year,month,day_of_month,day_of_week,fl_date,op_unique_carrier,op_carrier_fl_num,origin,dest,origin_city_name,origin_state_nm,dest_city_name,dest_state_nm,crs_dep_time,crs_arr_time,dep_delay,arr_delay,dep_time,arr_time,taxi_out,taxi_in,wheels_off,wheels_on,distance,air_time,crs_elapsed_time,actual_elapsed_time,cancelled,cancellation_code,diverted,carrier_delay,weather_delay,nas_delay,security_delay,late_aircraft_delay
2024,4,12,5,2024-04-12,DL,639,BOS,BWI,"Boston, MA",Massachusetts,"Baltimore, MD",Maryland,2088,1991,-15,-10,2073,1981,13,6,2086,1975,1752,219,239,238,0,,0,0.0,0.0,0.0,0.0,0.0
2024,12,14,6,2024-12-14,OH,6599,LGA,MSP,"New York, NY",New York,"Minneapolis, MN",Minnesota,510,984,-24,-20,486,964,24,5,510,959,2176,269,289,298,0,,0,0.0,0.0,0.0,0.0,0.0
2024,9,27,5,2024-09-27,YX,4855,MCO,TPA,"Orlando, FL",Florida,"Tampa, FL",Florida,1174,1109,-4,0,1170,1109,22,10,1192,1099,978,114,134,146,0,,0,0.0,0.0,0.0,0.0,0.0
2024,4,16,2,2024-04-16,B6,6059,PHX,LGA,"Phoenix, AZ",Arizona,"New York, NY",New York,1194,2205,15,10,1209,2215,29,4,1238,2211,422,57,77,90,0,,0,0.0,0.0,0.0,0.0,0.0
2024,3,12,2,2024-03-12,HA,3389,DCA,HNL,"Washington, DC",District of Columbia,"Honolulu, HI",Hawaii,1709,1781,53,45,1762,1826,25,9,1787,1817,2371,292,312,326,0,,0,13.0,10.0,0.0,0.0,22.0
2024,7,7,7,2024-07-07,WN,5646,MDW,MIA,"Chicago, IL",Illinois,"Miami, FL",Florida,2072,2233,8,10,2080,2243,17,13,2097,2230,1373,162,182,192,0,,0,0.0,0.0,0.0,0.0,0.0
2024,1,21,7,2024-01-21,G4,2858,SFO,MCO,"San Francisco, CA",California,"Orlando, FL",Florida,1472,2340,-10,0,1462,2340,27,8,1489,2332,746,101,121,136,0,,0,0.0,0.0,0.0,0.0,0.0
2024,4,12,5,2024-04-12,YX,5411,STL,PHL,"St. Louis, MO",Missouri,"Philadelphia, PA",Pennsylvania,508,685,7,0,515,685,14,5,529,680,1750,210,230,229,0,,0,0.0,0.0,0.0,0.0,0.0
2024,5,1,3,2024-05-01,B6,4207,DCA,PHX,"Washington, DC",District of Columbia,"Phoenix, AZ",Arizona,527,960,6,10,533,970,25,15,558,955,2079,259,279,299,0,,0,0.0,0.0,0.0,0.0,0.0
2024,8,2,5,2024-08-02,G4,1995,CLT,ORD,"Charlotte, NC",North Carolina,"Chicago, IL",Illinois,1322,1605,-13,-20,1309,1585,16,4,1325,1581,1529,189,209,209,0,,0,0.0,0.0,0.0,0.0,0.0
2024,11,26,2,2024-11-26,OO,2600,MCO,IAH,"Orlando, FL",Florida,"Houston, TX",Texas,1185,1391,19,20,1204,1411,17,7,1221,1404,215,26,46,50,0,,0,0.0,4.0,0.0,0.0,16.0
2024,3,28,4,2024-03-28,G4,2929,DTW,DCA,"Detroit, MI",Michigan,"Washington, DC",District of Columbia,1987,1708,9,0,1996,1708,25,17,2021,1691,712,79,99,121,0,,0,0.0,0.0,0.0,0.0,0.0
2024,4,9,2,2024-04-09,OH,147,EWR,DTW,"Newark, NJ",New Jersey,"Detroit, MI",Michigan,2162,958,11,20,2173,978,26,12,2199,966,1257,147,167,185,0,,0,2.0,5.0,3.0,0.0,10.0
2024,12,25,3,2024-12-25,DL,2464,DTW,PDX,"Detroit, MI",Michigan,"Portland, OR",Oregon,1010,1326,5,5,1015,1331,9,8,1024,1323,553,70,90,87,0,,0,0.0,0.0,0.0,0.0,0.0
2024,5,31,5,2024-05-31,OH,5766,LGA,STL,"New York, NY",New York,"St. Louis, MO",Missouri,1001,1756,-3,-10,998,1746,28,16,1026,1730,1687,209,229,253,0,,0,0.0,0.0,0.0,0.0,0.0
2024,5,10,5,2024-05-10,HA,6558,EWR,IAH,"Newark, NJ",New Jersey,"Houston, TX",Texas,1081,2010,-10,-10,1071,2000,16,3,1087,1997,1327,166,186,185,0,,0,0.0,0.0,0.0,0.0,0.0
2024,5,29,3,2024-05-29,G4,9045,MCO,IAH,"Orlando, FL",Florida,"Houston, TX",Texas,1277,1870,-2,-5,1275,1865,8,11,1283,1854,1512,192,212,211,0,,0,0.0,0.0,0.0,0.0,0.0
2024,11,4,1,2024-11-04,UA,8277,ATL,BOS,"Atlanta, GA",Georgia,"Boston, MA",Massachusetts,2186,1764,-8,-10,2178,1754,7,12,2185,1742,342,42,62,61,0,,0,0.0,0.0,0.0,0.0,0.0
2024,9,14,6,2024-09-14,WN,7730,ATL,ORD,"Atlanta, GA",Georgia,"Chicago, IL",Illinois,1160,1046,-15,-5,1145,1041,18,13,1163,1028,1176,140,160,171,0,,0,0.0,0.0,0.0,0.0,0.0
2024,12,9,1,2024-12-09,AA,8031,LAX,IAH,"Los Angeles, CA",California,"Houston, TX",Texas,1741,1699,-1,0,1740,1699,7,11,1747,1688,2945,367,387,385,0,,0,0.0,0.0,0.0,0.0,0.0
2024,10,20,7,2024-10-20,OH,7158,IAH,ORD,"Houston, TX",Texas,"Chicago, IL",Illinois,1952,1721,-1,-5,1951,1716,6,14,1957,1702,536,73,93,93,0,,0,0.0,0.0,0.0,0.0,0.0
2024,7,10,3,2024-07-10,AA,2902,JFK,BOS,"New York, NY",New York,"Boston, MA",Massachusetts,2161,1926,-7,-15,2154,1911,12,8,2166,1903,2026,243,263,263,0,,0,0.0,0.0,0.0,0.0,0.0
2024,10,3,4,2024-10-03,AA,8694,DEN,PDX,"Denver, CO",Colorado,"Portland, OR",Oregon,502,2089,26,20,528,2109,11,18,539,2091,892,106,126,135,0,,0,6.0,4.0,2.0,0.0,8.0
2024,6,9,7,2024-06-09,G4,2186,SLC,MDW,"Salt Lake City, UT",Utah,"Chicago, IL",Illinois,1710,1678,-6,-5,1704,1673,26,15,1730,1658,1215,145,165,186,0,,0,0.0,0.0,0.0,0.0,0.0
2024,11,9,6,2024-11-09,OO,6824,ATL,STL,"Atlanta, GA",Georgia,"St. Louis, MO",Missouri,542,904,7,10,549,914,6,8,555,906,2148,275,295,289,0,,0,0.0,0.0,0.0,0.0,0.0
2024,1,22,1,2024-01-22,F9,6255,BOS,LGA,"Boston, MA",Massachusetts,"New York, NY",New York,2134,1370,-19,-15,2115,1355,22,15,2137,1340,2623,334,354,371,0,,0,0.0,0.0,0.0,0.0,0.0
2024,9,9,1,2024-09-09,B6,1249,BWI,DEN,"Baltimore, MD",Maryland,"Denver, CO",Colorado,1274,1133,17,10,1291,1143,21,17,1312,1126,2305,281,301,319,0,,0,0.0,0.0,0.0,0.0,0.0
2024,8,23,5,2024-08-23,B6,162,DEN,LGA,"Denver, CO",Colorado,"New York, NY",New York,1934,634,-17,-10,1917,624,18,18,1935,606,2220,284,304,320,0,,0,0.0,0.0,0.0,0.0,0.0
2024,12,10,2,2024-12-10,G4,3253,MDW,HNL,"Chicago, IL",Illinois,"Honolulu, HI",Hawaii,1713,2163,0,5,1713,2168,16,11,1729,2157,788,107,127,134,0,,0,0.0,0.0,0.0,0.0,0.0
2024,2,18,7,2024-02-18,UA,9300,MCO,IAD,"Orlando, FL",Florida,"Washington, DC",District of Columbia,541,2112,-4,5,537,2117,22,12,559,2105,1262,166,186,200,0,,0,0.0,0.0,0.0,0.0,0.0
2024,2,28,3,2024-02-28,UA,6038,SLC,LAX,"Salt Lake City, UT",Utah,"Los Angeles, CA",California,1620,1281,17,15,1637,1296,29,14,1666,1282,1736,222,242,265,0,,0,0.0,0.0,0.0,0.0,0.0
2024,6,18,2,2024-06-18,NK,9614,IAD,HNL,"Washington, DC",District of Columbia,"Honolulu, HI",Hawaii,2295,1763,-4,-5,2291,1758,21,7,2312,1751,760,99,119,127,0,,0,0.0,0.0,0.0,0.0,0.0
2024,7,6,6,2024-07-06,G4,851,PDX,TPA,"Portland, OR",Oregon,"Tampa, FL",Florida,1229,1614,-21,-15,1208,1599,20,4,1228,1595,1556,196,216,220,0,,0,0.0,0.0,0.0,0.0,0.0
2024,9,27,5,2024-09-27,AS,7876,SAN,MSP,"San Diego, CA",California,"Minneapolis, MN",Minnesota,1147,1240,18,10,1165,1250,14,11,1179,1239,543,59,79,84,0,,0,0.0,0.0,0.0,0.0,0.0
2024,7,8,1,2024-07-08,OH,8949,BWI,EWR,"Baltimore, MD",Maryland,"Newark, NJ",New Jersey,1156,1723,-14,-5,1142,1718,8,3,1150,1715,2580,329,349,340,0,,0,0.0,0.0,0.0,0.0,0.0
2024,6,23,7,2024-06-23,DL,9952,CLT,PDX,"Charlotte, NC",North Carolina,"Portland, OR",Oregon,2040,1589,-10,-10,2030,1579,6,16,2036,1563,1579,187,207,209,0,,0,0.0,0.0,0.0,0.0,0.0
2024,2,20,2,2024-02-20,AA,800,IAD,MCO,"Washington, DC",District of Columbia,"Orlando, FL",Florida,1380,1996,-3,0,1377,1996,9,5,1386,1991,1150,137,157,151,0,,0,0.0,0.0,0.0,0.0,0.0
2024,12,29,7,2024-12-29,DL,9372,BOS,LAX,"Boston, MA",Massachusetts,"Los Angeles, CA",California,1659,1358,-22,-15,1637,1343,18,13,1655,1330,1045,123,143,154,0,,0,0.0,0.0,0.0,0.0,0.0
2024,2,24,6,2024-02-24,OH,1640,DFW,PDX,"Dallas/Fort Worth, TX",Texas,"Portland, OR",Oregon,1009,1646,-17,-10,992,1636,14,4,1006,1632,564,68,88,86,0,,0,0.0,0.0,0.0,0.0,0.0
2024,8,31,6,2024-08-31,OH,3132,ORD,MCO,"Chicago, IL",Illinois,"Orlando, FL",Florida,2042,883,-5,-5,2037,878,12,19,2049,859,1470,173,193,204,0,,0,0.0,0.0,0.0,0.0,0.0
2024,11,15,5,2024-11-15,AA,6267,SLC,JFK,"Salt Lake City, UT",Utah,"New York, NY",New York,536,712,-7,-10,529,702,5,5,534,697,697,86,106,96,0,,0,0.0,0.0,0.0,0.0,0.0
2024,5,10,5,2024-05-10,9E,6464,LAX,DFW,"Los Angeles, CA",California,"Dallas/Fort Worth, TX",Texas,1322,972,-2,0,1320,972,13,9,1333,963,1035,130,150,152,0,,0,0.0,0.0,0.0,0.0,0.0
2024,11,2,6,2024-11-02,9E,2083,IAD,PHX,"Washington, DC",District of Columbia,"Phoenix, AZ",Arizona,1078,796,4,-5,1082,791,27,5,1109,786,1286,161,181,193,0,,0,0.0,0.0,0.0,0.0,0.0
2024,5,14,2,2024-05-14,G4,8606,ATL,SEA,"Atlanta, GA",Georgia,"Seattle, WA",Washington,1336,1787,8,5,1344,1792,25,17,1369,1775,1815,230,250,272,0,,0,0.0,0.0,0.0,0.0,0.0
2024,1,21,7,2024-01-21,HA,5896,MIA,IAD,"Miami, FL",Florida,"Washington, DC",District of Columbia,1016,1492,7,15,1023,1507,9,6,1032,1501,1463,191,211,206,0,,0,0.0,0.0,0.0,0.0,0.0
2024,11,24,7,2024-11-24,9E,7748,SEA,BOS,"Seattle, WA",Washington,"Boston, MA",Massachusetts,1284,1421,-13,-15,1271,1406,13,17,1284,1389,1820,218,238,248,0,,0,0.0,0.0,0.0,0.0,0.0
2024,6,15,6,2024-06-15,HA,7994,SAN,TPA,"San Diego, CA",California,"Tampa, FL",Florida,1520,2054,13,10,1533,2064,13,5,1546,2059,2847,359,379,377,0,,0,0.0,0.0,0.0,0.0,0.0
2024,9,30,1,2024-09-30,YX,2414,DFW,MDW,"Dallas/Fort Worth, TX",Texas,"Chicago, IL",Illinois,1378,2191,21,15,1399,2206,22,13,1421,2193,1562,187,207,222,0,,0,0.0,0.0,0.0,0.0,0.0
2024,3,29,5,2024-03-29,OH,8059,DCA,LGA,"Washington, DC",District of Columbia,"New York, NY",New York,1581,609,-3,5,1578,614,28,5,1606,609,1321,164,184,197,0,,0,0.0,0.0,0.0,0.0,0.0
2024,11,11,1,2024-11-11,MQ,1749,STL,LAS,"St. Louis, MO",Missouri,"Las Vegas, NV",Nevada,1458,2268,64,60,1522,2328,9,16,1531,2312,2205,266,286,291,0,,0,21.0,16.0,8.0,2.0,13.0
2024,1,14,7,2024-01-14,F9,7800,MSP,MDW,"Minneapolis, MN",Minnesota,"Chicago, IL",Illinois,654,997,-14,-5,640,992,20,11,660,981,1717,211,231,242,0,,0,0.0,0.0,0.0,0.0,0.0
2024,8,29,4,2024-08-29,HA,7000,SAN,CLT,"San Diego, CA",California,"Charlotte, NC",North Carolina,612,751,9,10,621,761,6,17,627,744,1994,239,259,262,0,,0,0.0,0.0,0.0,0.0,0.0
2024,9,21,6,2024-09-21,NK,3900,SFO,MSP,"San Francisco, CA",California,"Minneapolis, MN",Minnesota,1983,790,9,5,1992,795,29,10,2021,785,878,113,133,152,0,,0,0.0,0.0,0.0,0.0,0.0
2024,12,11,3,2024-12-11,HA,2578,SEA,PHX,"Seattle, WA",Washington,"Phoenix, AZ",Arizona,2127,876,3,-5,2130,871,8,10,2138,861,2718,332,352,350,0,,0,0.0,0.0,0.0,0.0,0.0
2024,2,22,4,2024-02-22,UA,7154,BWI,PHL,"Baltimore, MD",Maryland,"Philadelphia, PA",Pennsylvania,1335,1092,6,5,1341,1097,25,10,1366,1087,2514,306,326,341,0,,0,0.0,0.0,0.0,0.0,0.0
2024,12,5,4,2024-12-05,F9,6159,SAN,HNL,"San Diego, CA",California,"Honolulu, HI",Hawaii,2279,1866,6,0,2285,1866,27,16,2312,1850,1959,246,266,289,0,,0,0.0,0.0,0.0,0.0,0.0
2024,4,1,1,2024-04-01,DL,8533,MSP,PHX,"Minneapolis, MN",Minnesota,"Phoenix, AZ",Arizona,1100,1087,-5,-10,1095,1077,22,8,1117,1069,1590,197,217,227,0,,0,0.0,0.0,0.0,0.0,0.0
2024,9,20,5,2024-09-20,DL,6309,PHL,MSP,"Philadelphia, PA",Pennsylvania,"Minneapolis, MN",Minnesota,941,875,-13,-10,928,865,9,15,937,850,1509,179,199,203,0,,0,0.0,0.0,0.0,0.0,0.0
2024,2,4,7,2024-02-04,OO,7215,IAH,CLT,"Houston, TX",Texas,"Charlotte, NC",North Carolina,2213,789,-1,5,2212,794,12,9,2224,785,1707,221,241,242,0,,0,0.0,0.0,0.0,0.0,0.0
2024,7,24,3,2024-07-24,9E,2356,DTW,BWI,"Detroit, MI",Michigan,"Baltimore, MD",Maryland,727,2250,9,5,736,2255,16,17,752,2238,2826,361,381,394,0,,0,0.0,0.0,0.0,0.0,0.0
2024,3,21,4,2024-03-21,UA,3468,DTW,LGA,"Detroit, MI",Michigan,"New York, NY",New York,1373,1463,-3,0,1370,1463,18,12,1388,1451,1963,248,268,278,0,,0,0.0,0.0,0.0,0.0,0.0
2024,2,19,1,2024-02-19,NK,7487,PDX,LAX,"Portland, OR",Oregon,"Los Angeles, CA",California,2102,1930,7,0,2109,1930,21,14,2130,1916,1495,184,204,219,0,,0,0.0,0.0,0.0,0.0,0.0
2024,12,25,3,2024-12-25,AA,8658,LAS,DTW,"Las Vegas, NV",Nevada,"Detroit, MI",Michigan,1645,895,-13,-10,1632,885,16,7,1648,878,1383,180,200,203,0,,0,0.0,0.0,0.0,0.0,0.0
2024,1,2,2,2024-01-02,F9,2927,BOS,LAS,"Boston, MA",Massachusetts,"Las Vegas, NV",Nevada,1170,1857,3,-5,1173,1852,28,5,1201,1847,1067,142,162,175,0,,0,0.0,0.0,0.0,0.0,0.0
2024,2,23,5,2024-02-23,YX,9544,STL,LGA,"St. Louis, MO",Missouri,"New York, NY",New York,1880,940,16,10,1896,950,6,7,1902,943,2949,374,394,387,0,,0,0.0,0.0,0.0,0.0,0.0
2024,4,15,1,2024-04-15,NK,2587,PDX,LAX,"Portland, OR",Oregon,"Los Angeles, CA",California,1791,1192,3,10,1794,1202,8,14,1802,1188,2477,303,323,325,0,,0,0.0,0.0,0.0,0.0,0.0
2024,9,16,1,2024-09-16,WN,3703,MCO,PHL,"Orlando, FL",Florida,"Philadelphia, PA",Pennsylvania,1194,1816,-2,5,1192,1821,15,5,1207,1816,2973,362,382,382,0,,0,0.0,0.0,0.0,0.0,0.0
2024,11,5,2,2024-11-05,OH,3621,DEN,SEA,"Denver, CO",Colorado,"Seattle, WA",Washington,2008,1482,69,60,2077,1542,16,3,2093,1539,697,83,103,102,0,,0,3.0,1.0,2.0,1.0,53.0
2024,7,9,2,2024-07-09,HA,4617,IAH,IAD,"Houston, TX",Texas,"Washington, DC",District of Columbia,1368,1987,19,10,1387,1997,23,19,1410,1978,2453,297,317,339,0,,0,0.0,0.0,0.0,0.0,0.0
2024,8,5,1,2024-08-05,B6,1743,CLT,LGA,"Charlotte, NC",North Carolina,"New York, NY",New York,1527,1549,-17,-15,1510,1534,6,12,1516,1522,398,50,70,68,0,,0,0.0,0.0,0.0,0.0,0.0
2024,2,13,2,2024-02-13,9E,1312,BOS,STL,"Boston, MA",Massachusetts,"St. Louis, MO",Missouri,2001,857,-2,-5,1999,852,14,8,2013,844,2569,324,344,346,0,,0,0.0,0.0,0.0,0.0,0.0
2024,6,10,1,2024-06-10,MQ,7445,DCA,PDX,"Washington, DC",District of Columbia,"Portland, OR",Oregon,620,1576,-25,-15,595,1561,14,15,609,1546,2607,321,341,350,0,,0,0.0,0.0,0.0,0.0,0.0
2024,7,20,6,2024-07-20,AA,4803,HNL,STL,"Honolulu, HI",Hawaii,"St. Louis, MO",Missouri,1241,2134,-2,0,1239,2134,6,17,1245,2117,1618,205,225,228,0,,0,0.0,0.0,0.0,0.0,0.0
2024,9,26,4,2024-09-26,WN,5534,JFK,LAS,"New York, NY",New York,"Las Vegas, NV",Nevada,2009,1854,7,5,2016,1859,26,4,2042,1855,2744,344,364,374,0,,0,0.0,0.0,0.0,0.0,0.0
2024,12,16,1,2024-12-16,HA,119,SFO,STL,"San Francisco, CA",California,"St. Louis, MO",Missouri,1742,613,-3,-10,1739,603,23,4,1762,599,657,87,107,114,0,,0,0.0,0.0,0.0,0.0,0.0
2024,10,30,3,2024-10-30,AA,775,LAX,LGA,"Los Angeles, CA",California,"New York, NY",New York,1193,1637,9,10,1202,1647,24,19,1226,1628,1101,140,160,183,0,,0,0.0,0.0,0.0,0.0,0.0
2024,9,27,5,2024-09-27,AA,4577,MCO,DFW,"Orlando, FL",Florida,"Dallas/Fort Worth, TX",Texas,1801,1155,-7,0,1794,1155,8,3,1802,1152,2138,260,280,271,0,,0,0.0,0.0,0.0,0.0,0.0
2024,8,2,5,2024-08-02,9E,708,EWR,LAX,"Newark, NJ",New Jersey,"Los Angeles, CA",California,756,1607,9,5,765,1612,22,7,787,1605,352,47,67,76,0,,0,0.0,0.0,0.0,0.0,0.0
2024,9,8,7,2024-09-08,AA,6386,STL,DCA,"St. Louis, MO",Missouri,"Washington, DC",District of Columbia,1827,809,-27,-20,1800,789,24,18,1824,771,509,53,73,95,0,,0,0.0,0.0,0.0,0.0,0.0
2024,7,8,1,2024-07-08,NK,161,MDW,EWR,"Chicago, IL",Illinois,"Newark, NJ",New Jersey,542,1663,-6,-15,536,1648,22,7,558,1641,651,80,100,109,0,,0,0.0,0.0,0.0,0.0,0.0
2024,10,22,2,2024-10-22,NK,9557,LGA,MSP,"New York, NY",New York,"Minneapolis, MN",Minnesota,1369,1657,0,0,1369,1657,18,12,1387,1645,2515,306,326,336,0,,0,0.0,0.0,0.0,0.0,0.0
2024,7,31,3,2024-07-31,WN,1254,MIA,DCA,"Miami, FL",Florida,"Washington, DC",District of Columbia,1415,1346,11,10,1426,1356,24,12,1450,1344,1101,141,161,177,0,,0,0.0,0.0,0.0,0.0,0.0
2024,7,26,5,2024-07-26,HA,9920,SEA,EWR,"Seattle, WA",Washington,"Newark, NJ",New Jersey,2053,1857,12,10,2065,1867,17,3,2082,1864,401,52,72,72,0,,0,0.0,0.0,0.0,0.0,0.0
2024,8,24,6,2024-08-24,MQ,9918,DFW,IAH,"Dallas/Fort Worth, TX",Texas,"Houston, TX",Texas,2233,1913,-4,5,2229,1918,28,11,2257,1907,2082,257,277,296,0,,0,0.0,0.0,0.0,0.0,0.0
2024,12,3,2,2024-12-03,YX,3816,ORD,PDX,"Chicago, IL",Illinois,"Portland, OR",Oregon,2212,1454,-13,-10,2199,1444,19,9,2218,1435,559,60,80,88,0,,0,0.0,0.0,0.0,0.0,0.0
2024,2,22,4,2024-02-22,DL,5342,DCA,SLC,"Washington, DC",District of Columbia,"Salt Lake City, UT",Utah,1087,2056,-17,-10,1070,2046,19,18,1089,2028,1336,176,196,213,0,,0,0.0,0.0,0.0,0.0,0.0
2024,10,6,7,2024-10-06,YX,5659,SLC,EWR,"Salt Lake City, UT",Utah,"Newark, NJ",New Jersey,1412,1447,8,10,1420,1457,29,8,1449,1449,1517,187,207,224,0,,0,0.0,0.0,0.0,0.0,0.0
2024,8,4,7,2024-08-04,UA,5122,BOS,STL,"Boston, MA",Massachusetts,"St. Louis, MO",Missouri,2216,1550,-24,-15,2192,1535,24,12,2216,1523,1388,173,193,209,0,,0,0.0,0.0,0.0,0.0,0.0
2024,9,8,7,2024-09-08,F9,6585,LAX,ATL,"Los Angeles, CA",California,"Atlanta, GA",Georgia,1673,1941,-1,5,1672,1946,8,7,1680,1939,707,79,99,94,0,,0,0.0,0.0,0.0,0.0,0.0
2024,7,6,6,2024-07-06,MQ,1542,LAS,MSP,"Las Vegas, NV",Nevada,"Minneapolis, MN",Minnesota,1093,1239,-6,0,1087,1239,19,15,1106,1224,1376,169,189,203,0,,0,0.0,0.0,0.0,0.0,0.0
2024,2,10,6,2024-02-10,F9,1753,DEN,SLC,"Denver, CO",Colorado,"Salt Lake City, UT",Utah,1533,1007,-12,-5,1521,1002,18,14,1539,988,2675,332,352,364,0,,0,0.0,0.0,0.0,0.0,0.0
2024,6,5,3,2024-06-05,OO,2602,LAX,EWR,"Los Angeles, CA",California,"Newark, NJ",New Jersey,1291,2344,3,-5,1294,2339,11,19,1305,2320,1283,161,181,191,0,,0,0.0,0.0,0.0,0.0,0.0
2024,1,15,1,2024-01-15,OO,3369,MDW,DTW,"Chicago, IL",Illinois,"Detroit, MI",Michigan,711,1415,13,15,724,1430,21,4,745,1426,1109,146,166,171,0,,0,0.0,0.0,0.0,0.0,0.0
2024,10,27,7,2024-10-27,AS,381,MSP,IAD,"Minneapolis, MN",Minnesota,"Washington, DC",District of Columbia,2175,1703,11,10,2186,1713,27,7,2213,1706,266,37,57,71,0,,0,0.0,0.0,0.0,0.0,0.0
2024,3,5,2,2024-03-05,HA,9316,BOS,PHL,"Boston, MA",Massachusetts,"Philadelphia, PA",Pennsylvania,1783,775,2,10,1785,785,13,12,1798,773,827,96,116,121,1,,0,0.0,0.0,0.0,0.0,0.0
2024,12,10,2,2024-12-10,9E,3503,TPA,LAX,"Tampa, FL",Florida,"Los Angeles, CA",California,1905,1614,-11,-5,1894,1609,8,3,1902,1606,2827,352,372,363,0,,0,0.0,0.0,0.0,0.0,0.0
2024,11,22,5,2024-11-22,G4,1335,MSP,JFK,"Minneapolis, MN",Minnesota,"New York, NY",New York,1912,1447,-24,-15,1888,1432,22,14,1910,1418,875,111,131,147,0,,0,0.0,0.0,0.0,0.0,0.0
2024,1,9,2,2024-01-09,OO,4860,MDW,IAD,"Chicago, IL",Illinois,"Washington, DC",District of Columbia,1421,1908,62,60,1483,1968,17,16,1500,1952,2528,313,333,346,0,,0,14.0,6.0,0.0,1.0,39.0
2024,12,9,1,2024-12-09,YX,7040,DEN,MSP,"Denver, CO",Colorado,"Minneapolis, MN",Minnesota,2263,2253,-19,-15,2244,2238,19,10,2263,2228,1231,153,173,182,0,,0,0.0,0.0,0.0,0.0,0.0
2024,5,8,3,2024-05-08,G4,885,PHX,PHL,"Phoenix, AZ",Arizona,"Philadelphia, PA",Pennsylvania,835,2301,-3,0,832,2301,8,19,840,2282,1504,182,202,209,0,,0,0.0,0.0,0.0,0.0,0.0
2024,5,15,3,2024-05-15,WN,9959,JFK,BWI,"New York, NY",New York,"Baltimore, MD",Maryland,1528,917,-1,-10,1527,907,22,13,1549,894,1765,224,244,259,0,,0,0.0,0.0,0.0,0.0,0.0
2024,3,3,7,2024-03-03,YX,3294,DFW,ATL,"Dallas/Fort Worth, TX",Texas,"Atlanta, GA",Georgia,1421,1009,0,0,1421,1009,14,4,1435,1005,1850,221,241,239,0,,0,0.0,0.0,0.0,0.0,0.0
2024,5,18,6,2024-05-18,AA,4889,MDW,DEN,"Chicago, IL",Illinois,"Denver, CO",Colorado,582,1765,-4,-5,578,1760,11,7,589,1753,534,72,92,90,0,,0,0.0,0.0,0.0,0.0,0.0
2024,3,21,4,2024-03-21,AA,3875,SLC,DFW,"Salt Lake City, UT",Utah,"Dallas/Fort Worth, TX",Texas,1529,846,17,10,1546,856,10,11,1556,845,387,49,69,70,0,,0,0.0,0.0,0.0,0.0,0.0
2024,6,11,2,2024-06-11,HA,5450,IAD,IAH,"Washington, DC",District of Columbia,"Houston, TX",Texas,651,776,27,20,678,796,17,11,695,785,1012,119,139,147,0,,0,7.0,5.0,0.0,0.0,8.0
2024,10,15,2,2024-10-15,YX,633,TPA,MCO,"Tampa, FL",Florida,"Orlando, FL",Florida,2258,1410,0,-5,2258,1405,22,12,2280,1393,1964,241,261,275,0,,0,0.0,0.0,0.0,0.0,0.0
2024,9,17,2,2024-09-17,9E,8693,LAX,EWR,"Los Angeles, CA",California,"Newark, NJ",New Jersey,1704,1967,-6,-15,1698,1952,26,6,1724,1946,758,94,114,126,0,,0,0.0,0.0,0.0,0.0,0.0
2024,8,18,7,2024-08-18,HA,3763,ORD,PHX,"Chicago, IL",Illinois,"Phoenix, AZ",Arizona,2298,863,0,5,2298,868,13,19,2311,849,1049,132,152,164,0,,0,0.0,0.0,0.0,0.0,0.0
2024,2,10,6,2024-02-10,B6,229,DCA,MCO,"Washington, DC",District of Columbia,"Orlando, FL",Florida,1690,767,2,-5,1692,762,15,14,1707,748,2289,291,311,320,0,,0,0.0,0.0,0.0,0.0,0.0
2024,1,28,7,2024-01-28,OH,3059,MSP,ATL,"Minneapolis, MN",Minnesota,"Atlanta, GA",Georgia,1993,1648,36,30,2029,1678,20,5,2049,1673,2425,310,330,335,0,,0,10.0,1.0,0.0,0.0,19.0
2024,5,14,2,2024-05-14,MQ,1958,PHX,IAD,"Phoenix, AZ",Arizona,"Washington, DC",District of Columbia,577,1302,-8,-15,569,1287,12,6,581,1281,1998,252,272,270,0,,0,0.0,0.0,0.0,0.0,0.0
2024,7,19,5,2024-07-19,DL,3749,TPA,MIA,"Tampa, FL",Florida,"Miami, FL",Florida,911,2150,-23,-15,888,2135,29,9,917,2126,203,29,49,67,0,,0,0.0,0.0,0.0,0.0,0.0
2024,11,23,6,2024-11-23,HA,3197,BOS,LAS,"Boston, MA",Massachusetts,"Las Vegas, NV",Nevada,2077,1127,3,5,2080,1132,9,13,2089,1119,509,69,89,91,0,,0,0.0,0.0,0.0,0.0,0.0
2024,9,24,2,2024-09-24,AS,3612,JFK,DCA,"New York, NY",New York,"Washington, DC",District of Columbia,2097,1933,1,5,2098,1938,19,6,2117,1932,1908,229,249,254,0,,0,0.0,0.0,0.0,0.0,0.0
2024,2,2,5,2024-02-02,NK,4960,PHX,PHL,"Phoenix, AZ",Arizona,"Philadelphia, PA",Pennsylvania,880,2262,-4,0,876,2262,6,8,882,2254,998,116,136,130,0,,0,0.0,0.0,0.0,0.0,0.0
2024,2,17,6,2024-02-17,AA,9512,EWR,HNL,"Newark, NJ",New Jersey,"Honolulu, HI",Hawaii,1447,627,-2,-10,1445,617,9,3,1454,614,1303,156,176,168,0,,0,0.0,0.0,0.0,0.0,0.0
2024,3,2,6,2024-03-02,AS,8933,IAD,PDX,"Washington, DC",District of Columbia,"Portland, OR",Oregon,1289,1993,-15,-5,1274,1988,14,3,1288,1985,2308,278,298,295,0,,0,0.0,0.0,0.0,0.0,0.0
2024,8,3,6,2024-08-03,F9,823,EWR,SAN,"Newark, NJ",New Jersey,"San Diego, CA",California,812,2007,-15,-5,797,2002,23,8,820,1994,2625,327,347,358,0,,0,0.0,0.0,0.0,0.0,0.0
2024,10,19,6,2024-10-19,YX,837,ATL,BOS,"Atlanta, GA",Georgia,"Boston, MA",Massachusetts,1363,1917,-20,-10,1343,1907,18,3,1361,1904,1610,205,225,226,0,,0,0.0,0.0,0.0,0.0,0.0
2024,4,8,1,2024-04-08,B6,1399,MSP,DFW,"Minneapolis, MN",Minnesota,"Dallas/Fort Worth, TX",Texas,894,1263,10,10,904,1273,17,17,921,1256,1142,141,161,175,0,,0,0.0,0.0,0.0,0.0,0.0
2024,6,20,4,2024-06-20,OH,3580,DEN,PDX,"Denver, CO",Colorado,"Portland, OR",Oregon,1042,2102,-8,-15,1034,2087,18,3,1052,2084,2762,338,358,359,0,,0,0.0,0.0,0.0,0.0,0.0
2024,12,25,3,2024-12-25,YX,439,DTW,MIA,"Detroit, MI",Michigan,"Miami, FL",Florida,503,1179,-3,-5,500,1174,8,8,508,1166,2250,283,303,299,0,,0,0.0,0.0,0.0,0.0,0.0
2024,8,1,4,2024-08-01,NK,252,JFK,DTW,"New York, NY",New York,"Detroit, MI",Michigan,608,636,9,5,617,641,11,11,628,630,676,89,109,111,0,,0,0.0,0.0,0.0,0.0,0.0
2024,2,4,7,2024-02-04,9E,5784,MSP,LGA,"Minneapolis, MN",Minnesota,"New York, NY",New York,1417,1487,-14,-20,1403,1467,22,8,1425,1459,258,31,51,61,0,,0,0.0,0.0,0.0,0.0,0.0
2024,8,14,3,2024-08-14,AS,9713,ATL,BWI,"Atlanta, GA",Georgia,"Baltimore, MD",Maryland,1385,1146,9,10,1394,1156,10,19,1404,1137,508,54,74,83,0,,0,0.0,0.0,0.0,0.0,0.0
2024,4,10,3,2024-04-10,WN,3151,PHX,LGA,"Phoenix, AZ",Arizona,"New York, NY",New York,592,1245,2,5,594,1250,19,3,613,1247,1623,199,219,221,0,,0,0.0,0.0,0.0,0.0,0.0
2024,5,10,5,2024-05-10,HA,526,MIA,PHX,"Miami, FL",Florida,"Phoenix, AZ",Arizona,1622,1477,-17,-15,1605,1462,15,18,1620,1444,2401,303,323,336,0,,0,0.0,0.0,0.0,0.0,0.0
2024,9,13,5,2024-09-13,HA,7246,PHX,HNL,"Phoenix, AZ",Arizona,"Honolulu, HI",Hawaii,691,1272,18,10,709,1282,21,18,730,1264,877,103,123,142,0,,0,0.0,0.0,0.0,0.0,0.0
2024,1,5,5,2024-01-05,NK,8225,DTW,BOS,"Detroit, MI",Michigan,"Boston, MA",Massachusetts,832,971,7,0,839,971,14,3,853,968,568,78,98,95,0,,0,0.0,0.0,0.0,0.0,0.0
2024,8,5,1,2024-08-05,9E,6447,DEN,IAH,"Denver, CO",Colorado,"Houston, TX",Texas,1735,1335,2,5,1737,1340,20,9,1757,1331,442,52,72,81,0,,0,0.0,0.0,0.0,0.0,0.0
2024,9,11,3,2024-09-11,G4,9427,SFO,LAX,"San Francisco, CA",California,"Los Angeles, CA",California,2118,2245,4,10,2122,2255,23,16,2145,2239,2524,316,336,355,0,,0,0.0,0.0,0.0,0.0,0.0
2024,12,24,2,2024-12-24,9E,2472,HNL,LAX,"Honolulu, HI",Hawaii,"Los Angeles, CA",California,1730,701,13,10,1743,711,15,17,1758,694,880,117,137,149,1,,0,0.0,0.0,0.0,0.0,0.0
2024,10,9,3,2024-10-09,9E,8226,SFO,LAS,"San Francisco, CA",California,"Las Vegas, NV",Nevada,1126,1978,-3,-5,1123,1973,11,8,1134,1965,2336,294,314,313,0,,0,0.0,0.0,0.0,0.0,0.0
2024,7,25,4,2024-07-25,MQ,1049,BWI,DCA,"Baltimore, MD",Maryland,"Washington, DC",District of Columbia,1485,1064,-20,-10,1465,1054,25,19,1490,1035,1482,179,199,223,0,,0,0.0,0.0,0.0,0.0,0.0
2024,1,15,1,2024-01-15,NK,7795,IAH,EWR,"Houston, TX",Texas,"Newark, NJ",New Jersey,2287,1293,-10,-10,2277,1283,28,19,2305,1264,2484,310,330,357,0,,0,0.0,0.0,0.0,0.0,0.0
2024,12,11,3,2024-12-11,YX,1473,SLC,IAH,"Salt Lake City, UT",Utah,"Houston, TX",Texas,1072,1079,6,5,1078,1084,27,8,1105,1076,2559,311,331,346,0,,0,0.0,0.0,0.0,0.0,0.0
2024,2,11,7,2024-02-11,OH,7182,ORD,SAN,"Chicago, IL",Illinois,"San Diego, CA",California,855,1509,10,15,865,1524,27,15,892,1509,389,53,73,95,0,,0,0.0,0.0,0.0,0.0,0.0
2024,6,27,4,2024-06-27,B6,9248,LAX,LGA,"Los Angeles, CA",California,"New York, NY",New York,1776,2282,-14,-15,1762,2267,18,13,1780,2254,928,113,133,144,0,,0,0.0,0.0,0.0,0.0,0.0
2024,3,3,7,2024-03-03,NK,9993,DEN,STL,"Denver, CO",Colorado,"St. Louis, MO",Missouri,1090,815,-28,-20,1062,795,5,12,1067,783,1447,186,206,203,0,,0,0.0,0.0,0.0,0.0,0.0
2024,12,17,2,2024-12-17,UA,2582,CLT,LGA,"Charlotte, NC",North Carolina,"New York, NY",New York,695,1598,7,10,702,1608,21,4,723,1604,1819,222,242,247,0,,0,0.0,0.0,0.0,0.0,0.0
2024,8,18,7,2024-08-18,DL,7693,BWI,DTW,"Baltimore, MD",Maryland,"Detroit, MI",Michigan,761,2274,-14,-5,747,2269,26,10,773,2259,214,28,48,64,0,,0,0.0,0.0,0.0,0.0,0.0
2024,8,28,3,2024-08-28,OO,9595,PDX,DCA,"Portland, OR",Oregon,"Washington, DC",District of Columbia,821,1950,-15,-10,806,1940,17,17,823,1923,965,126,146,160,0,,0,0.0,0.0,0.0,0.0,0.0
2024,2,21,3,2024-02-21,HA,470,IAD,MIA,"Washington, DC",District of Columbia,"Miami, FL",Florida,919,1299,-18,-10,901,1289,12,11,913,1278,1253,148,168,171,0,,0,0.0,0.0,0.0,0.0,0.0
2024,4,5,5,2024-04-05,B6,7937,PHL,BOS,"Philadelphia, PA",Pennsylvania,"Boston, MA",Massachusetts,2021,1199,-9,-5,2012,1194,23,15,2035,1179,659,84,104,122,0,,0,0.0,0.0,0.0,0.0,0.0
2024,8,9,5,2024-08-09,WN,2396,DFW,PHL,"Dallas/Fort Worth, TX",Texas,"Philadelphia, PA",Pennsylvania,831,1870,25,20,856,1890,28,17,884,1873,1031,125,145,170,0,,0,4.0,5.0,3.0,0.0,8.0
2024,8,18,7,2024-08-18,B6,7134,MSP,SAN,"Minneapolis, MN",Minnesota,"San Diego, CA",California,1819,1612,26,20,1845,1632,12,17,1857,1615,1469,180,200,209,0,,0,6.0,3.0,2.0,0.0,9.0
2024,8,24,6,2024-08-24,F9,6424,CLT,PHX,"Charlotte, NC",North Carolina,"Phoenix, AZ",Arizona,1759,2321,-4,-5,1755,2316,21,3,1776,2313,2566,328,348,352,0,,0,0.0,0.0,0.0,0.0,0.0
2024,5,22,3,2024-05-22,YX,7242,PDX,SEA,"Portland, OR",Oregon,"Seattle, WA",Washington,1180,1711,24,20,1204,1731,9,7,1213,1724,2254,280,300,296,0,,0,2.0,0.0,0.0,0.0,18.0
2024,6,19,3,2024-06-19,WN,7128,BOS,IAD,"Boston, MA",Massachusetts,"Washington, DC",District of Columbia,506,933,-7,-10,499,923,29,17,528,906,285,39,59,85,0,,0,0.0,0.0,0.0,0.0,0.0
2024,1,29,1,2024-01-29,HA,6579,DEN,HNL,"Denver, CO",Colorado,"Honolulu, HI",Hawaii,1033,1263,0,10,1033,1273,15,16,1048,1257,1551,189,209,220,0,,0,0.0,0.0,0.0,0.0,0.0
2024,2,5,1,2024-02-05,G4,4245,ATL,IAH,"Atlanta, GA",Georgia,"Houston, TX",Texas,571,1378,-9,-10,562,1368,18,8,580,1360,414,58,78,84,0,,0,0.0,0.0,0.0,0.0,0.0
2024,1,13,6,2024-01-13,NK,4121,SLC,IAH,"Salt Lake City, UT",Utah,"Houston, TX",Texas,2023,1823,19,10,2042,1833,14,8,2056,1825,2509,303,323,325,0,,0,0.0,0.0,0.0,0.0,0.0
2024,6,8,6,2024-06-08,9E,2464,TPA,DEN,"Tampa, FL",Florida,"Denver, CO",Colorado,1117,2006,4,-5,1121,2001,16,7,1137,1994,2945,370,390,393,0,,0,0.0,0.0,0.0,0.0,0.0
2024,11,22,5,2024-11-22,MQ,5330,STL,DFW,"St. Louis, MO",Missouri,"Dallas/Fort Worth, TX",Texas,638,2051,-7,-10,631,2041,7,11,638,2030,1749,224,244,242,0,,0,0.0,0.0,0.0,0.0,0.0
2024,7,5,5,2024-07-05,YX,6070,BOS,DFW,"Boston, MA",Massachusetts,"Dallas/Fort Worth, TX",Texas,1909,1958,20,15,1929,1973,13,9,1942,1964,2508,321,341,343,0,,0,0.0,0.0,0.0,0.0,0.0
2024,8,30,5,2024-08-30,NK,9054,CLT,MIA,"Charlotte, NC",North Carolina,"Miami, FL",Florida,1041,1601,-6,-10,1035,1591,15,18,1050,1573,255,22,42,55,0,,0,0.0,0.0,0.0,0.0,0.0
2024,3,26,2,2024-03-26,HA,7400,BWI,MDW,"Baltimore, MD",Maryland,"Chicago, IL",Illinois,823,1049,42,45,865,1094,13,19,878,1075,2880,357,377,389,0,,0,5.0,3.0,8.0,1.0,28.0
2024,10,10,4,2024-10-10,MQ,6855,SLC,STL,"Salt Lake City, UT",Utah,"St. Louis, MO",Missouri,1448,815,-25,-15,1423,800,5,10,1428,790,709,88,108,103,0,,0,0.0,0.0,0.0,0.0,0.0
2024,3,6,3,2024-03-06,MQ,1104,JFK,BOS,"New York, NY",New York,"Boston, MA",Massachusetts,1100,1540,-18,-20,1082,1520,22,15,1104,1505,1888,237,257,274,0,,0,0.0,0.0,0.0,0.0,0.0
2024,6,18,2,2024-06-18,F9,7157,MSP,EWR,"Minneapolis, MN",Minnesota,"Newark, NJ",New Jersey,2188,1185,2,10,2190,1195,7,16,2197,1179,643,72,92,95,0,,0,0.0,0.0,0.0,0.0,0.0
2024,2,14,3,2024-02-14,YX,3855,PHL,LGA,"Philadelphia, PA",Pennsylvania,"New York, NY",New York,572,1271,1,0,573,1271,18,6,591,1265,1355,163,183,187,0,,0,0.0,0.0,0.0,0.0,0.0
2024,3,2,6,2024-03-02,AS,2946,TPA,IAH,"Tampa, FL",Florida,"Houston, TX",Texas,1339,1878,-9,-5,1330,1873,8,12,1338,1861,2788,349,369,369,0,,0,0.0,0.0,0.0,0.0,0.0
2024,5,13,1,2024-05-13,F9,6362,MCO,LGA,"Orlando, FL",Florida,"New York, NY",New York,1912,2152,-18,-15,1894,2137,9,12,1903,2125,1968,236,256,257,0,,0,0.0,0.0,0.0,0.0,0.0
2024,10,10,4,2024-10-10,UA,8641,IAD,LAX,"Washington, DC",District of Columbia,"Los Angeles, CA",California,1761,1616,6,0,1767,1616,25,8,1792,1608,2870,358,378,391,0,,0,0.0,0.0,0.0,0.0,0.0
2024,1,28,7,2024-01-28,9E,3064,LGA,SLC,"New York, NY",New York,"Salt Lake City, UT",Utah,1487,1104,2,-5,1489,1099,14,9,1503,1090,1849,223,243,246,0,,0,0.0,0.0,0.0,0.0,0.0
2024,4,17,3,2024-04-17,9E,8978,DTW,LAS,"Detroit, MI",Michigan,"Las Vegas, NV",Nevada,1845,1037,-1,0,1844,1037,9,9,1853,1028,2510,322,342,340,0,,0,0.0,0.0,0.0,0.0,0.0
2024,2,13,2,2024-02-13,OH,4737,CLT,LAX,"Charlotte, NC",North Carolina,"Los Angeles, CA",California,1864,2273,4,0,1868,2273,7,6,1875,2267,1115,138,158,151,0,,0,0.0,0.0,0.0,0.0,0.0
2024,12,5,4,2024-12-05,AA,2855,LGA,SAN,"New York, NY",New York,"San Diego, CA",California,2286,1069,-1,0,2285,1069,26,11,2311,1058,1591,200,220,237,0,,0,0.0,0.0,0.0,0.0,0.0
2024,10,12,6,2024-10-12,AS,3724,IAH,BWI,"Houston, TX",Texas,"Baltimore, MD",Maryland,1828,605,18,20,1846,625,24,18,1870,607,2802,358,378,400,0,,0,3.0,4.0,3.0,0.0,10.0
2024,11,26,2,2024-11-26,AA,2832,TPA,MDW,"Tampa, FL",Florida,"Chicago, IL",Illinois,1531,818,-5,5,1526,823,13,5,1539,818,555,71,91,89,0,,0,0.0,0.0,0.0,0.0,0.0
2024,5,7,2,2024-05-07,G4,6573,LGA,DTW,"New York, NY",New York,"Detroit, MI",Michigan,1730,2136,-11,-5,1719,2131,16,7,1735,2124,676,93,113,116,0,,0,0.0,0.0,0.0,0.0,0.0
2024,12,13,5,2024-12-13,OH,6451,LAX,BWI,"Los Angeles, CA",California,"Baltimore, MD",Maryland,910,1175,-1,-5,909,1170,6,7,915,1163,867,111,131,124,0,,0,0.0,0.0,0.0,0.0,0.0
2024,8,18,7,2024-08-18,DL,1793,ORD,LAX,"Chicago, IL",Illinois,"Los Angeles, CA",California,757,2344,3,0,760,2344,15,8,775,2336,2287,284,304,307,0,,0,0.0,0.0,0.0,0.0,0.0
2024,7,8,1,2024-07-08,OO,784,BOS,DCA,"Boston, MA",Massachusetts,"Washington, DC",District of Columbia,1150,1112,-10,-10,1140,1102,5,11,1145,1091,1546,199,219,215,0,,0,0.0,0.0,0.0,0.0,0.0
2024,8,12,1,2024-08-12,DL,3019,DTW,TPA,"Detroit, MI",Michigan,"Tampa, FL",Florida,1569,1468,1,-5,1570,1463,27,11,1597,1452,554,64,84,102,0,,0,0.0,0.0,0.0,0.0,0.0
2024,10,9,3,2024-10-09,NK,7266,TPA,IAD,"Tampa, FL",Florida,"Washington, DC",District of Columbia,625,1812,13,10,638,1822,20,14,658,1808,514,58,78,92,0,,0,0.0,0.0,0.0,0.0,0.0
2024,4,30,2,2024-04-30,DL,3856,CLT,LAS,"Charlotte, NC",North Carolina,"Las Vegas, NV",Nevada,1544,1574,5,10,1549,1584,29,18,1578,1566,2011,254,274,301,0,,0,0.0,0.0,0.0,0.0,0.0
2024,4,25,4,2024-04-25,9E,5554,HNL,IAD,"Honolulu, HI",Hawaii,"Washington, DC",District of Columbia,1693,1870,-7,0,1686,1870,29,18,1715,1852,646,83,103,130,0,,0,0.0,0.0,0.0,0.0,0.0
2024,8,20,2,2024-08-20,F9,3383,PHL,DCA,"Philadelphia, PA",Pennsylvania,"Washington, DC",District of Columbia,1043,1368,2,0,1045,1368,7,7,1052,1361,2960,364,384,378,0,,0,0.0,0.0,0.0,0.0,0.0
2024,9,15,7,2024-09-15,AS,4791,PHL,PHX,"Philadelphia, PA",Pennsylvania,"Phoenix, AZ",Arizona,1939,1576,1,-5,1940,1571,17,3,1957,1568,362,54,74,74,0,,0,0.0,0.0,0.0,0.0,0.0
2024,12,24,2,2024-12-24,OH,6928,SLC,SFO,"Salt Lake City, UT",Utah,"San Francisco, CA",California,954,1285,1,0,955,1285,19,5,974,1280,513,64,84,88,0,,0,0.0,0.0,0.0,0.0,0.0
2024,7,16,2,2024-07-16,NK,7450,ORD,DCA,"Chicago, IL",Illinois,"Washington, DC",District of Columbia,1161,1220,11,10,1172,1230,5,8,1177,1222,2112,258,278,271,0,,0,0.0,0.0,0.0,0.0,0.0
2024,5,16,4,2024-05-16,NK,1256,MCO,BWI,"Orlando, FL",Florida,"Baltimore, MD",Maryland,1729,2195,-2,5,1727,2200,29,10,1756,2190,1794,232,252,271,0,,0,0.0,0.0,0.0,0.0,0.0
2024,11,13,3,2024-11-13,AS,3161,ORD,TPA,"Chicago, IL",Illinois,"Tampa, FL",Florida,1856,1154,-29,-20,1827,1134,27,18,1854,1116,1084,139,159,184,0,,0,0.0,0.0,0.0,0.0,0.0
2024,6,13,4,2024-06-13,9E,7257,JFK,PHL,"New York, NY",New York,"Philadelphia, PA",Pennsylvania,1544,2051,14,5,1558,2056,28,8,1586,2048,2908,369,389,405,1,,0,0.0,0.0,0.0,0.0,0.0
2024,8,12,1,2024-08-12,OO,6019,SEA,MIA,"Seattle, WA",Washington,"Miami, FL",Florida,1417,1149,0,5,1417,1154,20,16,1437,1138,1522,196,216,232,0,,0,0.0,0.0,0.0,0.0,0.0
2024,11,2,6,2024-11-02,G4,5993,BOS,DCA,"Boston, MA",Massachusetts,"Washington, DC",District of Columbia,2173,962,-20,-15,2153,947,19,12,2172,935,2034,246,266,277,0,,0,0.0,0.0,0.0,0.0,0.0
2024,8,21,3,2024-08-21,MQ,4545,PHL,HNL,"Philadelphia, PA",Pennsylvania,"Honolulu, HI",Hawaii,1588,1193,-20,-10,1568,1183,10,6,1578,1177,2463,315,335,331,0,,0,0.0,0.0,0.0,0.0,0.0
2024,6,20,4,2024-06-20,G4,6536,MDW,LAS,"Chicago, IL",Illinois,"Las Vegas, NV",Nevada,2100,2019,5,5,2105,2024,26,14,2131,2010,1582,191,211,231,0,,0,0.0,0.0,0.0,0.0,0.0
2024,5,31,5,2024-05-31,HA,1392,BWI,DFW,"Baltimore, MD",Maryland,"Dallas/Fort Worth, TX",Texas,587,2356,1,0,588,2356,19,9,607,2347,2376,294,314,322,0,,0,0.0,0.0,0.0,0.0,0.0
2024,11,10,7,2024-11-10,NK,9852,PHX,PHL,"Phoenix, AZ",Arizona,"Philadelphia, PA",Pennsylvania,2002,1222,3,10,2005,1232,24,9,2029,1223,1397,164,184,197,0,,0,0.0,0.0,0.0,0.0,0.0
2024,6,8,6,2024-06-08,G4,9275,JFK,DCA,"New York, NY",New York,"Washington, DC",District of Columbia,1566,1759,-5,-10,1561,1749,22,18,1583,1731,1350,171,191,211,0,,0,0.0,0.0,0.0,0.0,0.0
2024,4,5,5,2024-04-05,MQ,8002,HNL,DTW,"Honolulu, HI",Hawaii,"Detroit, MI",Michigan,1664,1033,-12,-20,1652,1013,21,3,1673,1010,1126,139,159,163,0,,0,0.0,0.0,0.0,0.0,0.0
2024,8,20,2,2024-08-20,9E,2167,EWR,MIA,"Newark, NJ",New Jersey,"Miami, FL",Florida,1897,917,-10,-10,1887,907,18,18,1905,889,2822,349,369,385,0,,0,0.0,0.0,0.0,0.0,0.0
2024,6,28,5,2024-06-28,UA,2079,DEN,MSP,"Denver, CO",Colorado,"Minneapolis, MN",Minnesota,1015,1134,0,0,1015,1134,26,5,1041,1129,1653,196,216,227,0,,0,0.0,0.0,0.0,0.0,0.0
2024,4,22,1,2024-04-22,UA,1836,SEA,LAS,"Seattle, WA",Washington,"Las Vegas, NV",Nevada,999,2124,2,0,1001,2124,29,17,1030,2107,2009,245,265,291,0,,0,0.0,0.0,0.0,0.0,0.0
2024,11,13,3,2024-11-13,AA,2018,MCO,HNL,"Orlando, FL",Florida,"Honolulu, HI",Hawaii,1802,1972,12,10,1814,1982,22,8,1836,1974,482,68,88,98,0,,0,0.0,0.0,0.0,0.0,0.0
2024,2,21,3,2024-02-21,B6,800,ORD,MSP,"Chicago, IL",Illinois,"Minneapolis, MN",Minnesota,825,1682,2,5,827,1687,21,15,848,1672,2224,274,294,310,0,,0,0.0,0.0,0.0,0.0,0.0
2024,9,24,2,2024-09-24,HA,4146,MSP,PDX,"Minneapolis, MN",Minnesota,"Portland, OR",Oregon,1941,1377,45,45,1986,1422,5,10,1991,1412,2421,296,316,311,0,,0,8.0,11.0,1.0,1.0,24.0
2024,10,21,1,2024-10-21,WN,2173,ATL,JFK,"Atlanta, GA",Georgia,"New York, NY",New York,1052,739,-10,-15,1042,724,18,14,1060,710,2820,343,363,375,0,,0,0.0,0.0,0.0,0.0,0.0
2024,4,22,1,2024-04-22,DL,4761,DEN,SEA,"Denver, CO",Colorado,"Seattle, WA",Washington,1387,1492,-13,-15,1374,1477,11,16,1385,1461,1450,185,205,212,0,,0,0.0,0.0,0.0,0.0,0.0
2024,4,10,3,2024-04-10,G4,494,BOS,HNL,"Boston, MA",Massachusetts,"Honolulu, HI",Hawaii,1495,1227,-23,-15,1472,1212,5,18,1477,1194,2859,347,367,370,0,,0,0.0,0.0,0.0,0.0,0.0
2024,4,22,1,2024-04-22,UA,3148,BWI,STL,"Baltimore, MD",Maryland,"St. Louis, MO",Missouri,2125,1827,0,0,2125,1827,29,16,2154,1811,1340,166,186,211,0,,0,0.0,0.0,0.0,0.0,0.0
2024,3,21,4,2024-03-21,HA,3552,ATL,HNL,"Atlanta, GA",Georgia,"Honolulu, HI",Hawaii,1492,757,-13,-10,1479,747,29,18,1508,729,391,43,63,90,0,,1,0.0,0.0,0.0,0.0,0.0
2024,7,5,5,2024-07-05,F9,622,BWI,SEA,"Baltimore, MD",Maryland,"Seattle, WA",Washington,2291,1953,4,5,2295,1958,7,8,2302,1950,2370,291,311,306,0,,0,0.0,0.0,0.0,0.0,0.0
2024,4,22,1,2024-04-22,AS,9854,BOS,EWR,"Boston, MA",Massachusetts,"Newark, NJ",New Jersey,1428,1573,-8,-15,1420,1558,15,6,1435,1552,468,61,81,82,0,,0,0.0,0.0,0.0,0.0,0.0
2024,1,2,2,2024-01-02,OH,8841,DFW,TPA,"Dallas/Fort Worth, TX",Texas,"Tampa, FL",Florida,1420,795,-9,-15,1411,780,22,10,1433,770,633,76,96,108,0,,0,0.0,0.0,0.0,0.0,0.0
2024,5,9,4,2024-05-09,MQ,1568,EWR,MIA,"Newark, NJ",New Jersey,"Miami, FL",Florida,807,2054,-4,0,803,2054,29,6,832,2048,2375,303,323,338,0,,0,0.0,0.0,0.0,0.0,0.0
2024,8,7,3,2024-08-07,B6,6330,JFK,MIA,"New York, NY",New York,"Miami, FL",Florida,1156,1323,2,-5,1158,1318,18,5,1176,1313,1743,211,231,234,0,,0,0.0,0.0,0.0,0.0,0.0
2024,2,23,5,2024-02-23,AA,8216,EWR,SAN,"Newark, NJ",New Jersey,"San Diego, CA",California,1830,1152,9,10,1839,1162,7,15,1846,1147,1663,210,230,232,0,,0,0.0,0.0,0.0,0.0,0.0
2024,12,8,7,2024-12-08,WN,9124,CLT,TPA,"Charlotte, NC",North Carolina,"Tampa, FL",Florida,969,2142,19,10,988,2152,6,6,994,2146,383,46,66,58,0,,0,0.0,0.0,0.0,0.0,0.0
2024,8,11,7,2024-08-11,UA,6911,BWI,MCO,"Baltimore, MD",Maryland,"Orlando, FL",Florida,1707,1461,-13,-15,1694,1446,24,13,1718,1433,335,39,59,76,0,,0,0.0,0.0,0.0,0.0,0.0
2024,8,12,1,2024-08-12,AA,1521,IAD,MIA,"Washington, DC",District of Columbia,"Miami, FL",Florida,2154,1483,6,10,2160,1493,19,18,2179,1475,1687,202,222,239,0,,0,0.0,0.0,0.0,0.0,0.0
2024,5,5,7,2024-05-05,YX,8087,LAS,SAN,"Las Vegas, NV",Nevada,"San Diego, CA",California,1124,2240,-4,0,1120,2240,11,17,1131,2223,884,105,125,133,0,,0,0.0,0.0,0.0,0.0,0.0
2024,5,9,4,2024-05-09,HA,385,MDW,DEN,"Chicago, IL",Illinois,"Denver, CO",Colorado,790,2095,9,0,799,2095,17,4,816,2091,553,65,85,86,0,,0,0.0,0.0,0.0,0.0,0.0
2024,2,22,4,2024-02-22,B6,2845,IAH,ORD,"Houston, TX",Texas,"Chicago, IL",Illinois,748,1057,-15,-15,733,1042,8,17,741,1025,1375,179,199,204,0,,0,0.0,0.0,0.0,0.0,0.0
2024,6,20,4,2024-06-20,AS,7208,ATL,IAD,"Atlanta, GA",Georgia,"Washington, DC",District of Columbia,823,1419,4,5,827,1424,12,8,839,1416,220,31,51,51,0,,0,0.0,0.0,0.0,0.0,0.0
2024,8,5,1,2024-08-05,DL,4564,PDX,HNL,"Portland, OR",Oregon,"Honolulu, HI",Hawaii,1966,1668,-14,-15,1952,1653,25,17,1977,1636,852,97,117,139,0,,0,0.0,0.0,0.0,0.0,0.0
2024,6,8,6,2024-06-08,HA,1545,JFK,DEN,"New York, NY",New York,"Denver, CO",Colorado,1103,637,-8,-10,1095,627,6,15,1101,612,1529,194,214,215,0,,0,0.0,0.0,0.0,0.0,0.0
2024,7,16,2,2024-07-16,OH,5937,SEA,BOS,"Seattle, WA",Washington,"Boston, MA",Massachusetts,558,1275,-14,-15,544,1260,17,5,561,1255,634,82,102,104,0,,0,0.0,0.0,0.0,0.0,0.0
2024,9,3,2,2024-09-03,UA,1566,JFK,LAX,"New York, NY",New York,"Los Angeles, CA",California,1520,2216,1,0,1521,2216,8,14,1529,2202,1227,154,174,176,0,,0,0.0,0.0,0.0,0.0,0.0
2024,11,19,2,2024-11-19,OO,7267,PDX,DTW,"Portland, OR",Oregon,"Detroit, MI",Michigan,768,940,-5,0,763,940,17,14,780,926,1956,251,271,282,0,,0,0.0,0.0,0.0,0.0,0.0
2024,7,21,7,2024-07-21,OH,9206,IAD,PDX,"Washington, DC",District of Columbia,"Portland, OR",Oregon,1841,2193,2,10,1843,2203,20,19,1863,2184,2117,259,279,298,0,,0,0.0,0.0,0.0,0.0,0.0
2024,7,2,2,2024-07-02,HA,8579,SEA,EWR,"Seattle, WA",Washington,"Newark, NJ",New Jersey,593,901,2,5,595,906,16,10,611,896,2179,263,283,289,0,,0,0.0,0.0,0.0,0.0,0.0
2024,5,2,4,2024-05-02,AS,4526,BWI,TPA,"Baltimore, MD",Maryland,"Tampa, FL",Florida,1777,1234,26,20,1803,1254,17,15,1820,1239,1129,131,151,163,0,,0,0.0,3.0,1.0,0.0,16.0
2024,9,11,3,2024-09-11,WN,6032,MCO,HNL,"Orlando, FL",Florida,"Honolulu, HI",Hawaii,1186,2330,7,5,1193,2335,27,14,1220,2321,1296,162,182,203,0,,1,0.0,0.0,0.0,0.0,0.0
2024,10,20,7,2024-10-20,G4,1278,ORD,LAS,"Chicago, IL",Illinois,"Las Vegas, NV",Nevada,1983,1816,-13,-10,1970,1806,5,18,1975,1788,2352,298,318,321,0,,0,0.0,0.0,0.0,0.0,0.0
2024,10,6,7,2024-10-06,B6,2651,SFO,SEA,"San Francisco, CA",California,"Seattle, WA",Washington,1014,1497,-6,0,1008,1497,27,13,1035,1484,331,36,56,76,0,,0,0.0,0.0,0.0,0.0,0.0
2024,11,20,3,2024-11-20,WN,4470,DEN,MSP,"Denver, CO",Colorado,"Minneapolis, MN",Minnesota,1032,1215,-7,0,1025,1215,7,11,1032,1204,2567,326,346,344,0,,0,0.0,0.0,0.0,0.0,0.0
2024,4,7,7,2024-04-07,DL,9880,STL,DCA,"St. Louis, MO",Missouri,"Washington, DC",District of Columbia,1627,2247,5,0,1632,2247,27,10,1659,2237,1047,127,147,164,0,,0,0.0,0.0,0.0,0.0,0.0
2024,7,16,2,2024-07-16,AS,6422,STL,LGA,"St. Louis, MO",Missouri,"New York, NY",New York,901,731,7,0,908,731,7,15,915,716,2272,293,313,315,0,,0,0.0,0.0,0.0,0.0,0.0
2024,8,27,2,2024-08-27,9E,4962,BOS,CLT,"Boston, MA",Massachusetts,"Charlotte, NC",North Carolina,1466,2231,-2,5,1464,2236,16,4,1480,2232,718,96,116,116,0,,0,0.0,0.0,0.0,0.0,0.0
2024,5,23,4,2024-05-23,DL,9279,DTW,ORD,"Detroit, MI",Michigan,"Chicago, IL",Illinois,1856,2218,-15,-15,1841,2203,28,15,1869,2188,2117,265,285,308,0,,0,0.0,0.0,0.0,0.0,0.0
2024,4,6,6,2024-04-06,YX,5955,LGA,HNL,"New York, NY",New York,"Honolulu, HI",Hawaii,1220,2091,2,5,1222,2096,8,13,1230,2083,2932,363,383,384,0,,0,0.0,0.0,0.0,0.0,0.0
2024,7,19,5,2024-07-19,MQ,1303,PHX,EWR,"Phoenix, AZ",Arizona,"Newark, NJ",New Jersey,1376,1793,-25,-15,1351,1778,5,4,1356,1774,1740,226,246,235,0,,0,0.0,0.0,0.0,0.0,0.0
2024,5,3,5,2024-05-03,NK,7449,MCO,EWR,"Orlando, FL",Florida,"Newark, NJ",New Jersey,1107,2184,-18,-20,1089,2164,21,10,1110,2154,476,57,77,88,0,,0,0.0,0.0,0.0,0.0,0.0
2024,7,5,5,2024-07-05,UA,6486,TPA,SAN,"Tampa, FL",Florida,"San Diego, CA",California,592,1544,-7,0,585,1544,24,9,609,1535,2921,365,385,398,0,,0,0.0,0.0,0.0,0.0,0.0
2024,11,21,4,2024-11-21,G4,1219,DTW,LAS,"Detroit, MI",Michigan,"Las Vegas, NV",Nevada,2080,1484,-7,0,2073,1484,13,3,2086,1481,2679,336,356,352,0,,0,0.0,0.0,0.0,0.0,0.0
2024,12,14,6,2024-12-14,OO,8488,BOS,ATL,"Boston, MA",Massachusetts,"Atlanta, GA",Georgia,1073,2270,-27,-20,1046,2250,9,16,1055,2234,2338,285,305,310,0,,0,0.0,0.0,0.0,0.0,0.0
2024,9,15,7,2024-09-15,B6,4075,LAX,LGA,"Los Angeles, CA",California,"New York, NY",New York,2065,1888,2,0,2067,1888,25,10,2092,1878,2308,285,305,320,0,,0,0.0,0.0,0.0,0.0,0.0
2024,5,27,1,2024-05-27,F9,8817,PDX,DFW,"Portland, OR",Oregon,"Dallas/Fort Worth, TX",Texas,1470,1822,8,0,1478,1822,7,3,1485,1819,534,59,79,69,0,,0,0.0,0.0,0.0,0.0,0.0
2024,9,8,7,2024-09-08,OO,9702,JFK,PHL,"New York, NY",New York,"Philadelphia, PA",Pennsylvania,936,1906,-10,-15,926,1891,25,19,951,1872,2878,362,382,406,0,,0,0.0,0.0,0.0,0.0,0.0
2024,12,11,3,2024-12-11,AS,1392,DCA,LAX,"Washington, DC",District of Columbia,"Los Angeles, CA",California,1533,2028,8,5,1541,2033,11,6,1552,2027,822,108,128,125,0,,0,0.0,0.0,0.0,0.0,0.0
2024,5,26,7,2024-05-26,OH,9486,DEN,PHL,"Denver, CO",Colorado,"Philadelphia, PA",Pennsylvania,955,2170,-11,-10,944,2160,7,8,951,2152,2303,278,298,293,0,,0,0.0,0.0,0.0,0.0,0.0
2024,5,27,1,2024-05-27,YX,3755,PHL,BOS,"Philadelphia, PA",Pennsylvania,"Boston, MA",Massachusetts,914,2103,-1,5,913,2108,9,3,922,2105,1416,178,198,190,0,,0,0.0,0.0,0.0,0.0,0.0
2024,12,17,2,2024-12-17,9E,4886,IAD,CLT,"Washington, DC",District of Columbia,"Charlotte, NC",North Carolina,2041,1827,-1,-5,2040,1822,16,5,2056,1817,2832,355,375,376,0,,0,0.0,0.0,0.0,0.0,0.0
2024,7,17,3,2024-07-17,F9,2317,ORD,BWI,"Chicago, IL",Illinois,"Baltimore, MD",Maryland,1898,1070,-5,0,1893,1070,7,4,1900,1066,878,117,137,128,0,,0,0.0,0.0,0.0,0.0,0.0
2024,11,3,7,2024-11-03,MQ,6690,LGA,ATL,"New York, NY",New York,"Atlanta, GA",Georgia,2054,948,18,10,2072,958,5,19,2077,939,1249,163,183,187,0,,0,0.0,0.0,0.0,0.0,0.0
2024,5,7,2,2024-05-07,MQ,1117,TPA,LAS,"Tampa, FL",Florida,"Las Vegas, NV",Nevada,2047,642,13,10,2060,652,26,11,2086,641,2262,281,301,318,0,,0,0.0,0.0,0.0,0.0,0.0
2024,2,8,4,2024-02-08,OO,5276,LAX,STL,"Los Angeles, CA",California,"St. Louis, MO",Missouri,1896,1375,5,5,1901,1380,7,10,1908,1370,2037,252,272,269,0,,0,0.0,0.0,0.0,0.0,0.0
2024,12,3,2,2024-12-03,YX,3690,SAN,TPA,"San Diego, CA",California,"Tampa, FL",Florida,1203,1081,-18,-10,1185,1071,20,17,1205,1054,2525,320,340,357,0,,0,0.0,0.0,0.0,0.0,0.0
2024,12,25,3,2024-12-25,UA,8339,DEN,DCA,"Denver, CO",Colorado,"Washington, DC",District of Columbia,2138,2000,-29,-20,2109,1980,22,8,2131,1972,1133,131,151,161,0,,0,0.0,0.0,0.0,0.0,0.0
2024,5,8,3,2024-05-08,UA,9119,LAX,LGA,"Los Angeles, CA",California,"New York, NY",New York,1381,677,-5,0,1376,677,7,8,1383,669,1739,222,242,237,0,,0,0.0,0.0,0.0,0.0,0.0
2024,9,23,1,2024-09-23,B6,6276,LGA,ORD,"New York, NY",New York,"Chicago, IL",Illinois,1261,1659,-8,-5,1253,1654,9,10,1262,1644,2268,280,300,299,0,,0,0.0,0.0,0.0,0.0,0.0
2024,5,30,4,2024-05-30,OO,6747,EWR,BWI,"Newark, NJ",New Jersey,"Baltimore, MD",Maryland,2279,2006,5,15,2284,2021,9,5,2293,2016,245,38,58,52,0,,0,0.0,0.0,0.0,0.0,0.0
2024,10,24,4,2024-10-24,9E,4822,MSP,MDW,"Minneapolis, MN",Minnesota,"Chicago, IL",Illinois,1962,1415,-2,-5,1960,1410,13,14,1973,1396,2336,283,303,310,0,,0,0.0,0.0,0.0,0.0,0.0
2024,4,8,1,2024-04-08,UA,6115,SEA,MDW,"Seattle, WA",Washington,"Chicago, IL",Illinois,1718,1797,0,-5,1718,1792,16,10,1734,1782,707,95,115,121,0,,0,0.0,0.0,0.0,0.0,0.0
2024,9,19,4,2024-09-19,F9,5222,MCO,MIA,"Orlando, FL",Florida,"Miami, FL",Florida,764,1527,6,0,770,1527,20,13,790,1514,2520,324,344,357,0,,0,0.0,0.0,0.0,0.0,0.0
2024,9,8,7,2024-09-08,9E,7783,IAD,BOS,"Washington, DC",District of Columbia,"Boston, MA",Massachusetts,1006,1246,2,5,1008,1251,13,17,1021,1234,1319,173,193,203,0,,0,0.0,0.0,0.0,0.0,0.0
2024,5,23,4,2024-05-23,MQ,2189,MSP,CLT,"Minneapolis, MN",Minnesota,"Charlotte, NC",North Carolina,1145,1953,-4,-10,1141,1943,22,15,1163,1928,2999,381,401,418,0,,0,0.0,0.0,0.0,0.0,0.0
2024,12,11,3,2024-12-11,YX,2156,SFO,TPA,"San Francisco, CA",California,"Tampa, FL",Florida,1396,1251,17,15,1413,1266,26,15,1439,1251,1096,140,160,181,0,,0,0.0,0.0,0.0,0.0,0.0
2024,4,21,7,2024-04-21,OH,9110,SLC,STL,"Salt Lake City, UT",Utah,"St. Louis, MO",Missouri,1949,1678,8,0,1957,1678,29,16,1986,1662,2998,370,390,415,0,,0,0.0,0.0,0.0,0.0,0.0
2024,2,29,4,2024-02-29,F9,3780,HNL,CLT,"Honolulu, HI",Hawaii,"Charlotte, NC",North Carolina,1360,1363,8,10,1368,1373,29,11,1397,1362,2192,270,290,310,0,,0,0.0,0.0,0.0,0.0,0.0
2024,1,2,2,2024-01-02,DL,4985,ATL,PDX,"Atlanta, GA",Georgia,"Portland, OR",Oregon,1188,878,-8,0,1180,878,15,5,1195,873,1716,208,228,228,0,,0,0.0,0.0,0.0,0.0,0.0
2024,10,30,3,2024-10-30,YX,3214,BWI,SEA,"Baltimore, MD",Maryland,"Seattle, WA",Washington,1366,1058,12,5,1378,1063,26,14,1404,1049,417,61,81,101,0,,0,0.0,0.0,0.0,0.0,0.0
2024,9,10,2,2024-09-10,WN,7483,DCA,IAH,"Washington, DC",District of Columbia,"Houston, TX",Texas,1622,1291,-25,-15,1597,1276,21,11,1618,1265,1514,190,210,222,0,,0,0.0,0.0,0.0,0.0,0.0
2024,5,19,7,2024-05-19,9E,1729,SAN,DCA,"San Diego, CA",California,"Washington, DC",District of Columbia,1553,1124,7,5,1560,1129,5,14,1565,1115,2672,336,356,355,0,,0,0.0,0.0,0.0,0.0,0.0
2024,2,6,2,2024-02-06,MQ,1643,PHL,SFO,"Philadelphia, PA",Pennsylvania,"San Francisco, CA",California,1814,2339,2,0,1816,2339,29,13,1845,2326,795,105,125,147,0,,0,0.0,0.0,0.0,0.0,0.0
2024,6,8,6,2024-06-08,AA,7612,DEN,ORD,"Denver, CO",Colorado,"Chicago, IL",Illinois,2098,2078,-4,-5,2094,2073,7,11,2101,2062,1144,147,167,165,0,,0,0.0,0.0,0.0,0.0,0.0
2024,1,9,2,2024-01-09,WN,5869,MCO,JFK,"Orlando, FL",Florida,"New York, NY",New York,986,2198,-25,-15,961,2183,9,7,970,2176,2785,353,373,369,0,,0,0.0,0.0,0.0,0.0,0.0
2024,8,20,2,2024-08-20,YX,2004,IAD,PHX,"Washington, DC",District of Columbia,"Phoenix, AZ",Arizona,1929,1091,4,5,1933,1096,26,12,1959,1084,2480,312,332,350,0,,0,0.0,0.0,0.0,0.0,0.0
2024,4,8,1,2024-04-08,MQ,1536,LGA,PDX,"New York, NY",New York,"Portland, OR",Oregon,527,673,-7,-15,520,658,5,11,525,647,361,45,65,61,0,,0,0.0,0.0,0.0,0.0,0.0
2024,5,26,7,2024-05-26,MQ,5131,SFO,IAH,"San Francisco, CA",California,"Houston, TX",Texas,1669,2078,-14,-10,1655,2068,19,3,1674,2065,2998,366,386,388,0,,0,0.0,0.0,0.0,0.0,0.0
2024,10,30,3,2024-10-30,OO,3417,SLC,ATL,"Salt Lake City, UT",Utah,"Atlanta, GA",Georgia,787,1418,-12,-15,775,1403,21,15,796,1388,1809,216,236,252,0,,0,0.0,0.0,0.0,0.0,0.0
2024,7,26,5,2024-07-26,MQ,4216,SEA,DFW,"Seattle, WA",Washington,"Dallas/Fort Worth, TX",Texas,1080,754,-25,-20,1055,734,8,14,1063,720,2469,303,323,325,0,,0,0.0,0.0,0.0,0.0,0.0
2024,5,10,5,2024-05-10,WN,9290,HNL,BOS,"Honolulu, HI",Hawaii,"Boston, MA",Massachusetts,1449,1118,0,5,1449,1123,26,13,1475,1110,1483,182,202,221,0,,0,0.0,0.0,0.0,0.0,0.0
2024,5,31,5,2024-05-31,9E,9723,HNL,DTW,"Honolulu, HI",Hawaii,"Detroit, MI",Michigan,751,974,-12,-10,739,964,28,11,767,953,558,63,83,102,0,,0,0.0,0.0,0.0,0.0,0.0
2024,2,23,5,2024-02-23,G4,4652,PDX,SAN,"Portland, OR",Oregon,"San Diego, CA",California,1685,1929,-6,-15,1679,1914,27,17,1706,1897,2473,305,325,349,0,,0,0.0,0.0,0.0,0.0,0.0
2024,4,29,1,2024-04-29,HA,5663,DEN,SAN,"Denver, CO",Colorado,"San Diego, CA",California,1426,942,0,-5,1426,937,18,15,1444,922,2512,306,326,339,0,,0,0.0,0.0,0.0,0.0,0.0
2024,6,9,7,2024-06-09,UA,6223,LAS,IAH,"Las Vegas, NV",Nevada,"Houston, TX",Texas,609,1264,-6,0,603,1264,6,14,609,1250,268,31,51,51,0,,0,0.0,0.0,0.0,0.0,0.0
2024,4,25,4,2024-04-25,HA,3161,DTW,SFO,"Detroit, MI",Michigan,"San Francisco, CA",California,1143,643,4,0,1147,643,8,16,1155,627,2225,281,301,305,0,,0,0.0,0.0,0.0,0.0,0.0
2024,3,15,5,2024-03-15,DL,8189,ATL,MDW,"Atlanta, GA",Georgia,"Chicago, IL",Illinois,897,1147,-15,-5,882,1142,9,11,891,1131,208,17,37,37,0,,0,0.0,0.0,0.0,0.0,0.0
2024,4,22,1,2024-04-22,G4,8556,SFO,SAN,"San Francisco, CA",California,"San Diego, CA",California,1794,2064,-7,0,1787,2064,28,12,1815,2052,480,52,72,92,0,,0,0.0,0.0,0.0,0.0,0.0
2024,4,13,6,2024-04-13,G4,3831,BOS,DFW,"Boston, MA",Massachusetts,"Dallas/Fort Worth, TX",Texas,1711,1720,-6,-5,1705,1715,11,8,1716,1707,1775,229,249,248,0,,0,0.0,0.0,0.0,0.0,0.0
2024,12,5,4,2024-12-05,AA,6427,SEA,TPA,"Seattle, WA",Washington,"Tampa, FL",Florida,2055,764,5,10,2060,774,8,12,2068,762,1418,176,196,196,0,,0,0.0,0.0,0.0,0.0,0.0
2024,9,10,2,2024-09-10,AS,3417,SEA,PDX,"Seattle, WA",Washington,"Portland, OR",Oregon,775,1345,-29,-20,746,1325,12,17,758,1308,992,115,135,144,0,,0,0.0,0.0,0.0,0.0,0.0
2024,8,14,3,2024-08-14,9E,2146,PHX,LGA,"Phoenix, AZ",Arizona,"New York, NY",New York,1188,1726,9,10,1197,1736,15,10,1212,1726,506,65,85,90,0,,0,0.0,0.0,0.0,0.0,0.0
2024,4,21,7,2024-04-21,F9,3244,SAN,SLC,"San Diego, CA",California,"Salt Lake City, UT",Utah,2134,1035,-2,-10,2132,1025,12,4,2144,1021,345,46,66,62,0,,0,0.0,0.0,0.0,0.0,0.0
2024,4,8,1,2024-04-08,UA,3321,TPA,LAX,"Tampa, FL",Florida,"Los Angeles, CA",California,746,2004,3,5,749,2009,8,6,757,2003,642,88,108,102,0,,0,0.0,0.0,0.0,0.0,0.0
2024,6,1,6,2024-06-01,OO,5164,STL,BWI,"St. Louis, MO",Missouri,"Baltimore, MD",Maryland,1847,1046,-5,-5,1842,1041,15,11,1857,1030,508,65,85,91,0,,0,0.0,0.0,0.0,0.0,0.0
2024,12,14,6,2024-12-14,G4,9545,EWR,DCA,"Newark, NJ",New Jersey,"Washington, DC",District of Columbia,1541,1630,-17,-10,1524,1620,16,18,1540,1602,681,81,101,115,0,,0,0.0,0.0,0.0,0.0,0.0
2024,12,3,2,2024-12-03,DL,822,MSP,BOS,"Minneapolis, MN",Minnesota,"Boston, MA",Massachusetts,907,1717,-1,0,906,1717,6,7,912,1710,1631,195,215,208,0,,0,0.0,0.0,0.0,0.0,0.0
2024,7,12,5,2024-07-12,AS,7875,SFO,PHX,"San Francisco, CA",California,"Phoenix, AZ",Arizona,1934,1043,0,5,1934,1048,19,17,1953,1031,1796,214,234,250,0,,0,0.0,0.0,0.0,0.0,0.0
2024,11,5,2,2024-11-05,AA,7664,LAS,STL,"Las Vegas, NV",Nevada,"St. Louis, MO",Missouri,624,1078,-13,-5,611,1073,18,17,629,1056,2489,320,340,355,0,,0,0.0,0.0,0.0,0.0,0.0
2024,6,11,2,2024-06-11,MQ,8375,STL,DFW,"St. Louis, MO",Missouri,"Dallas/Fort Worth, TX",Texas,1843,2256,2,0,1845,2256,23,14,1868,2242,1792,226,246,263,0,,0,0.0,0.0,0.0,0.0,0.0
2024,7,26,5,2024-07-26,NK,4935,MDW,JFK,"Chicago, IL",Illinois,"New York, NY",New York,652,2117,-7,-15,645,2102,25,18,670,2084,1556,189,209,232,0,,0,0.0,0.0,0.0,0.0,0.0
2024,6,17,1,2024-06-17,UA,3919,MSP,SAN,"Minneapolis, MN",Minnesota,"San Diego, CA",California,2104,636,7,15,2111,651,21,13,2132,638,782,98,118,132,0,,0,0.0,0.0,0.0,0.0,0.0
2024,6,9,7,2024-06-09,NK,3464,DCA,MDW,"Washington, DC",District of Columbia,"Chicago, IL",Illinois,1157,2156,19,10,1176,2166,20,9,1196,2157,2618,326,346,355,0,,0,0.0,0.0,0.0,0.0,0.0
2024,3,8,5,2024-03-08,WN,6189,MCO,PHL,"Orlando, FL",Florida,"Philadelphia, PA",Pennsylvania,2080,697,2,-5,2082,692,9,18,2091,674,2921,357,377,384,0,,0,0.0,0.0,0.0,0.0,0.0
2024,10,15,2,2024-10-15,G4,4418,SAN,SLC,"San Diego, CA",California,"Salt Lake City, UT",Utah,519,1413,6,5,525,1418,24,12,549,1406,253,21,41,57,0,,0,0.0,0.0,0.0,0.0,0.0
2024,10,3,4,2024-10-03,B6,7036,SFO,DFW,"San Francisco, CA",California,"Dallas/Fort Worth, TX",Texas,746,1644,-4,-5,742,1639,25,18,767,1621,776,99,119,142,0,,0,0.0,0.0,0.0,0.0,0.0
2024,10,30,3,2024-10-30,UA,2880,MDW,PDX,"Chicago, IL",Illinois,"Portland, OR",Oregon,1913,1855,6,5,1919,1860,5,3,1924,1857,1468,174,194,182,0,,0,0.0,0.0,0.0,0.0,0.0
2024,5,14,2,2024-05-14,HA,7498,HNL,IAH,"Honolulu, HI",Hawaii,"Houston, TX",Texas,1870,1067,-4,0,1866,1067,14,7,1880,1060,399,57,77,78,0,,0,0.0,0.0,0.0,0.0,0.0
2024,7,13,6,2024-07-13,F9,2552,HNL,LGA,"Honolulu, HI",Hawaii,"New York, NY",New York,1999,953,-2,0,1997,953,11,9,2008,944,2682,344,364,364,0,,0,0.0,0.0,0.0,0.0,0.0
2024,5,7,2,2024-05-07,AS,5388,IAD,JFK,"Washington, DC",District of Columbia,"New York, NY",New York,1726,671,-14,-15,1712,656,14,8,1726,648,1596,191,211,213,0,,0,0.0,0.0,0.0,0.0,0.0
2024,2,2,5,2024-02-02,DL,8620,LAS,MSP,"Las Vegas, NV",Nevada,"Minneapolis, MN",Minnesota,1532,1975,28,20,1560,1995,29,19,1589,1976,1608,209,229,257,0,,0,2.0,4.0,0.0,0.0,14.0
2024,6,24,1,2024-06-24,UA,525,SEA,IAD,"Seattle, WA",Washington,"Washington, DC",District of Columbia,2215,1675,3,10,2218,1685,20,14,2238,1671,2912,368,388,402,0,,0,0.0,0.0,0.0,0.0,0.0
2024,1,22,1,2024-01-22,F9,9061,DFW,BOS,"Dallas/Fort Worth, TX",Texas,"Boston, MA",Massachusetts,2191,1845,4,5,2195,1850,9,14,2204,1836,1444,188,208,211,0,,0,0.0,0.0,0.0,0.0,0.0
2024,8,25,7,2024-08-25,HA,4075,TPA,MSP,"Tampa, FL",Florida,"Minneapolis, MN",Minnesota,1030,1623,3,-5,1033,1618,23,3,1056,1615,763,94,114,120,0,,0,0.0,0.0,0.0,0.0,0.0
2024,6,6,4,2024-06-06,9E,8899,SFO,DFW,"San Francisco, CA",California,"Dallas/Fort Worth, TX",Texas,602,1948,-4,-10,598,1938,29,4,627,1934,1294,161,181,194,1,,1,0.0,0.0,0.0,0.0,0.0
2024,2,7,3,2024-02-07,NK,6769,LGA,HNL,"New York, NY",New York,"Honolulu, HI",Hawaii,1769,1589,7,0,1776,1589,10,16,1786,1573,682,89,109,115,0,,0,0.0,0.0,0.0,0.0,0.0
2024,8,17,6,2024-08-17,9E,2224,MIA,SAN,"Miami, FL",Florida,"San Diego, CA",California,1096,1059,9,10,1105,1069,16,12,1121,1057,855,103,123,131,0,,0,0.0,0.0,0.0,0.0,0.0
2024,12,30,1,2024-12-30,AS,1400,LAX,MSP,"Los Angeles, CA",California,"Minneapolis, MN",Minnesota,1842,1790,16,15,1858,1805,10,16,1868,1789,1953,244,264,270,0,,0,0.0,0.0,0.0,0.0,0.0
2024,2,20,2,2024-02-20,OH,5115,DCA,LGA,"Washington, DC",District of Columbia,"New York, NY",New York,850,1906,-1,-10,849,1896,14,5,863,1891,2572,327,347,346,0,,0,0.0,0.0,0.0,0.0,0.0
2024,9,20,5,2024-09-20,AA,8757,EWR,IAH,"Newark, NJ",New Jersey,"Houston, TX",Texas,733,1100,-3,0,730,1100,14,15,744,1085,204,16,36,45,0,,0,0.0,0.0,0.0,0.0,0.0
2024,10,9,3,2024-10-09,G4,2064,PDX,ORD,"Portland, OR",Oregon,"Chicago, IL",Illinois,2170,1316,13,5,2183,1321,17,7,2200,1314,1808,233,253,257,0,,0,0.0,0.0,0.0,0.0,0.0
2024,1,27,6,2024-01-27,UA,5667,CLT,SAN,"Charlotte, NC",North Carolina,"San Diego, CA",California,536,966,-20,-10,516,956,23,7,539,949,1148,141,161,171,1,,0,0.0,0.0,0.0,0.0,0.0
2024,8,13,2,2024-08-13,OH,5379,LAS,JFK,"Las Vegas, NV",Nevada,"New York, NY",New York,1868,2273,-12,-5,1856,2268,21,15,1877,2253,1218,148,168,184,0,,0,0.0,0.0,0.0,0.0,0.0
2024,10,3,4,2024-10-03,B6,2460,DTW,SEA,"Detroit, MI",Michigan,"Seattle, WA",Washington,2127,1659,-15,-10,2112,1649,20,17,2132,1632,1463,181,201,218,0,,0,0.0,0.0,0.0,0.0,0.0
2024,10,12,6,2024-10-12,NK,2139,MSP,BWI,"Minneapolis, MN",Minnesota,"Baltimore, MD",Maryland,791,1206,-2,5,789,1211,8,8,797,1203,2010,248,268,264,0,,0,0.0,0.0,0.0,0.0,0.0
2024,4,6,6,2024-04-06,HA,1284,IAH,SEA,"Houston, TX",Texas,"Seattle, WA",Washington,516,1127,15,10,531,1137,24,14,555,1123,1414,178,198,216,0,,0,0.0,0.0,0.0,0.0,0.0
2024,10,10,4,2024-10-10,NK,4034,DTW,LGA,"Detroit, MI",Michigan,"New York, NY",New York,589,1598,7,10,596,1608,7,18,603,1590,1229,144,164,169,0,,0,0.0,0.0,0.0,0.0,0.0
2024,11,12,2,2024-11-12,UA,5894,EWR,SFO,"Newark, NJ",New Jersey,"San Francisco, CA",California,1871,1348,3,5,1874,1353,9,17,1883,1336,1542,191,211,217,0,,0,0.0,0.0,0.0,0.0,0.0
2024,10,30,3,2024-10-30,HA,8272,HNL,SFO,"Honolulu, HI",Hawaii,"San Francisco, CA",California,1176,2299,-1,-5,1175,2294,17,18,1192,2276,2146,274,294,309,0,,0,0.0,0.0,0.0,0.0,0.0
2024,5,26,7,2024-05-26,WN,877,MIA,HNL,"Miami, FL",Florida,"Honolulu, HI",Hawaii,1476,1201,12,5,1488,1206,18,16,1506,1190,1720,220,240,254,0,,0,0.0,0.0,0.0,0.0,0.0
2024,1,4,4,2024-01-04,9E,3479,BWI,SEA,"Baltimore, MD",Maryland,"Seattle, WA",Washington,1967,1219,2,10,1969,1229,13,18,1982,1211,1638,205,225,236,0,,0,0.0,0.0,0.0,0.0,0.0
2024,2,4,7,2024-02-04,NK,2518,JFK,BOS,"New York, NY",New York,"Boston, MA",Massachusetts,752,2219,6,0,758,2219,13,5,771,2214,2140,262,282,280,0,,0,0.0,0.0,0.0,0.0,0.0
2024,7,10,3,2024-07-10,F9,4177,LAX,IAD,"Los Angeles, CA",California,"Washington, DC",District of Columbia,1316,854,-15,-5,1301,849,12,4,1313,845,1237,158,178,174,0,,0,0.0,0.0,0.0,0.0,0.0
2024,2,18,7,2024-02-18,DL,2539,PHX,SLC,"Phoenix, AZ",Arizona,"Salt Lake City, UT",Utah,2116,1529,11,15,2127,1544,14,12,2141,1532,1431,182,202,208,0,,0,0.0,0.0,0.0,0.0,0.0
2024,1,17,3,2024-01-17,G4,7904,BWI,IAH,"Baltimore, MD",Maryland,"Houston, TX",Texas,683,1276,9,10,692,1286,26,16,718,1270,201,30,50,72,0,,0,0.0,0.0,0.0,0.0,0.0
2024,6,20,4,2024-06-20,NK,5369,SFO,ORD,"San Francisco, CA",California,"Chicago, IL",Illinois,789,1823,14,10,803,1833,24,19,827,1814,601,67,87,110,0,,0,0.0,0.0,0.0,0.0,0.0
2024,8,7,3,2024-08-07,MQ,5687,SEA,IAH,"Seattle, WA",Washington,"Houston, TX",Texas,1260,1435,17,15,1277,1450,22,19,1299,1431,729,93,113,134,0,,0,0.0,0.0,0.0,0.0,0.0
2024,6,6,4,2024-06-06,F9,2089,STL,DCA,"St. Louis, MO",Missouri,"Washington, DC",District of Columbia,1738,1268,-11,-5,1727,1263,16,5,1743,1258,961,127,147,148,0,,0,0.0,0.0,0.0,0.0,0.0
2024,2,15,4,2024-02-15,AS,7968,DEN,STL,"Denver, CO",Colorado,"St. Louis, MO",Missouri,657,1654,6,10,663,1664,17,17,680,1647,2329,283,303,317,0,,0,0.0,0.0,0.0,0.0,0.0
2024,1,6,6,2024-01-06,AS,9358,LAS,PDX,"Las Vegas, NV",Nevada,"Portland, OR",Oregon,1422,2201,3,0,1425,2201,20,14,1445,2187,992,117,137,151,0,,0,0.0,0.0,0.0,0.0,0.0
2024,4,8,1,2024-04-08,G4,1044,MIA,LAX,"Miami, FL",Florida,"Los Angeles, CA",California,1190,1200,-17,-20,1173,1180,7,18,1180,1162,1098,131,151,156,0,,0,0.0,0.0,0.0,0.0,0.0
2024,8,20,2,2024-08-20,WN,8320,BWI,ORD,"Baltimore, MD",Maryland,"Chicago, IL",Illinois,892,1085,-2,0,890,1085,13,8,903,1077,1709,222,242,243,0,,1,0.0,0.0,0.0,0.0,0.0
2024,2,6,2,2024-02-06,OO,1997,ORD,MIA,"Chicago, IL",Illinois,"Miami, FL",Florida,1543,858,-5,0,1538,858,20,16,1558,842,768,91,111,127,0,,0,0.0,0.0,0.0,0.0,0.0
2024,10,6,7,2024-10-06,OO,5851,DEN,PDX,"Denver, CO",Colorado,"Portland, OR",Oregon,1994,852,-2,-10,1992,842,21,5,2013,837,1683,206,226,232,0,,0,0.0,0.0,0.0,0.0,0.0
2024,12,14,6,2024-12-14,B6,5250,LAS,IAD,"Las Vegas, NV",Nevada,"Washington, DC",District of Columbia,930,1093,24,20,954,1113,20,19,974,1094,2045,264,284,303,0,,0,6.0,3.0,1.0,0.0,10.0
2024,10,28,1,2024-10-28,G4,1797,ATL,MIA,"Atlanta, GA",Georgia,"Miami, FL",Florida,2182,1857,-10,-15,2172,1842,27,8,2199,1834,2380,299,319,334,0,,0,0.0,0.0,0.0,0.0,0.0
2024,6,29,6,2024-06-29,AA,5985,BOS,DEN,"Boston, MA",Massachusetts,"Denver, CO",Colorado,1496,1730,16,15,1512,1745,14,9,1526,1736,2150,271,291,294,0,,0,0.0,0.0,0.0,0.0,0.0
2024,4,4,4,2024-04-04,WN,1765,BWI,DEN,"Baltimore, MD",Maryland,"Denver, CO",Colorado,1504,2204,-18,-10,1486,2194,26,8,1512,2186,1458,178,198,212,0,,0,0.0,0.0,0.0,0.0,0.0
2024,4,8,1,2024-04-08,NK,9862,SLC,IAH,"Salt Lake City, UT",Utah,"Houston, TX",Texas,1591,1389,-13,-5,1578,1384,22,14,1600,1370,2375,296,316,332,0,,0,0.0,0.0,0.0,0.0,0.0
2024,7,6,6,2024-07-06,OO,9051,IAD,PHX,"Washington, DC",District of Columbia,"Phoenix, AZ",Arizona,1600,935,-10,-5,1590,930,25,19,1615,911,627,79,99,123,0,,0,0.0,0.0,0.0,0.0,0.0
2024,4,25,4,2024-04-25,HA,9643,IAH,SAN,"Houston, TX",Texas,"San Diego, CA",California,601,2336,13,5,614,2341,6,8,620,2333,543,74,94,88,0,,0,0.0,0.0,0.0,0.0,0.0
2024,7,9,2,2024-07-09,G4,9560,STL,TPA,"St. Louis, MO",Missouri,"Tampa, FL",Florida,1151,652,-9,-10,1142,642,18,17,1160,625,1348,175,195,210,0,,0,0.0,0.0,0.0,0.0,0.0
2024,9,9,1,2024-09-09,HA,1885,MDW,BOS,"Chicago, IL",Illinois,"Boston, MA",Massachusetts,1392,1286,35,30,1427,1316,29,7,1456,1309,995,115,135,151,0,,0,3.0,0.0,0.0,0.0,27.0
2024,6,9,7,2024-06-09,OH,6048,LAX,LGA,"Los Angeles, CA",California,"New York, NY",New York,1084,1665,12,5,1096,1670,9,17,1105,1653,2882,352,372,378,0,,0,0.0,0.0,0.0,0.0,0.0
2024,9,12,4,2024-09-12,MQ,2707,SFO,SLC,"San Francisco, CA",California,"Salt Lake City, UT",Utah,706,1883,-2,5,704,1888,10,13,714,1875,1996,258,278,281,0,,0,0.0,0.0,0.0,0.0,0.0
2024,11,18,1,2024-11-18,OO,8690,JFK,DCA,"New York, NY",New York,"Washington, DC",District of Columbia,712,1992,-6,-15,706,1977,24,11,730,1966,916,110,130,145,0,,0,0.0,0.0,0.0,0.0,0.0
2024,5,7,2,2024-05-07,YX,2730,DFW,MCO,"Dallas/Fort Worth, TX",Texas,"Orlando, FL",Florida,578,809,2,0,580,809,5,6,585,803,1238,144,164,155,0,,0,0.0,0.0,0.0,0.0,0.0
2024,1,18,4,2024-01-18,MQ,7760,ORD,PHL,"Chicago, IL",Illinois,"Philadelphia, PA",Pennsylvania,1636,2089,17,15,1653,2104,19,5,1672,2099,1328,175,195,199,0,,0,0.0,0.0,0.0,0.0,0.0
2024,10,7,1,2024-10-07,9E,9961,MDW,PDX,"Chicago, IL",Illinois,"Portland, OR",Oregon,2288,1665,-19,-10,2269,1655,7,15,2276,1640,1749,209,229,231,0,,1,0.0,0.0,0.0,0.0,0.0
2024,8,10,6,2024-08-10,AS,338,SLC,LAS,"Salt Lake City, UT",Utah,"Las Vegas, NV",Nevada,632,1612,-17,-15,615,1597,25,8,640,1589,418,59,79,92,0,,0,0.0,0.0,0.0,0.0,0.0
2024,2,23,5,2024-02-23,YX,3636,MSP,PDX,"Minneapolis, MN",Minnesota,"Portland, OR",Oregon,1720,1976,0,0,1720,1976,23,3,1743,1973,1617,211,231,237,0,,0,0.0,0.0,0.0,0.0,0.0
2024,2,27,2,2024-02-27,F9,3961,SFO,IAD,"San Francisco, CA",California,"Washington, DC",District of Columbia,1548,1281,7,15,1555,1296,28,12,1583,1284,2846,358,378,398,0,,0,0.0,0.0,0.0,0.0,0.0
2024,11,18,1,2024-11-18,MQ,9438,MSP,PHL,"Minneapolis, MN",Minnesota,"Philadelphia, PA",Pennsylvania,971,1493,6,0,977,1493,22,7,999,1486,2604,319,339,348,0,,0,0.0,0.0,0.0,0.0,0.0
2024,12,25,3,2024-12-25,G4,9849,MIA,JFK,"Miami, FL",Florida,"New York, NY",New York,2136,1882,-4,-5,2132,1877,19,4,2151,1873,931,117,137,140,0,,0,0.0,0.0,0.0,0.0,0.0
2024,6,22,6,2024-06-22,9E,8591,PDX,LGA,"Portland, OR",Oregon,"New York, NY",New York,2280,936,-1,5,2279,941,22,18,2301,923,2547,309,329,349,0,,0,0.0,0.0,0.0,0.0,0.0
2024,10,6,7,2024-10-06,WN,7999,DTW,ORD,"Detroit, MI",Michigan,"Chicago, IL",Illinois,2066,1315,18,15,2084,1330,5,11,2089,1319,2068,257,277,273,0,,0,0.0,0.0,0.0,0.0,0.0
2024,4,23,2,2024-04-23,AA,7245,DFW,HNL,"Dallas/Fort Worth, TX",Texas,"Honolulu, HI",Hawaii,789,2018,-12,-20,777,1998,18,19,795,1979,363,47,67,84,0,,0,0.0,0.0,0.0,0.0,0.0
2024,10,14,1,2024-10-14,OH,5961,DCA,HNL,"Washington, DC",District of Columbia,"Honolulu, HI",Hawaii,1779,1448,-4,-10,1775,1438,21,9,1796,1429,1095,139,159,169,0,,0,0.0,0.0,0.0,0.0,0.0
2024,12,7,6,2024-12-07,F9,348,DCA,SEA,"Washington, DC",District of Columbia,"Seattle, WA",Washington,1729,1274,-22,-15,1707,1259,24,19,1731,1240,1666,198,218,241,0,,0,0.0,0.0,0.0,0.0,0.0
2024,5,30,4,2024-05-30,DL,4423,LAX,BWI,"Los Angeles, CA",California,"Baltimore, MD",Maryland,1998,704,-25,-15,1973,689,12,3,1985,686,871,106,126,121,0,,0,0.0,0.0,0.0,0.0,0.0
2024,5,6,1,2024-05-06,OO,7201,DFW,PHX,"Dallas/Fort Worth, TX",Texas,"Phoenix, AZ",Arizona,1506,2313,1,-5,1507,2308,28,10,1535,2298,1588,188,208,226,0,,0,0.0,0.0,0.0,0.0,0.0
2024,6,3,1,2024-06-03,AA,2960,STL,TPA,"St. Louis, MO",Missouri,"Tampa, FL",Florida,1591,1302,-11,-10,1580,1292,12,12,1592,1280,1739,215,235,239,0,,0,0.0,0.0,0.0,0.0,0.0
2024,9,29,7,2024-09-29,MQ,823,BOS,SEA,"Boston, MA",Massachusetts,"Seattle, WA",Washington,1738,1747,-3,0,1735,1747,21,8,1756,1739,1861,232,252,261,0,,0,0.0,0.0,0.0,0.0,0.0
2024,4,13,6,2024-04-13,NK,669,DCA,DTW,"Washington, DC",District of Columbia,"Detroit, MI",Michigan,1133,2333,-5,-5,1128,2328,5,11,1133,2317,1347,164,184,180,0,,0,0.0,0.0,0.0,0.0,0.0
2024,10,25,5,2024-10-25,YX,8511,LAX,PHX,"Los Angeles, CA",California,"Phoenix, AZ",Arizona,921,1722,4,-5,925,1717,11,3,936,1714,1433,169,189,183,0,,0,0.0,0.0,0.0,0.0,0.0
2024,9,2,1,2024-09-02,9E,9686,SLC,ORD,"Salt Lake City, UT",Utah,"Chicago, IL",Illinois,1057,605,14,15,1071,620,27,12,1098,608,2324,280,300,319,0,,0,0.0,0.0,0.0,0.0,0.0
2024,6,24,1,2024-06-24,G4,2934,DFW,LAX,"Dallas/Fort Worth, TX",Texas,"Los Angeles, CA",California,1080,1399,-2,-10,1078,1389,18,14,1096,1375,2976,370,390,402,0,,0,0.0,0.0,0.0,0.0,0.0
2024,2,8,4,2024-02-08,OO,8028,PHX,LAS,"Phoenix, AZ",Arizona,"Las Vegas, NV",Nevada,1038,1890,-10,-5,1028,1885,25,13,1053,1872,1756,223,243,261,0,,0,0.0,0.0,0.0,0.0,0.0
2024,6,18,2,2024-06-18,HA,6771,DCA,MCO,"Washington, DC",District of Columbia,"Orlando, FL",Florida,2206,1666,-10,-10,2196,1656,28,7,2224,1649,2928,371,391,406,0,,0,0.0,0.0,0.0,0.0,0.0
2024,9,3,2,2024-09-03,YX,2222,SFO,TPA,"San Francisco, CA",California,"Tampa, FL",Florida,2280,1252,5,0,2285,1252,10,12,2295,1240,496,54,74,76,0,,0,0.0,0.0,0.0,0.0,0.0
2024,1,26,5,2024-01-26,YX,4100,IAD,SLC,"Washington, DC",District of Columbia,"Salt Lake City, UT",Utah,961,1892,4,5,965,1897,21,11,986,1886,2364,287,307,319,0,,0,0.0,0.0,0.0,0.0,0.0
2024,12,20,5,2024-12-20,G4,3189,ORD,MIA,"Chicago, IL",Illinois,"Miami, FL",Florida,1978,1150,0,10,1978,1160,18,5,1996,1155,1706,216,236,239,0,,0,0.0,0.0,0.0,0.0,0.0
2024,11,1,5,2024-11-01,UA,7265,JFK,HNL,"New York, NY",New York,"Honolulu, HI",Hawaii,1505,1541,-3,0,1502,1541,11,6,1513,1535,2123,259,279,276,0,,0,0.0,0.0,0.0,0.0,0.0
2024,1,13,6,2024-01-13,AS,7310,HNL,MIA,"Honolulu, HI",Hawaii,"Miami, FL",Florida,800,1273,16,10,816,1283,19,8,835,1275,2444,311,331,338,0,,0,0.0,0.0,0.0,0.0,0.0
2024,11,11,1,2024-11-11,NK,149,PHX,STL,"Phoenix, AZ",Arizona,"St. Louis, MO",Missouri,1811,1818,13,5,1824,1823,12,4,1836,1819,1907,237,257,253,0,,0,0.0,0.0,0.0,0.0,0.0
2024,11,8,5,2024-11-08,OH,614,IAD,ORD,"Washington, DC",District of Columbia,"Chicago, IL",Illinois,2284,1527,-12,-10,2272,1517,28,7,2300,1510,2434,309,329,344,0,,0,0.0,0.0,0.0,0.0,0.0
2024,2,5,1,2024-02-05,9E,4771,LAX,MDW,"Los Angeles, CA",California,"Chicago, IL",Illinois,1525,923,-1,-10,1524,913,20,15,1544,898,877,116,136,151,0,,0,0.0,0.0,0.0,0.0,0.0
2024,6,21,5,2024-06-21,G4,7849,SFO,SLC,"San Francisco, CA",California,"Salt Lake City, UT",Utah,1543,1215,2,5,1545,1220,14,3,1559,1217,479,61,81,78,0,,0,0.0,0.0,0.0,0.0,0.0
2024,1,20,6,2024-01-20,HA,1265,DTW,SAN,"Detroit, MI",Michigan,"San Diego, CA",California,2000,1356,18,20,2018,1376,13,16,2031,1360,1455,188,208,217,0,,0,2.0,0.0,3.0,0.0,15.0
2024,11,16,6,2024-11-16,DL,514,MIA,TPA,"Miami, FL",Florida,"Tampa, FL",Florida,1453,1688,0,-5,1453,1683,23,13,1476,1670,2010,257,277,293,0,,0,0.0,0.0,0.0,0.0,0.0
2024,9,20,5,2024-09-20,F9,1204,ATL,CLT,"Atlanta, GA",Georgia,"Charlotte, NC",North Carolina,2014,800,-7,-10,2007,790,6,4,2013,786,2114,257,277,267,0,,0,0.0,0.0,0.0,0.0,0.0
2024,5,21,2,2024-05-21,OH,4958,CLT,PHL,"Charlotte, NC",North Carolina,"Philadelphia, PA",Pennsylvania,1485,841,5,10,1490,851,12,17,1502,834,798,92,112,121,0,,0,0.0,0.0,0.0,0.0,0.0
2024,5,22,3,2024-05-22,NK,3456,MCO,HNL,"Orlando, FL",Florida,"Honolulu, HI",Hawaii,1305,1630,-12,-10,1293,1620,15,9,1308,1611,1814,230,250,254,0,,0,0.0,0.0,0.0,0.0,0.0
2024,4,1,1,2024-04-01,WN,2516,BWI,DTW,"Baltimore, MD",Maryland,"Detroit, MI",Michigan,756,1842,5,5,761,1847,8,7,769,1840,796,92,112,107,0,,0,0.0,0.0,0.0,0.0,0.0
2024,12,19,4,2024-12-19,DL,5711,SEA,PDX,"Seattle, WA",Washington,"Portland, OR",Oregon,952,602,-16,-20,936,582,22,14,958,568,1323,167,187,203,0,,0,0.0,0.0,0.0,0.0,0.0
2024,11,17,7,2024-11-17,F9,5565,SAN,MCO,"San Diego, CA",California,"Orlando, FL",Florida,937,1453,-16,-20,921,1433,22,19,943,1414,2886,367,387,408,0,,0,0.0,0.0,0.0,0.0,0.0
2024,10,14,1,2024-10-14,OO,8495,ATL,SAN,"Atlanta, GA",Georgia,"San Diego, CA",California,2284,2087,-6,0,2278,2087,6,18,2284,2069,2132,261,281,285,0,,0,0.0,0.0,0.0,0.0,0.0
2024,8,2,5,2024-08-02,B6,7292,TPA,IAH,"Tampa, FL",Florida,"Houston, TX",Texas,897,1567,2,5,899,1572,9,19,908,1553,977,116,136,144,0,,0,0.0,0.0,0.0,0.0,0.0
2024,12,7,6,2024-12-07,AS,5772,IAD,LAX,"Washington, DC",District of Columbia,"Los Angeles, CA",California,1676,1564,-6,-15,1670,1549,18,9,1688,1540,1013,116,136,143,0,,0,0.0,0.0,0.0,0.0,0.0
2024,2,20,2,2024-02-20,OH,8360,JFK,LAX,"New York, NY",New York,"Los Angeles, CA",California,1148,904,-3,5,1145,909,17,3,1162,906,2860,352,372,372,0,,0,0.0,0.0,0.0,0.0,0.0
2024,6,1,6,2024-06-01,OO,8807,SEA,TPA,"Seattle, WA",Washington,"Tampa, FL",Florida,721,913,-6,-15,715,898,12,4,727,894,2114,255,275,271,0,,0,0.0,0.0,0.0,0.0,0.0
2024,7,4,4,2024-07-04,NK,3663,ORD,LAS,"Chicago, IL",Illinois,"Las Vegas, NV",Nevada,2246,1077,-7,0,2239,1077,29,7,2268,1070,2023,246,266,282,0,,0,0.0,0.0,0.0,0.0,0.0
2024,3,3,7,2024-03-03,HA,6483,ATL,DTW,"Atlanta, GA",Georgia,"Detroit, MI",Michigan,2224,1395,-9,-5,2215,1390,15,3,2230,1387,2542,322,342,340,0,,0,0.0,0.0,0.0,0.0,0.0
2024,7,8,1,2024-07-08,HA,9756,ATL,ORD,"Atlanta, GA",Georgia,"Chicago, IL",Illinois,1959,1482,11,5,1970,1487,26,15,1996,1472,694,79,99,120,0,,0,0.0,0.0,0.0,0.0,0.0
2024,5,4,6,2024-05-04,9E,9944,MDW,MCO,"Chicago, IL",Illinois,"Orlando, FL",Florida,2267,2034,11,10,2278,2044,12,3,2290,2041,1402,177,197,192,0,,0,0.0,0.0,0.0,0.0,0.0
2024,5,29,3,2024-05-29,AA,8998,STL,PHL,"St. Louis, MO",Missouri,"Philadelphia, PA",Pennsylvania,635,1097,-20,-15,615,1082,19,3,634,1079,1879,230,250,252,0,,0,0.0,0.0,0.0,0.0,0.0
2024,11,9,6,2024-11-09,F9,9917,ATL,IAH,"Atlanta, GA",Georgia,"Houston, TX",Texas,2051,2157,-17,-10,2034,2147,10,5,2044,2142,494,59,79,74,0,,0,0.0,0.0,0.0,0.0,0.0
2024,2,27,2,2024-02-27,WN,6933,SLC,MIA,"Salt Lake City, UT",Utah,"Miami, FL",Florida,1125,2229,17,10,1142,2239,21,7,1163,2232,1048,121,141,149,0,,0,0.0,0.0,0.0,0.0,0.0
2024,12,7,6,2024-12-07,MQ,4852,SEA,MSP,"Seattle, WA",Washington,"Minneapolis, MN",Minnesota,1275,1980,0,-5,1275,1975,15,14,1290,1961,2951,362,382,391,0,,0,0.0,0.0,0.0,0.0,0.0
2024,10,31,4,2024-10-31,G4,8223,LAS,MDW,"Las Vegas, NV",Nevada,"Chicago, IL",Illinois,1802,670,-10,0,1792,670,29,10,1821,660,1911,247,267,286,0,,0,0.0,0.0,0.0,0.0,0.0
2024,6,28,5,2024-06-28,AA,3885,DEN,PHX,"Denver, CO",Colorado,"Phoenix, AZ",Arizona,1084,2357,-4,-10,1080,2347,11,7,1091,2340,1761,220,240,238,0,,0,0.0,0.0,0.0,0.0,0.0
2024,6,18,2,2024-06-18,OO,9637,PHL,LGA,"Philadelphia, PA",Pennsylvania,"New York, NY",New York,2259,1636,39,45,2298,1681,6,17,2304,1664,2298,293,313,316,0,,0,12.0,9.0,8.0,1.0,15.0
2024,11,21,4,2024-11-21,DL,8635,BWI,PHX,"Baltimore, MD",Maryland,"Phoenix, AZ",Arizona,984,1005,22,15,1006,1020,7,13,1013,1007,2571,323,343,343,0,,0,0.0,0.0,0.0,0.0,0.0
2024,9,27,5,2024-09-27,OH,8827,DEN,IAD,"Denver, CO",Colorado,"Washington, DC",District of Columbia,2069,2140,-25,-20,2044,2120,22,17,2066,2103,821,111,131,150,0,,0,0.0,0.0,0.0,0.0,0.0
2024,2,23,5,2024-02-23,AS,8646,SAN,HNL,"San Diego, CA",California,"Honolulu, HI",Hawaii,1768,1645,2,0,1770,1645,29,7,1799,1638,2452,297,317,333,0,,0,0.0,0.0,0.0,0.0,0.0
2024,4,10,3,2024-04-10,OO,5123,BOS,SFO,"Boston, MA",Massachusetts,"San Francisco, CA",California,2273,1494,7,10,2280,1504,28,8,2308,1496,2318,294,314,330,0,,0,0.0,0.0,0.0,0.0,0.0
2024,9,20,5,2024-09-20,9E,1082,ATL,PHL,"Atlanta, GA",Georgia,"Philadelphia, PA",Pennsylvania,1541,1932,3,-5,1544,1927,25,6,1569,1921,351,51,71,82,0,,0,0.0,0.0,0.0,0.0,0.0
2024,2,22,4,2024-02-22,OO,1445,PHX,SAN,"Phoenix, AZ",Arizona,"San Diego, CA",California,1376,1918,0,-5,1376,1913,24,7,1400,1906,1802,234,254,265,0,,0,0.0,0.0,0.0,0.0,0.0
2024,2,29,4,2024-02-29,OH,5791,SFO,BOS,"San Francisco, CA",California,"Boston, MA",Massachusetts,2079,2172,2,-5,2081,2167,27,15,2108,2152,394,47,67,89,0,,0,0.0,0.0,0.0,0.0,0.0
2024,4,17,3,2024-04-17,AA,6102,SAN,MIA,"San Diego, CA",California,"Miami, FL",Florida,1666,630,-24,-20,1642,610,18,14,1660,596,1017,120,140,152,0,,0,0.0,0.0,0.0,0.0,0.0
2024,1,5,5,2024-01-05,WN,626,SFO,DEN,"San Francisco, CA",California,"Denver, CO",Colorado,1000,1685,3,5,1003,1690,13,8,1016,1682,701,94,114,115,0,,0,0.0,0.0,0.0,0.0,0.0
2024,4,12,5,2024-04-12,F9,6747,CLT,PDX,"Charlotte, NC",North Carolina,"Portland, OR",Oregon,2050,1844,-10,0,2040,1844,12,7,2052,1837,2263,281,301,300,0,,0,0.0,0.0,0.0,0.0,0.0
2024,7,14,7,2024-07-14,HA,7352,LAS,MIA,"Las Vegas, NV",Nevada,"Miami, FL",Florida,592,1982,-2,0,590,1982,28,12,618,1970,422,56,76,96,0,,0,0.0,0.0,0.0,0.0,0.0
2024,9,18,3,2024-09-18,9E,1030,DCA,ORD,"Washington, DC",District of Columbia,"Chicago, IL",Illinois,1906,2216,-11,-10,1895,2206,22,8,1917,2198,2920,367,387,397,0,,0,0.0,0.0,0.0,0.0,0.0
2024,12,30,1,2024-12-30,B6,2382,IAD,SAN,"Washington, DC",District of Columbia,"San Diego, CA",California,778,2006,12,5,790,2011,16,11,806,2000,2453,311,331,338,0,,0,0.0,0.0,0.0,0.0,0.0
2024,12,15,7,2024-12-15,MQ,2046,DCA,DEN,"Washington, DC",District of Columbia,"Denver, CO",Colorado,2250,2141,-5,5,2245,2146,16,6,2261,2140,2752,343,363,365,0,,0,0.0,0.0,0.0,0.0,0.0
2024,2,16,5,2024-02-16,G4,3460,SLC,BWI,"Salt Lake City, UT",Utah,"Baltimore, MD",Maryland,1972,2240,2,0,1974,2240,14,15,1988,2225,2937,360,380,389,0,,0,0.0,0.0,0.0,0.0,0.0
2024,12,20,5,2024-12-20,OO,9885,SEA,CLT,"Seattle, WA",Washington,"Charlotte, NC",North Carolina,2284,1960,18,15,2302,1975,13,6,2315,1969,2619,332,352,351,0,,0,0.0,0.0,0.0,0.0,0.0
2024,11,6,3,2024-11-06,OO,8212,IAD,ATL,"Washington, DC",District of Columbia,"Atlanta, GA",Georgia,1481,761,-19,-15,1462,746,6,15,1468,731,1338,167,187,188,0,,0,0.0,0.0,0.0,0.0,0.0
2024,11,3,7,2024-11-03,AS,3025,LGA,SFO,"New York, NY",New York,"San Francisco, CA",California,2106,1163,2,5,2108,1168,28,13,2136,1155,2633,320,340,361,0,,0,0.0,0.0,0.0,0.0,0.0
2024,5,23,4,2024-05-23,AA,3725,MCO,LGA,"Orlando, FL",Florida,"New York, NY",New York,1120,757,-10,0,1110,757,25,13,1135,744,770,97,117,135,0,,0,0.0,0.0,0.0,0.0,0.0
2024,9,25,3,2024-09-25,AS,5569,DFW,EWR,"Dallas/Fort Worth, TX",Texas,"Newark, NJ",New Jersey,1811,612,-19,-10,1792,602,15,3,1807,599,496,59,79,77,0,,0,0.0,0.0,0.0,0.0,0.0
2024,5,3,5,2024-05-03,AS,1323,DEN,BWI,"Denver, CO",Colorado,"Baltimore, MD",Maryland,975,1809,-15,-15,960,1794,26,16,986,1778,283,37,57,79,0,,0,0.0,0.0,0.0,0.0,0.0
2024,4,15,1,2024-04-15,MQ,7210,EWR,IAD,"Newark, NJ",New Jersey,"Washington, DC",District of Columbia,1381,1333,-15,-5,1366,1328,14,15,1380,1313,2377,288,308,317,0,,0,0.0,0.0,0.0,0.0,0.0
2024,6,6,4,2024-06-06,AS,9257,CLT,EWR,"Charlotte, NC",North Carolina,"Newark, NJ",New Jersey,1171,1352,11,10,1182,1362,29,9,1211,1353,2885,351,371,389,0,,0,0.0,0.0,0.0,0.0,0.0
2024,5,26,7,2024-05-26,F9,5092,SFO,SAN,"San Francisco, CA",California,"San Diego, CA",California,1300,908,2,5,1302,913,12,3,1314,910,573,64,84,79,0,,0,0.0,0.0,0.0,0.0,0.0
2024,5,24,5,2024-05-24,HA,8914,PHX,STL,"Phoenix, AZ",Arizona,"St. Louis, MO",Missouri,670,747,-8,0,662,747,9,15,671,732,2452,313,333,337,0,,0,0.0,0.0,0.0,0.0,0.0
2024,4,29,1,2024-04-29,AS,4887,PDX,LAX,"Portland, OR",Oregon,"Los Angeles, CA",California,2048,1620,-16,-15,2032,1605,26,7,2058,1598,847,97,117,130,0,,0,0.0,0.0,0.0,0.0,0.0
2024,11,14,4,2024-11-14,B6,6918,HNL,DEN,"Honolulu, HI",Hawaii,"Denver, CO",Colorado,871,1678,24,20,895,1698,9,10,904,1688,1482,181,201,200,0,,0,0.0,4.0,0.0,0.0,16.0
2024,10,1,2,2024-10-01,HA,4826,PDX,EWR,"Portland, OR",Oregon,"Newark, NJ",New Jersey,1231,1526,-4,-5,1227,1521,13,16,1240,1505,1109,133,153,162,0,,0,0.0,0.0,0.0,0.0,0.0
2024,4,1,1,2024-04-01,OO,2472,IAH,LGA,"Houston, TX",Texas,"New York, NY",New York,1916,1170,-9,0,1907,1170,15,4,1922,1166,2590,313,333,332,0,,0,0.0,0.0,0.0,0.0,0.0
2024,2,27,2,2024-02-27,DL,3399,LGA,HNL,"New York, NY",New York,"Honolulu, HI",Hawaii,684,2333,4,10,688,2343,16,6,704,2337,1256,155,175,177,0,,0,0.0,0.0,0.0,0.0,0.0
2024,12,11,3,2024-12-11,WN,9460,STL,SEA,"St. Louis, MO",Missouri,"Seattle, WA",Washington,2033,2233,-17,-15,2016,2218,9,4,2025,2214,447,56,76,69,0,,0,0.0,0.0,0.0,0.0,0.0
2024,8,16,5,2024-08-16,OH,6551,CLT,DTW,"Charlotte, NC",North Carolina,"Detroit, MI",Michigan,1955,1267,12,5,1967,1272,10,6,1977,1266,1890,232,252,248,0,,0,0.0,0.0,0.0,0.0,0.0
2024,4,26,5,2024-04-26,HA,8683,SLC,IAD,"Salt Lake City, UT",Utah,"Washington, DC",District of Columbia,1438,1291,-25,-20,1413,1271,5,8,1418,1263,2002,240,260,253,0,,0,0.0,0.0,0.0,0.0,0.0
2024,11,13,3,2024-11-13,9E,3909,LAX,LAS,"Los Angeles, CA",California,"Las Vegas, NV",Nevada,1334,1109,-15,-15,1319,1094,20,3,1339,1091,2088,270,290,293,0,,0,0.0,0.0,0.0,0.0,0.0
2024,10,5,6,2024-10-05,B6,2507,LAX,STL,"Los Angeles, CA",California,"St. Louis, MO",Missouri,708,1185,8,5,716,1190,28,15,744,1175,803,93,113,136,0,,0,0.0,0.0,0.0,0.0,0.0
2024,5,6,1,2024-05-06,9E,4964,LAX,STL,"Los Angeles, CA",California,"St. Louis, MO",Missouri,1493,2196,-20,-10,1473,2186,18,17,1491,2169,1712,209,229,244,0,,0,0.0,0.0,0.0,0.0,0.0
2024,5,8,3,2024-05-08,WN,5127,MCO,LAS,"Orlando, FL",Florida,"Las Vegas, NV",Nevada,1299,1536,-12,-5,1287,1531,28,11,1315,1520,1057,137,157,176,0,,0,0.0,0.0,0.0,0.0,0.0
2024,2,27,2,2024-02-27,DL,4360,STL,IAD,"St. Louis, MO",Missouri,"Washington, DC",District of Columbia,1852,644,-14,-10,1838,634,18,4,1856,630,1573,200,220,222,0,,0,0.0,0.0,0.0,0.0,0.0
2024,5,1,3,2024-05-01,NK,4928,DCA,MCO,"Washington, DC",District of Columbia,"Orlando, FL",Florida,1884,2270,-7,-5,1877,2265,28,16,1905,2249,1297,154,174,198,0,,0,0.0,0.0,0.0,0.0,0.0
2024,1,1,1,2024-01-01,9E,8872,PDX,CLT,"Portland, OR",Oregon,"Charlotte, NC",North Carolina,1967,2345,-9,-15,1958,2330,17,6,1975,2324,1482,192,212,215,0,,0,0.0,0.0,0.0,0.0,0.0
2024,8,26,1,2024-08-26,9E,9112,MCO,LAX,"Orlando, FL",Florida,"Los Angeles, CA",California,1964,685,11,5,1975,690,16,7,1991,683,2745,351,371,374,0,,0,0.0,0.0,0.0,0.0,0.0
2024,10,16,3,2024-10-16,DL,9539,BOS,PDX,"Boston, MA",Massachusetts,"Portland, OR",Oregon,868,1915,-15,-15,853,1900,27,11,880,1889,224,30,50,68,0,,0,0.0,0.0,0.0,0.0,0.0
2024,4,5,5,2024-04-05,AA,8415,MCO,SLC,"Orlando, FL",Florida,"Salt Lake City, UT",Utah,1629,863,11,10,1640,873,11,19,1651,854,1669,217,237,247,0,,0,0.0,0.0,0.0,0.0,0.0
2024,5,5,7,2024-05-05,OH,1974,STL,DEN,"St. Louis, MO",Missouri,"Denver, CO",Colorado,1223,1891,9,5,1232,1896,10,18,1242,1878,1376,175,195,203,0,,0,0.0,0.0,0.0,0.0,0.0
2024,4,27,6,2024-04-27,B6,8815,SFO,MIA,"San Francisco, CA",California,"Miami, FL",Florida,1848,1607,-14,-5,1834,1602,27,19,1861,1583,2300,290,310,336,0,,0,0.0,0.0,0.0,0.0,0.0
2024,2,17,6,2024-02-17,YX,3223,PHX,BWI,"Phoenix, AZ",Arizona,"Baltimore, MD",Maryland,1755,1848,7,10,1762,1858,13,9,1775,1849,682,82,102,104,0,,0,0.0,0.0,0.0,0.0,0.0
2024,3,29,5,2024-03-29,MQ,4324,HNL,STL,"Honolulu, HI",Hawaii,"St. Louis, MO",Missouri,1504,815,-1,-10,1503,805,25,3,1528,802,435,54,74,82,0,,0,0.0,0.0,0.0,0.0,0.0
2024,8,24,6,2024-08-24,AA,5354,SLC,LAS,"Salt Lake City, UT",Utah,"Las Vegas, NV",Nevada,2248,830,-19,-10,2229,820,20,14,2249,806,1745,219,239,253,0,,0,0.0,0.0,0.0,0.0,0.0
2024,9,28,6,2024-09-28,AA,3298,BWI,EWR,"Baltimore, MD",Maryland,"Newark, NJ",New Jersey,1336,2325,-20,-15,1316,2310,13,19,1329,2291,1813,216,236,248,0,,0,0.0,0.0,0.0,0.0,0.0
2024,7,7,7,2024-07-07,HA,7182,IAH,SFO,"Houston, TX",Texas,"San Francisco, CA",California,2231,1253,-15,-5,2216,1248,18,17,2234,1231,548,66,86,101,0,,0,0.0,0.0,0.0,0.0,0.0
2024,7,10,3,2024-07-10,AA,1310,HNL,PHL,"Honolulu, HI",Hawaii,"Philadelphia, PA",Pennsylvania,1772,1800,37,30,1809,1830,13,8,1822,1822,1352,178,198,199,0,,0,5.0,0.0,4.0,0.0,21.0
2024,3,9,6,2024-03-09,AS,9318,ORD,IAD,"Chicago, IL",Illinois,"Washington, DC",District of Columbia,1840,2186,-17,-10,1823,2176,8,15,1831,2161,987,126,146,149,0,,0,0.0,0.0,0.0,0.0,0.0
2024,10,4,5,2024-10-04,G4,5504,LAX,LGA,"Los Angeles, CA",California,"New York, NY",New York,763,1301,7,10,770,1311,13,14,783,1297,2733,350,370,377,0,,0,0.0,0.0,0.0,0.0,0.0
2024,12,14,6,2024-12-14,9E,4217,DTW,SAN,"Detroit, MI",Michigan,"San Diego, CA",California,2252,2140,2,5,2254,2145,12,5,2266,2140,2039,257,277,274,0,,0,0.0,0.0,0.0,0.0,0.0
2024,9,3,2,2024-09-03,MQ,5529,CLT,SAN,"Charlotte, NC",North Carolina,"San Diego, CA",California,2026,2346,-17,-20,2009,2326,18,10,2027,2316,432,56,76,84,0,,0,0.0,0.0,0.0,0.0,0.0
2024,3,16,6,2024-03-16,OO,8789,SFO,HNL,"San Francisco, CA",California,"Honolulu, HI",Hawaii,1786,1306,24,15,1810,1321,9,18,1819,1303,2319,290,310,317,0,,0,0.0,0.0,0.0,0.0,0.0
2024,6,2,7,2024-06-02,YX,9985,JFK,MCO,"New York, NY",New York,"Orlando, FL",Florida,1181,1112,23,20,1204,1132,20,17,1224,1115,2417,303,323,340,0,,0,6.0,4.0,0.0,0.0,10.0
2024,5,23,4,2024-05-23,AA,4858,ATL,SFO,"Atlanta, GA",Georgia,"San Francisco, CA",California,1939,1727,5,15,1944,1742,14,9,1958,1733,1475,193,213,216,0,,0,0.0,0.0,0.0,0.0,0.0
2024,3,26,2,2024-03-26,B6,8282,SLC,EWR,"Salt Lake City, UT",Utah,"Newark, NJ",New Jersey,1412,1724,9,0,1421,1724,7,18,1428,1706,206,21,41,46,0,,0,0.0,0.0,0.0,0.0,0.0
2024,7,3,3,2024-07-03,HA,9016,ORD,PHX,"Chicago, IL",Illinois,"Phoenix, AZ",Arizona,2191,2263,-18,-10,2173,2253,13,13,2186,2240,2226,269,289,295,0,,0,0.0,0.0,0.0,0.0,0.0
2024,10,11,5,2024-10-11,G4,475,PDX,SAN,"Portland, OR",Oregon,"San Diego, CA",California,569,904,-1,-5,568,899,7,6,575,893,2188,273,293,286,0,,0,0.0,0.0,0.0,0.0,0.0
2024,8,7,3,2024-08-07,OH,7513,DEN,EWR,"Denver, CO",Colorado,"Newark, NJ",New Jersey,1757,950,8,0,1765,950,23,18,1788,932,1243,160,180,201,0,,0,0.0,0.0,0.0,0.0,0.0
2024,3,9,6,2024-03-09,G4,4498,EWR,SAN,"Newark, NJ",New Jersey,"San Diego, CA",California,931,1402,-15,-5,916,1397,23,6,939,1391,1312,166,186,195,0,,0,0.0,0.0,0.0,0.0,0.0
2024,2,16,5,2024-02-16,AA,3959,MSP,ATL,"Minneapolis, MN",Minnesota,"Atlanta, GA",Georgia,1577,1050,-3,5,1574,1055,5,13,1579,1042,699,94,114,112,0,,0,0.0,0.0,0.0,0.0,0.0
2024,4,3,3,2024-04-03,F9,1786,LAX,LGA,"Los Angeles, CA",California,"New York, NY",New York,669,1892,14,5,683,1897,26,18,709,1879,2587,331,351,375,0,,0,0.0,0.0,0.0,0.0,0.0
2024,8,25,7,2024-08-25,AA,5112,DCA,TPA,"Washington, DC",District of Columbia,"Tampa, FL",Florida,535,1995,-20,-10,515,1985,23,18,538,1967,1279,159,179,200,0,,0,0.0,0.0,0.0,0.0,0.0
2024,7,22,1,2024-07-22,HA,356,CLT,SLC,"Charlotte, NC",North Carolina,"Salt Lake City, UT",Utah,758,1532,3,-5,761,1527,19,9,780,1518,1933,231,251,259,0,,0,0.0,0.0,0.0,0.0,0.0
2024,8,5,1,2024-08-05,F9,3700,DTW,SLC,"Detroit, MI",Michigan,"Salt Lake City, UT",Utah,750,1661,26,20,776,1681,23,8,799,1673,2702,339,359,370,0,,0,3.0,5.0,1.0,0.0,11.0
2024,12,6,5,2024-12-06,AA,150,PDX,SLC,"Portland, OR",Oregon,"Salt Lake City, UT",Utah,512,1501,-8,-10,504,1491,29,12,533,1479,1285,157,177,198,0,,0,0.0,0.0,0.0,0.0,0.0
2024,2,8,4,2024-02-08,YX,6690,MIA,MDW,"Miami, FL",Florida,"Chicago, IL",Illinois,1170,1361,4,-5,1174,1356,11,17,1185,1339,1607,209,229,237,1,,0,0.0,0.0,0.0,0.0,0.0
2024,4,9,2,2024-04-09,B6,7537,LAX,STL,"Los Angeles, CA",California,"St. Louis, MO",Missouri,1040,1332,-15,-20,1025,1312,28,6,1053,1306,1003,128,148,162,0,,0,0.0,0.0,0.0,0.0,0.0
2024,10,15,2,2024-10-15,F9,694,BOS,JFK,"Boston, MA",Massachusetts,"New York, NY",New York,556,662,-4,-5,552,657,5,8,557,649,2011,254,274,267,0,,0,0.0,0.0,0.0,0.0,0.0
2024,9,10,2,2024-09-10,AS,4831,DEN,MIA,"Denver, CO",Colorado,"Miami, FL",Florida,1503,1104,-9,-5,1494,1099,28,14,1522,1085,2741,347,367,389,0,,0,0.0,0.0,0.0,0.0,0.0
2024,8,9,5,2024-08-09,G4,3973,LAS,STL,"Las Vegas, NV",Nevada,"St. Louis, MO",Missouri,1684,1544,-9,-15,1675,1529,20,8,1695,1521,655,89,109,117,0,,0,0.0,0.0,0.0,0.0,0.0
2024,12,22,7,2024-12-22,AA,9364,HNL,MCO,"Honolulu, HI",Hawaii,"Orlando, FL",Florida,936,864,-20,-20,916,844,12,15,928,829,1762,216,236,243,1,,0,0.0,0.0,0.0,0.0,0.0
2024,1,23,2,2024-01-23,G4,5848,CLT,PHL,"Charlotte, NC",North Carolina,"Philadelphia, PA",Pennsylvania,1277,2299,-3,0,1274,2299,16,7,1290,2292,1574,191,211,214,0,,0,0.0,0.0,0.0,0.0,0.0
2024,9,6,5,2024-09-06,AA,5337,DCA,IAH,"Washington, DC",District of Columbia,"Houston, TX",Texas,729,1134,-6,-5,723,1129,28,16,751,1113,2544,316,336,360,0,,0,0.0,0.0,0.0,0.0,0.0
2024,1,10,3,2024-01-10,9E,1576,IAD,STL,"Washington, DC",District of Columbia,"St. Louis, MO",Missouri,1330,1702,-15,-20,1315,1682,10,16,1325,1666,284,42,62,68,0,,0,0.0,0.0,0.0,0.0,0.0
2024,9,2,1,2024-09-02,9E,4970,DEN,MSP,"Denver, CO",Colorado,"Minneapolis, MN",Minnesota,1340,2253,9,10,1349,2263,14,19,1363,2244,1787,218,238,251,0,,0,0.0,0.0,0.0,0.0,0.0
2024,11,20,3,2024-11-20,UA,8132,BWI,EWR,"Baltimore, MD",Maryland,"Newark, NJ",New Jersey,1716,1808,-3,0,1713,1808,18,6,1731,1802,1537,198,218,222,0,,0,0.0,0.0,0.0,0.0,0.0
2024,4,9,2,2024-04-09,AA,3120,SAN,STL,"San Diego, CA",California,"St. Louis, MO",Missouri,1119,1545,-16,-10,1103,1535,9,10,1112,1525,1569,189,209,208,0,,0,0.0,0.0,0.0,0.0,0.0
2024,10,16,3,2024-10-16,UA,6166,LAX,SLC,"Los Angeles, CA",California,"Salt Lake City, UT",Utah,856,1094,16,10,872,1104,8,3,880,1101,2758,353,373,364,0,,0,0.0,0.0,0.0,0.0,0.0
2024,6,28,5,2024-06-28,YX,8153,LAX,JFK,"Los Angeles, CA",California,"New York, NY",New York,851,2194,-8,-10,843,2184,29,14,872,2170,962,118,138,161,0,,0,0.0,0.0,0.0,0.0,0.0
2024,8,10,6,2024-08-10,OO,9956,MIA,MCO,"Miami, FL",Florida,"Orlando, FL",Florida,1364,1993,-11,-10,1353,1983,27,15,1380,1968,2725,337,357,379,0,,0,0.0,0.0,0.0,0.0,0.0
2024,9,6,5,2024-09-06,MQ,9687,LGA,MDW,"New York, NY",New York,"Chicago, IL",Illinois,1781,1502,9,10,1790,1512,18,7,1808,1505,2974,375,395,400,0,,0,0.0,0.0,0.0,0.0,0.0
2024,5,26,7,2024-05-26,DL,8166,LAX,SLC,"Los Angeles, CA",California,"Salt Lake City, UT",Utah,1121,1363,-9,-10,1112,1353,21,9,1133,1344,2144,265,285,295,0,,0,0.0,0.0,0.0,0.0,0.0
2024,4,5,5,2024-04-05,DL,8267,PHL,MIA,"Philadelphia, PA",Pennsylvania,"Miami, FL",Florida,2165,2224,11,10,2176,2234,5,5,2181,2229,1343,167,187,177,0,,0,0.0,0.0,0.0,0.0,0.0
2024,9,13,5,2024-09-13,G4,4880,IAH,DEN,"Houston, TX",Texas,"Denver, CO",Colorado,1134,1454,6,10,1140,1464,21,9,1161,1455,624,86,106,116,0,,0,0.0,0.0,0.0,0.0,0.0
2024,11,20,3,2024-11-20,F9,4145,LAS,MDW,"Las Vegas, NV",Nevada,"Chicago, IL",Illinois,1464,930,-5,-5,1459,925,24,19,1483,906,2450,308,328,351,0,,0,0.0,0.0,0.0,0.0,0.0
2024,1,4,4,2024-01-04,AA,2333,IAH,SAN,"Houston, TX",Texas,"San Diego, CA",California,1127,2063,-11,-20,1116,2043,13,15,1129,2028,1157,148,168,176,0,,0,0.0,0.0,0.0,0.0,0.0
2024,1,16,2,2024-01-16,YX,8217,EWR,LAS,"Newark, NJ",New Jersey,"Las Vegas, NV",Nevada,2265,1861,-14,-15,2251,1846,20,15,2271,1831,1008,120,140,155,0,,0,0.0,0.0,0.0,0.0,0.0
2024,10,6,7,2024-10-06,OH,6459,LAX,PHL,"Los Angeles, CA",California,"Philadelphia, PA",Pennsylvania,792,1503,-22,-15,770,1488,7,10,777,1478,2477,305,325,322,0,,0,0.0,0.0,0.0,0.0,0.0
2024,12,1,7,2024-12-01,WN,4297,PDX,DCA,"Portland, OR",Oregon,"Washington, DC",District of Columbia,1909,891,17,10,1926,901,14,10,1940,891,1512,191,211,215,0,,0,0.0,0.0,0.0,0.0,0.0
2024,9,3,2,2024-09-03,MQ,9598,TPA,SLC,"Tampa, FL",Florida,"Salt Lake City, UT",Utah,2268,1025,-6,-5,2262,1020,21,15,2283,1005,939,122,142,158,0,,0,0.0,0.0,0.0,0.0,0.0
2024,9,14,6,2024-09-14,AA,9929,JFK,PDX,"New York, NY",New York,"Portland, OR",Oregon,1328,894,-11,-20,1317,874,20,4,1337,870,237,34,54,58,0,,0,0.0,0.0,0.0,0.0,0.0
2024,6,8,6,2024-06-08,AA,9432,IAD,STL,"Washington, DC",District of Columbia,"St. Louis, MO",Missouri,733,1432,-9,0,724,1432,5,5,729,1427,2685,326,346,336,0,,0,0.0,0.0,0.0,0.0,0.0
2024,12,5,4,2024-12-05,YX,715,MCO,DFW,"Orlando, FL",Florida,"Dallas/Fort Worth, TX",Texas,1819,1099,-20,-10,1799,1089,23,15,1822,1074,1272,155,175,193,0,,0,0.0,0.0,0.0,0.0,0.0
2024,5,31,5,2024-05-31,YX,1666,ORD,MIA,"Chicago, IL",Illinois,"Miami, FL",Florida,2226,2179,-7,-10,2219,2169,19,19,2238,2150,727,83,103,121,0,,0,0.0,0.0,0.0,0.0,0.0
2024,6,26,3,2024-06-26,WN,9268,MSP,DFW,"Minneapolis, MN",Minnesota,"Dallas/Fort Worth, TX",Texas,1036,1444,-4,-10,1032,1434,11,8,1043,1426,2461,316,336,335,0,,0,0.0,0.0,0.0,0.0,0.0
2024,6,11,2,2024-06-11,DL,9608,SFO,ATL,"San Francisco, CA",California,"Atlanta, GA",Georgia,1902,2215,-2,5,1900,2220,12,5,1912,2215,796,101,121,118,0,,0,0.0,0.0,0.0,0.0,0.0
2024,2,2,5,2024-02-02,UA,2439,DTW,SFO,"Detroit, MI",Michigan,"San Francisco, CA",California,2201,2309,-22,-20,2179,2289,8,3,2187,2286,1011,120,140,131,0,,0,0.0,0.0,0.0,0.0,0.0
2024,6,27,4,2024-06-27,OO,8209,PDX,EWR,"Portland, OR",Oregon,"Newark, NJ",New Jersey,1304,1252,-9,-5,1295,1247,16,17,1311,1230,1766,221,241,254,0,,0,0.0,0.0,0.0,0.0,0.0
2024,4,10,3,2024-04-10,G4,7474,PHX,LAX,"Phoenix, AZ",Arizona,"Los Angeles, CA",California,1733,1660,-9,-15,1724,1645,6,10,1730,1635,2914,366,386,382,0,,0,0.0,0.0,0.0,0.0,0.0
2024,9,24,2,2024-09-24,DL,6807,DFW,MCO,"Dallas/Fort Worth, TX",Texas,"Orlando, FL",Florida,1038,2149,-8,0,1030,2149,11,14,1041,2135,1723,213,233,238,0,,0,0.0,0.0,0.0,0.0,0.0
2024,11,18,1,2024-11-18,WN,478,DTW,SEA,"Detroit, MI",Michigan,"Seattle, WA",Washington,1351,1233,-15,-5,1336,1228,29,9,1365,1219,880,115,135,153,0,,0,0.0,0.0,0.0,0.0,0.0
2024,3,5,2,2024-03-05,AA,3565,EWR,PHX,"Newark, NJ",New Jersey,"Phoenix, AZ",Arizona,677,2020,-21,-20,656,2000,10,18,666,1982,1849,226,246,254,0,,0,0.0,0.0,0.0,0.0,0.0
2024,6,16,7,2024-06-16,DL,6105,PHX,MDW,"Phoenix, AZ",Arizona,"Chicago, IL",Illinois,1055,1349,-6,0,1049,1349,6,10,1055,1339,1994,251,271,267,0,,0,0.0,0.0,0.0,0.0,0.0
2024,11,25,1,2024-11-25,B6,2371,PDX,DCA,"Portland, OR",Oregon,"Washington, DC",District of Columbia,1595,995,-7,0,1588,995,29,11,1617,984,1697,215,235,255,0,,0,0.0,0.0,0.0,0.0,0.0
2024,2,12,1,2024-02-12,OH,9338,IAH,ORD,"Houston, TX",Texas,"Chicago, IL",Illinois,2031,2190,-2,-10,2029,2180,11,10,2040,2170,2975,364,384,385,0,,0,0.0,0.0,0.0,0.0,0.0
2024,2,13,2,2024-02-13,9E,1107,MDW,IAD,"Chicago, IL",Illinois,"Washington, DC",District of Columbia,1745,1645,0,5,1745,1650,29,8,1774,1642,337,40,60,77,0,,0,0.0,0.0,0.0,0.0,0.0
2024,10,11,5,2024-10-11,HA,6900,STL,DEN,"St. Louis, MO",Missouri,"Denver, CO",Colorado,1447,1963,-10,-5,1437,1958,6,3,1443,1955,1124,134,154,143,0,,0,0.0,0.0,0.0,0.0,0.0
2024,1,12,5,2024-01-12,AA,209,PHX,PDX,"Phoenix, AZ",Arizona,"Portland, OR",Oregon,1322,1094,3,5,1325,1099,8,18,1333,1081,2413,301,321,327,0,,0,0.0,0.0,0.0,0.0,0.0
2024,4,4,4,2024-04-04,OO,2871,PDX,LAX,"Portland, OR",Oregon,"Los Angeles, CA",California,727,2026,9,0,736,2026,20,3,756,2023,2452,311,331,334,0,,0,0.0,0.0,0.0,0.0,0.0
2024,10,28,1,2024-10-28,NK,3983,MSP,MIA,"Minneapolis, MN",Minnesota,"Miami, FL",Florida,1756,1826,8,10,1764,1836,10,15,1774,1821,2389,299,319,324,0,,0,0.0,0.0,0.0,0.0,0.0
2024,9,9,1,2024-09-09,WN,2700,PHX,SFO,"Phoenix, AZ",Arizona,"San Francisco, CA",California,1791,1525,4,0,1795,1525,14,13,1809,1512,2981,378,398,405,0,,0,0.0,0.0,0.0,0.0,0.0
2024,8,29,4,2024-08-29,AS,5618,DTW,IAH,"Detroit, MI",Michigan,"Houston, TX",Texas,753,1549,-1,-10,752,1539,27,13,779,1526,942,114,134,154,0,,0,0.0,0.0,0.0,0.0,0.0
2024,2,4,7,2024-02-04,F9,3343,PHL,SLC,"Philadelphia, PA",Pennsylvania,"Salt Lake City, UT",Utah,1174,1969,7,10,1181,1979,18,13,1199,1966,2164,271,291,302,0,,0,0.0,0.0,0.0,0.0,0.0
2024,8,2,5,2024-08-02,MQ,1105,DFW,PHX,"Dallas/Fort Worth, TX",Texas,"Phoenix, AZ",Arizona,505,1638,-4,5,501,1643,7,17,508,1626,2211,273,293,297,0,,0,0.0,0.0,0.0,0.0,0.0
2024,12,2,1,2024-12-02,AS,405,DCA,PHX,"Washington, DC",District of Columbia,"Phoenix, AZ",Arizona,546,1653,19,20,565,1673,18,12,583,1661,2301,289,309,319,0,,0,3.0,2.0,1.0,0.0,14.0
2024,3,30,6,2024-03-30,OH,5801,SEA,MSP,"Seattle, WA",Washington,"Minneapolis, MN",Minnesota,1930,1652,-12,-15,1918,1637,15,18,1933,1619,2401,294,314,327,0,,0,0.0,0.0,0.0,0.0,0.0
2024,9,20,5,2024-09-20,DL,1058,MDW,DCA,"Chicago, IL",Illinois,"Washington, DC",District of Columbia,1382,759,-9,0,1373,759,15,5,1388,754,2473,306,326,326,0,,0,0.0,0.0,0.0,0.0,0.0
2024,4,2,2,2024-04-02,AA,9245,STL,MDW,"St. Louis, MO",Missouri,"Chicago, IL",Illinois,1079,2252,2,0,1081,2252,25,4,1106,2248,2532,308,328,337,0,,0,0.0,0.0,0.0,0.0,0.0
2024,3,30,6,2024-03-30,F9,5370,TPA,MSP,"Tampa, FL",Florida,"Minneapolis, MN",Minnesota,753,1269,13,5,766,1274,15,16,781,1258,2309,288,308,319,0,,0,0.0,0.0,0.0,0.0,0.0
2024,4,24,3,2024-04-24,F9,7695,PHX,SEA,"Phoenix, AZ",Arizona,"Seattle, WA",Washington,1972,1219,26,30,1998,1249,8,17,2006,1232,1615,195,215,220,0,,0,5.0,7.0,0.0,0.0,18.0
2024,4,14,7,2024-04-14,G4,3638,PHL,LAS,"Philadelphia, PA",Pennsylvania,"Las Vegas, NV",Nevada,558,1226,1,0,559,1226,9,10,568,1216,2926,370,390,389,0,,0,0.0,0.0,0.0,0.0,0.0
2024,7,14,7,2024-07-14,AS,7120,LAS,PHX,"Las Vegas, NV",Nevada,"Phoenix, AZ",Arizona,1916,871,0,5,1916,876,10,3,1926,873,1625,202,222,215,0,,0,0.0,0.0,0.0,0.0,0.0
2024,11,9,6,2024-11-09,YX,1730,MIA,EWR,"Miami, FL",Florida,"Newark, NJ",New Jersey,2154,1019,-13,-5,2141,1014,26,16,2167,998,2905,362,382,404,0,,0,0.0,0.0,0.0,0.0,0.0
2024,4,23,2,2024-04-23,AA,2703,MCO,TPA,"Orlando, FL",Florida,"Tampa, FL",Florida,2221,1449,-16,-10,2205,1439,18,16,2223,1423,2924,370,390,404,0,,0,0.0,0.0,0.0,0.0,0.0
2024,3,15,5,2024-03-15,OH,8358,MSP,DEN,"Minneapolis, MN",Minnesota,"Denver, CO",Colorado,1059,1088,-12,-5,1047,1083,11,10,1058,1073,1143,142,162,163,0,,0,0.0,0.0,0.0,0.0,0.0
2024,8,4,7,2024-08-04,G4,9126,LAX,BOS,"Los Angeles, CA",California,"Boston, MA",Massachusetts,1514,775,-17,-20,1497,755,10,11,1507,744,1972,244,264,265,0,,0,0.0,0.0,0.0,0.0,0.0
2024,10,3,4,2024-10-03,YX,305,BOS,MIA,"Boston, MA",Massachusetts,"Miami, FL",Florida,1714,1854,-15,-10,1699,1844,18,17,1717,1827,2295,282,302,317,0,,0,0.0,0.0,0.0,0.0,0.0
2024,9,5,4,2024-09-05,MQ,9824,PHL,TPA,"Philadelphia, PA",Pennsylvania,"Tampa, FL",Florida,764,1395,-4,-10,760,1385,26,14,786,1371,585,76,96,116,0,,0,0.0,0.0,0.0,0.0,0.0
2024,6,12,3,2024-06-12,HA,5791,SAN,SEA,"San Diego, CA",California,"Seattle, WA",Washington,2207,1941,6,0,2213,1941,20,3,2233,1938,448,59,79,82,0,,0,0.0,0.0,0.0,0.0,0.0
2024,12,22,7,2024-12-22,OH,6241,DEN,ORD,"Denver, CO",Colorado,"Chicago, IL",Illinois,2081,1361,2,0,2083,1361,8,17,2091,1344,225,35,55,60,0,,0,0.0,0.0,0.0,0.0,0.0
2024,7,10,3,2024-07-10,UA,3245,LAX,SEA,"Los Angeles, CA",California,"Seattle, WA",Washington,1666,1066,6,5,1672,1071,22,3,1694,1068,1483,191,211,216,0,,0,0.0,0.0,0.0,0.0,0.0
2024,8,14,3,2024-08-14,OO,3220,LAS,SFO,"Las Vegas, NV",Nevada,"San Francisco, CA",California,745,1039,-9,0,736,1039,11,3,747,1036,2256,272,292,286,0,,0,0.0,0.0,0.0,0.0,0.0
2024,6,25,2,2024-06-25,AS,6828,DFW,SEA,"Dallas/Fort Worth, TX",Texas,"Seattle, WA",Washington,1739,1679,3,0,1742,1679,27,4,1769,1675,2747,344,364,375,0,,0,0.0,0.0,0.0,0.0,0.0
2024,4,8,1,2024-04-08,9E,8999,DEN,CLT,"Denver, CO",Colorado,"Charlotte, NC",North Carolina,936,1954,-16,-10,920,1944,23,6,943,1938,1489,183,203,212,0,,0,0.0,0.0,0.0,0.0,0.0
2024,2,5,1,2024-02-05,MQ,6130,MDW,TPA,"Chicago, IL",Illinois,"Tampa, FL",Florida,1187,872,7,10,1194,882,18,19,1212,863,2488,301,321,338,0,,0,0.0,0.0,0.0,0.0,0.0
2024,4,5,5,2024-04-05,9E,278,BOS,PDX,"Boston, MA",Massachusetts,"Portland, OR",Oregon,975,1301,-11,-15,964,1286,19,4,983,1282,1548,194,214,217,0,,0,0.0,0.0,0.0,0.0,0.0
2024,5,31,5,2024-05-31,HA,5267,PDX,PHL,"Portland, OR",Oregon,"Philadelphia, PA",Pennsylvania,1907,1644,28,30,1935,1674,25,9,1960,1665,2157,275,295,309,0,,0,3.0,8.0,2.0,0.0,17.0
2024,5,30,4,2024-05-30,OO,212,ORD,DTW,"Chicago, IL",Illinois,"Detroit, MI",Michigan,1437,764,5,0,1442,764,10,12,1452,752,2040,251,271,273,0,,0,0.0,0.0,0.0,0.0,0.0
2024,7,8,1,2024-07-08,YX,9048,IAD,LAX,"Washington, DC",District of Columbia,"Los Angeles, CA",California,1377,2115,-8,-10,1369,2105,14,12,1383,2093,2424,303,323,329,0,,0,0.0,0.0,0.0,0.0,0.0
2024,8,11,7,2024-08-11,OH,9188,MDW,PDX,"Chicago, IL",Illinois,"Portland, OR",Oregon,1156,1482,-1,-5,1155,1477,29,15,1184,1462,730,93,113,137,0,,0,0.0,0.0,0.0,0.0,0.0
2024,2,6,2,2024-02-06,HA,8450,LAX,EWR,"Los Angeles, CA",California,"Newark, NJ",New Jersey,1046,2041,-27,-20,1019,2021,7,7,1026,2014,1260,155,175,169,0,,1,0.0,0.0,0.0,0.0,0.0
2024,9,24,2,2024-09-24,G4,9077,LAS,DFW,"Las Vegas, NV",Nevada,"Dallas/Fort Worth, TX",Texas,914,2203,-5,-10,909,2193,17,9,926,2184,2472,305,325,331,0,,0,0.0,0.0,0.0,0.0,0.0
2024,7,1,1,2024-07-01,OO,1903,SLC,HNL,"Salt Lake City, UT",Utah,"Honolulu, HI",Hawaii,1655,1591,-4,-5,1651,1586,23,16,1674,1570,1465,190,210,229,0,,0,0.0,0.0,0.0,0.0,0.0
2024,1,13,6,2024-01-13,MQ,2398,DTW,MSP,"Detroit, MI",Michigan,"Minneapolis, MN",Minnesota,897,1555,9,0,906,1555,25,12,931,1543,589,80,100,117,0,,0,0.0,0.0,0.0,0.0,0.0
2024,10,5,6,2024-10-05,UA,1642,IAH,BWI,"Houston, TX",Texas,"Baltimore, MD",Maryland,2030,1890,-14,-15,2016,1875,22,10,2038,1865,1543,191,211,223,0,,0,0.0,0.0,0.0,0.0,0.0
2024,8,4,7,2024-08-04,B6,7359,MCO,JFK,"Orlando, FL",Florida,"New York, NY",New York,1676,2353,9,5,1685,2358,7,4,1692,2354,1118,129,149,140,0,,0,0.0,0.0,0.0,0.0,0.0
2024,12,20,5,2024-12-20,MQ,2254,CLT,STL,"Charlotte, NC",North Carolina,"St. Louis, MO",Missouri,2083,1961,4,10,2087,1971,26,16,2113,1955,2197,277,297,319,0,,0,0.0,0.0,0.0,0.0,0.0
2024,12,26,4,2024-12-26,OH,8866,MIA,SEA,"Miami, FL",Florida,"Seattle, WA",Washington,667,1484,-10,0,657,1484,7,4,664,1480,2790,338,358,349,0,,0,0.0,0.0,0.0,0.0,0.0
2024,10,12,6,2024-10-12,B6,1481,ATL,SLC,"Atlanta, GA",Georgia,"Salt Lake City, UT",Utah,2213,2231,-1,-10,2212,2221,21,14,2233,2207,2280,281,301,316,0,,0,0.0,0.0,0.0,0.0,0.0
2024,9,29,7,2024-09-29,9E,6002,BOS,BWI,"Boston, MA",Massachusetts,"Baltimore, MD",Maryland,2298,787,-23,-15,2275,772,27,19,2302,753,2776,355,375,401,0,,0,0.0,0.0,0.0,0.0,0.0
2024,3,2,6,2024-03-02,NK,1322,IAH,PDX,"Houston, TX",Texas,"Portland, OR",Oregon,2130,2098,-23,-20,2107,2078,11,19,2118,2059,776,105,125,135,0,,0,0.0,0.0,0.0,0.0,0.0
2024,3,24,7,2024-03-24,WN,1601,LGA,JFK,"New York, NY",New York,"New York, NY",New York,1302,807,1,5,1303,812,6,17,1309,795,2195,267,287,290,0,,0,0.0,0.0,0.0,0.0,0.0
2024,8,4,7,2024-08-04,OO,9150,SEA,PDX,"Seattle, WA",Washington,"Portland, OR",Oregon,729,673,2,0,731,673,9,5,740,668,2826,349,369,363,0,,0,0.0,0.0,0.0,0.0,0.0
2024,12,7,6,2024-12-07,WN,3674,PHX,CLT,"Phoenix, AZ",Arizona,"Charlotte, NC",North Carolina,1202,1273,-1,0,1201,1273,13,13,1214,1260,372,51,71,77,0,,0,0.0,0.0,0.0,0.0,0.0
2024,7,5,5,2024-07-05,NK,3829,CLT,SFO,"Charlotte, NC",North Carolina,"San Francisco, CA",California,1927,1272,-9,-15,1918,1257,7,5,1925,1252,2475,305,325,317,0,,0,0.0,0.0,0.0,0.0,0.0
2024,1,19,5,2024-01-19,G4,7840,IAD,TPA,"Washington, DC",District of Columbia,"Tampa, FL",Florida,643,2017,-10,-10,633,2007,12,6,645,2001,287,35,55,53,0,,0,0.0,0.0,0.0,0.0,0.0
2024,6,25,2,2024-06-25,HA,3291,LAX,LAS,"Los Angeles, CA",California,"Las Vegas, NV",Nevada,2199,1089,7,10,2206,1099,8,11,2214,1088,432,51,71,70,0,,0,0.0,0.0,0.0,0.0,0.0
2024,4,9,2,2024-04-09,OO,9888,IAD,DFW,"Washington, DC",District of Columbia,"Dallas/Fort Worth, TX",Texas,2054,1171,4,0,2058,1171,7,8,2065,1163,2999,376,396,391,1,,0,0.0,0.0,0.0,0.0,0.0
2024,8,20,2,2024-08-20,WN,7576,LAS,IAD,"Las Vegas, NV",Nevada,"Washington, DC",District of Columbia,567,1649,21,20,588,1669,22,9,610,1660,1941,240,260,271,0,,0,5.0,1.0,0.0,0.0,14.0
2024,3,16,6,2024-03-16,WN,1661,LAS,EWR,"Las Vegas, NV",Nevada,"Newark, NJ",New Jersey,1517,1473,127,120,1644,1593,19,3,1663,1590,2284,279,299,301,0,,0,17.0,9.0,2.0,4.0,88.0
2024,9,21,6,2024-09-21,AS,2622,DCA,MCO,"Washington, DC",District of Columbia,"Orlando, FL",Florida,597,2160,9,10,606,2170,29,5,635,2165,1571,195,215,229,0,,0,0.0,0.0,0.0,0.0,0.0
2024,10,10,4,2024-10-10,AS,2491,MDW,MCO,"Chicago, IL",Illinois,"Orlando, FL",Florida,506,1114,-9,-10,497,1104,15,17,512,1087,2530,316,336,348,0,,0,0.0,0.0,0.0,0.0,0.0
2024,7,24,3,2024-07-24,NK,2775,SLC,BOS,"Salt Lake City, UT",Utah,"Boston, MA",Massachusetts,1314,1880,-17,-10,1297,1870,9,4,1306,1866,2395,305,325,318,0,,0,0.0,0.0,0.0,0.0,0.0
2024,8,10,6,2024-08-10,HA,2283,SLC,ATL,"Salt Lake City, UT",Utah,"Atlanta, GA",Georgia,676,879,-6,-10,670,869,29,11,699,858,1120,144,164,184,0,,0,0.0,0.0,0.0,0.0,0.0
2024,2,21,3,2024-02-21,AA,8568,TPA,JFK,"Tampa, FL",Florida,"New York, NY",New York,1729,1417,37,30,1766,1447,20,10,1786,1437,1293,161,181,191,0,,0,10.0,2.0,1.0,0.0,17.0
2024,12,4,3,2024-12-04,MQ,8166,MCO,MSP,"Orlando, FL",Florida,"Minneapolis, MN",Minnesota,798,1538,-3,-5,795,1533,28,16,823,1517,1914,230,250,274,0,,0,0.0,0.0,0.0,0.0,0.0
2024,5,23,4,2024-05-23,OO,2178,BOS,IAH,"Boston, MA",Massachusetts,"Houston, TX",Texas,728,1359,11,5,739,1364,23,12,762,1352,1333,163,183,198,0,,0,0.0,0.0,0.0,0.0,0.0
2024,3,9,6,2024-03-09,OH,4442,PHX,SEA,"Phoenix, AZ",Arizona,"Seattle, WA",Washington,1395,1155,10,20,1405,1175,8,13,1413,1162,2414,302,322,323,1,,0,6.0,0.0,0.0,0.0,14.0
2024,4,8,1,2024-04-08,UA,1220,MSP,JFK,"Minneapolis, MN",Minnesota,"New York, NY",New York,1130,1656,4,10,1134,1666,26,10,1160,1656,576,68,88,104,0,,0,0.0,0.0,0.0,0.0,0.0
2024,1,25,4,2024-01-25,G4,5519,LAS,PDX,"Las Vegas, NV",Nevada,"Portland, OR",Oregon,769,1917,6,0,775,1917,15,6,790,1911,2806,341,361,362,0,,0,0.0,0.0,0.0,0.0,0.0
2024,2,22,4,2024-02-22,AS,3470,BOS,STL,"Boston, MA",Massachusetts,"St. Louis, MO",Missouri,580,2247,-1,-10,579,2237,16,10,595,2227,886,107,127,133,0,,0,0.0,0.0,0.0,0.0,0.0
2024,5,30,4,2024-05-30,AS,2008,DCA,PDX,"Washington, DC",District of Columbia,"Portland, OR",Oregon,2195,1931,-3,-10,2192,1921,9,12,2201,1909,1273,163,183,184,0,,0,0.0,0.0,0.0,0.0,0.0
2024,5,23,4,2024-05-23,B6,3620,ORD,BOS,"Chicago, IL",Illinois,"Boston, MA",Massachusetts,1711,890,-2,0,1709,890,14,17,1723,873,2531,317,337,348,0,,0,0.0,0.0,0.0,0.0,0.0
2024,2,26,1,2024-02-26,OO,4407,STL,LGA,"St. Louis, MO",Missouri,"New York, NY",New York,2223,1384,19,20,2242,1404,14,15,2256,1389,2022,244,264,273,0,,0,3.0,5.0,3.0,0.0,9.0
2024,2,8,4,2024-02-08,UA,4596,PDX,TPA,"Portland, OR",Oregon,"Tampa, FL",Florida,1319,1425,21,15,1340,1440,23,7,1363,1433,400,43,63,73,0,,0,0.0,0.0,0.0,0.0,0.0
2024,4,18,4,2024-04-18,OO,4850,IAH,IAD,"Houston, TX",Texas,"Washington, DC",District of Columbia,1000,1927,-20,-10,980,1917,9,17,989,1900,1475,185,205,211,0,,0,0.0,0.0,0.0,0.0,0.0
2024,6,29,6,2024-06-29,B6,597,SEA,MDW,"Seattle, WA",Washington,"Chicago, IL",Illinois,1205,1666,-17,-10,1188,1656,9,5,1197,1651,2953,365,385,379,0,,0,0.0,0.0,0.0,0.0,0.0
2024,2,11,7,2024-02-11,OH,7091,MIA,LAX,"Miami, FL",Florida,"Los Angeles, CA",California,2010,2179,7,0,2017,2179,29,5,2046,2174,2172,276,296,310,0,,0,0.0,0.0,0.0,0.0,0.0
2024,7,4,4,2024-07-04,AA,3687,PHX,ORD,"Phoenix, AZ",Arizona,"Chicago, IL",Illinois,2295,1570,4,0,2299,1570,8,15,2307,1555,2294,292,312,315,0,,0,0.0,0.0,0.0,0.0,0.0
2024,8,10,6,2024-08-10,UA,2513,BWI,BOS,"Baltimore, MD",Maryland,"Boston, MA",Massachusetts,2011,2222,-11,-15,2000,2207,28,11,2028,2196,372,54,74,93,0,,0,0.0,0.0,0.0,0.0,0.0
2024,5,1,3,2024-05-01,WN,3900,TPA,LGA,"Tampa, FL",Florida,"New York, NY",New York,1489,1341,-15,-5,1474,1336,8,4,1482,1332,2441,309,329,321,0,,0,0.0,0.0,0.0,0.0,0.0
2024,5,12,7,2024-05-12,B6,8754,EWR,SAN,"Newark, NJ",New Jersey,"San Diego, CA",California,2001,2103,10,20,2011,2123,6,17,2017,2106,2878,368,388,391,0,,0,0.0,0.0,2.0,0.0,18.0
2024,6,11,2,2024-06-11,9E,6271,DCA,MSP,"Washington, DC",District of Columbia,"Minneapolis, MN",Minnesota,1202,682,20,20,1222,702,7,10,1229,692,1699,219,239,236,1,,0,7.0,4.0,2.0,0.0,7.0
2024,8,2,5,2024-08-02,G4,3557,MSP,EWR,"Minneapolis, MN",Minnesota,"Newark, NJ",New Jersey,1812,1827,0,0,1812,1827,8,5,1820,1822,734,85,105,98,0,,0,0.0,0.0,0.0,0.0,0.0
2024,8,8,4,2024-08-08,WN,8564,IAH,PDX,"Houston, TX",Texas,"Portland, OR",Oregon,605,1241,-5,0,600,1241,12,3,612,1238,1115,142,162,157,0,,0,0.0,0.0,0.0,0.0,0.0
2024,8,22,4,2024-08-22,UA,7069,DTW,HNL,"Detroit, MI",Michigan,"Honolulu, HI",Hawaii,1140,1761,-20,-10,1120,1751,13,9,1133,1742,2664,336,356,358,0,,0,0.0,0.0,0.0,0.0,0.0
2024,11,26,2,2024-11-26,9E,1250,SAN,TPA,"San Diego, CA",California,"Tampa, FL",Florida,1108,682,8,5,1116,687,26,8,1142,679,1453,184,204,218,0,,0,0.0,0.0,0.0,0.0,0.0
2024,5,25,6,2024-05-25,AA,7554,STL,LAS,"St. Louis, MO",Missouri,"Las Vegas, NV",Nevada,1495,2310,-20,-15,1475,2295,12,3,1487,2292,800,106,126,121,0,,0,0.0,0.0,0.0,0.0,0.0
2024,8,26,1,2024-08-26,MQ,5307,EWR,HNL,"Newark, NJ",New Jersey,"Honolulu, HI",Hawaii,1508,1247,-4,-10,1504,1237,16,11,1520,1226,2295,289,309,316,0,,0,0.0,0.0,0.0,0.0,0.0
2024,3,16,6,2024-03-16,9E,118,DEN,JFK,"Denver, CO",Colorado,"New York, NY",New York,2099,1218,-22,-20,2077,1198,14,13,2091,1185,599,67,87,94,0,,0,0.0,0.0,0.0,0.0,0.0
2024,1,9,2,2024-01-09,AS,9908,BWI,LGA,"Baltimore, MD",Maryland,"New York, NY",New York,2163,750,1,-5,2164,745,9,7,2173,738,2245,279,299,295,0,,0,0.0,0.0,0.0,0.0,0.0
2024,3,14,4,2024-03-14,NK,3278,CLT,SAN,"Charlotte, NC",North Carolina,"San Diego, CA",California,1746,1543,13,10,1759,1553,9,5,1768,1548,694,79,99,93,0,,0,0.0,0.0,0.0,0.0,0.0
2024,9,9,1,2024-09-09,9E,5677,MDW,LAS,"Chicago, IL",Illinois,"Las Vegas, NV",Nevada,881,2244,38,30,919,2274,28,11,947,2263,622,69,89,108,0,,0,8.0,0.0,5.0,0.0,17.0
2024,8,17,6,2024-08-17,HA,4181,STL,SEA,"St. Louis, MO",Missouri,"Seattle, WA",Washington,1337,2357,2,5,1339,2362,19,9,1358,2353,334,37,57,65,0,,0,0.0,0.0,0.0,0.0,0.0
2024,1,7,7,2024-01-07,F9,6554,SLC,EWR,"Salt Lake City, UT",Utah,"Newark, NJ",New Jersey,603,1459,6,5,609,1464,24,15,633,1449,2565,329,349,368,0,,0,0.0,0.0,0.0,0.0,0.0
2024,6,22,6,2024-06-22,YX,8703,BWI,HNL,"Baltimore, MD",Maryland,"Honolulu, HI",Hawaii,1163,918,-19,-10,1144,908,7,3,1151,905,2931,362,382,372,0,,0,0.0,0.0,0.0,0.0,0.0
2024,5,20,1,2024-05-20,AA,9033,MSP,EWR,"Minneapolis, MN",Minnesota,"Newark, NJ",New Jersey,1637,1870,-8,0,1629,1870,6,5,1635,1865,1961,237,257,248,0,,0,0.0,0.0,0.0,0.0,0.0
2024,6,16,7,2024-06-16,YX,2771,STL,SFO,"St. Louis, MO",Missouri,"San Francisco, CA",California,2031,1660,7,5,2038,1665,19,8,2057,1657,1560,197,217,224,0,,0,0.0,0.0,0.0,0.0,0.0
2024,6,18,2,2024-06-18,WN,6487,DTW,BOS,"Detroit, MI",Michigan,"Boston, MA",Massachusetts,1578,1891,-6,0,1572,1891,17,13,1589,1878,303,30,50,60,0,,0,0.0,0.0,0.0,0.0,0.0
2024,10,9,3,2024-10-09,OO,6933,IAH,ORD,"Houston, TX",Texas,"Chicago, IL",Illinois,620,2209,-8,-15,612,2194,28,19,640,2175,1505,196,216,243,0,,0,0.0,0.0,0.0,0.0,0.0
2024,5,1,3,2024-05-01,B6,2724,MIA,PHX,"Miami, FL",Florida,"Phoenix, AZ",Arizona,1740,714,-5,5,1735,719,16,17,1751,702,2087,253,273,286,0,,0,0.0,0.0,0.0,0.0,0.0
2024,7,12,5,2024-07-12,DL,5599,MDW,MCO,"Chicago, IL",Illinois,"Orlando, FL",Florida,2158,1704,-16,-10,2142,1694,18,6,2160,1688,2131,270,290,294,0,,0,0.0,0.0,0.0,0.0,0.0
2024,1,5,5,2024-01-05,AA,614,LAX,MSP,"Los Angeles, CA",California,"Minneapolis, MN",Minnesota,1526,1304,-14,-15,1512,1289,16,3,1528,1286,2111,272,292,291,0,,0,0.0,0.0,0.0,0.0,0.0
2024,1,29,1,2024-01-29,F9,306,PHL,BWI,"Philadelphia, PA",Pennsylvania,"Baltimore, MD",Maryland,1615,1325,8,0,1623,1325,19,3,1642,1322,2197,275,295,297,0,,0,0.0,0.0,0.0,0.0,0.0
2024,6,13,4,2024-06-13,AS,1047,SAN,MSP,"San Diego, CA",California,"Minneapolis, MN",Minnesota,906,2150,-20,-15,886,2135,25,8,911,2127,1308,166,186,199,0,,0,0.0,0.0,0.0,0.0,0.0
2024,12,4,3,2024-12-04,B6,1928,MSP,TPA,"Minneapolis, MN",Minnesota,"Tampa, FL",Florida,1175,1959,-9,0,1166,1959,26,11,1192,1948,1512,182,202,219,0,,0,0.0,0.0,0.0,0.0,0.0
2024,5,15,3,2024-05-15,MQ,6961,IAD,ORD,"Washington, DC",District of Columbia,"Chicago, IL",Illinois,940,1707,-9,0,931,1707,29,16,960,1691,522,57,77,102,0,,0,0.0,0.0,0.0,0.0,0.0
2024,12,30,1,2024-12-30,G4,6194,IAH,DFW,"Houston, TX",Texas,"Dallas/Fort Worth, TX",Texas,2154,1486,-1,-10,2153,1476,17,16,2170,1460,2966,365,385,398,0,,0,0.0,0.0,0.0,0.0,0.0
2024,11,16,6,2024-11-16,MQ,6445,PHL,IAD,"Philadelphia, PA",Pennsylvania,"Washington, DC",District of Columbia,931,1377,22,20,953,1397,7,9,960,1388,1742,221,241,237,0,,0,2.0,5.0,0.0,0.0,13.0
2024,12,7,6,2024-12-07,OO,2267,MSP,PHL,"Minneapolis, MN",Minnesota,"Philadelphia, PA",Pennsylvania,1408,1409,13,10,1421,1419,19,8,1440,1411,2977,366,386,393,0,,0,0.0,0.0,0.0,0.0,0.0
2024,5,24,5,2024-05-24,MQ,8079,DEN,IAD,"Denver, CO",Colorado,"Washington, DC",District of Columbia,560,753,-20,-15,540,738,24,5,564,733,865,103,123,132,0,,0,0.0,0.0,0.0,0.0,0.0
2024,11,22,5,2024-11-22,OO,6026,PHX,SLC,"Phoenix, AZ",Arizona,"Salt Lake City, UT",Utah,1225,852,6,5,1231,857,22,7,1253,850,275,35,55,64,0,,0,0.0,0.0,0.0,0.0,0.0
2024,8,4,7,2024-08-04,DL,6632,SAN,IAH,"San Diego, CA",California,"Houston, TX",Texas,1996,1101,-3,-5,1993,1096,10,8,2003,1088,1666,204,224,222,0,,0,0.0,0.0,0.0,0.0,0.0
2024,10,27,7,2024-10-27,9E,5756,PHL,IAH,"Philadelphia, PA",Pennsylvania,"Houston, TX",Texas,1770,1047,2,5,1772,1052,19,10,1791,1042,827,112,132,141,0,,0,0.0,0.0,0.0,0.0,0.0
2024,5,11,6,2024-05-11,YX,6043,IAH,SLC,"Houston, TX",Texas,"Salt Lake City, UT",Utah,2270,1896,13,10,2283,1906,29,15,2312,1891,895,111,131,155,0,,0,0.0,0.0,0.0,0.0,0.0
2024,10,18,5,2024-10-18,F9,9948,MCO,LAS,"Orlando, FL",Florida,"Las Vegas, NV",Nevada,1438,1529,-3,-10,1435,1519,16,15,1451,1504,1588,204,224,235,0,,0,0.0,0.0,0.0,0.0,0.0
2024,3,10,7,2024-03-10,OO,8893,EWR,MIA,"Newark, NJ",New Jersey,"Miami, FL",Florida,1368,1424,-2,5,1366,1429,6,3,1372,1426,2313,290,310,299,0,,0,0.0,0.0,0.0,0.0,0.0
2024,9,8,7,2024-09-08,OH,5539,DTW,DCA,"Detroit, MI",Michigan,"Washington, DC",District of Columbia,1895,1453,5,10,1900,1463,9,11,1909,1452,243,27,47,47,0,,0,0.0,0.0,0.0,0.0,0.0
2024,10,1,2,2024-10-01,9E,9003,MCO,SFO,"Orlando, FL",Florida,"San Francisco, CA",California,1812,1106,-10,-5,1802,1101,21,6,1823,1095,1958,246,266,273,0,,0,0.0,0.0,0.0,0.0,0.0
2024,12,29,7,2024-12-29,MQ,1303,EWR,IAH,"Newark, NJ",New Jersey,"Houston, TX",Texas,2113,731,-11,-15,2102,716,17,7,2119,709,2178,279,299,303,0,,0,0.0,0.0,0.0,0.0,0.0
2024,6,30,7,2024-06-30,G4,7100,MCO,CLT,"Orlando, FL",Florida,"Charlotte, NC",North Carolina,1547,2334,-18,-20,1529,2314,17,19,1546,2295,1641,213,233,249,0,,0,0.0,0.0,0.0,0.0,0.0
2024,6,15,6,2024-06-15,AA,9683,PHX,DTW,"Phoenix, AZ",Arizona,"Detroit, MI",Michigan,905,1948,-19,-15,886,1933,8,9,894,1924,1363,177,197,194,0,,0,0.0,0.0,0.0,0.0,0.0
2024,3,31,7,2024-03-31,NK,6739,TPA,LAX,"Tampa, FL",Florida,"Los Angeles, CA",California,1831,950,-18,-20,1813,930,20,15,1833,915,1858,231,251,266,0,,0,0.0,0.0,0.0,0.0,0.0
2024,7,20,6,2024-07-20,F9,7789,CLT,IAD,"Charlotte, NC",North Carolina,"Washington, DC",District of Columbia,1112,1706,-10,-5,1102,1701,12,3,1114,1698,423,47,67,62,0,,0,0.0,0.0,0.0,0.0,0.0
2024,12,11,3,2024-12-11,UA,7613,LAX,BOS,"Los Angeles, CA",California,"Boston, MA",Massachusetts,1895,1417,-15,-10,1880,1407,7,16,1887,1391,811,95,115,118,0,,0,0.0,0.0,0.0,0.0,0.0
2024,1,19,5,2024-01-19,OH,6726,LAS,ATL,"Las Vegas, NV",Nevada,"Atlanta, GA",Georgia,2286,725,-12,-15,2274,710,24,16,2298,694,279,36,56,76,0,,0,0.0,0.0,0.0,0.0,0.0
2024,2,8,4,2024-02-08,WN,7486,MIA,PDX,"Miami, FL",Florida,"Portland, OR",Oregon,2158,1837,-3,5,2155,1842,6,15,2161,1827,1092,132,152,153,0,,0,0.0,0.0,0.0,0.0,0.0
2024,5,5,7,2024-05-05,MQ,3231,IAD,MDW,"Washington, DC",District of Columbia,"Chicago, IL",Illinois,714,1434,45,45,759,1479,29,10,788,1469,1632,204,224,243,0,,0,4.0,2.0,2.0,1.0,36.0
2024,6,21,5,2024-06-21,UA,7234,MCO,BWI,"Orlando, FL",Florida,"Baltimore, MD",Maryland,761,2350,17,15,778,2365,25,3,803,2362,1701,214,234,242,0,,0,0.0,0.0,0.0,0.0,0.0
2024,5,20,1,2024-05-20,NK,3830,MDW,DTW,"Chicago, IL",Illinois,"Detroit, MI",Michigan,1414,2223,-18,-10,1396,2213,7,17,1403,2196,1775,215,235,239,0,,0,0.0,0.0,0.0,0.0,0.0
2024,8,29,4,2024-08-29,G4,2766,CLT,DCA,"Charlotte, NC",North Carolina,"Washington, DC",District of Columbia,1869,1495,6,5,1875,1500,15,19,1890,1481,2980,380,400,414,0,,0,0.0,0.0,0.0,0.0,0.0
2024,8,7,3,2024-08-07,UA,649,MIA,BOS,"Miami, FL",Florida,"Boston, MA",Massachusetts,1936,1554,24,15,1960,1569,15,19,1975,1550,2167,278,298,312,0,,0,0.0,0.0,0.0,0.0,0.0
2024,5,5,7,2024-05-05,MQ,4841,DFW,SFO,"Dallas/Fort Worth, TX",Texas,"San Francisco, CA",California,622,1061,9,15,631,1076,14,4,645,1072,1566,188,208,206,1,,0,0.0,0.0,0.0,0.0,0.0
2024,2,27,2,2024-02-27,AS,1344,STL,IAH,"St. Louis, MO",Missouri,"Houston, TX",Texas,1263,1224,12,10,1275,1234,27,16,1302,1218,1663,208,228,251,0,,0,0.0,0.0,0.0,0.0,0.0
2024,5,27,1,2024-05-27,F9,4112,IAH,PDX,"Houston, TX",Texas,"Portland, OR",Oregon,819,704,5,5,824,709,15,3,839,706,1027,135,155,153,0,,0,0.0,0.0,0.0,0.0,0.0
2024,11,12,2,2024-11-12,AS,9137,DTW,DFW,"Detroit, MI",Michigan,"Dallas/Fort Worth, TX",Texas,1860,1994,-4,-10,1856,1984,21,4,1877,1980,307,30,50,55,0,,0,0.0,0.0,0.0,0.0,0.0
2024,12,26,4,2024-12-26,DL,6296,LAS,ATL,"Las Vegas, NV",Nevada,"Atlanta, GA",Georgia,657,662,-16,-15,641,647,29,9,670,638,312,39,59,77,1,,0,0.0,0.0,0.0,0.0,0.0
2024,1,1,1,2024-01-01,MQ,4645,SEA,BWI,"Seattle, WA",Washington,"Baltimore, MD",Maryland,1850,1562,1,0,1851,1562,11,3,1862,1559,1398,172,192,186,0,,0,0.0,0.0,0.0,0.0,0.0
2024,12,13,5,2024-12-13,NK,6305,MSP,BOS,"Minneapolis, MN",Minnesota,"Boston, MA",Massachusetts,2184,1350,-20,-15,2164,1335,5,12,2169,1323,2115,271,291,288,0,,0,0.0,0.0,0.0,0.0,0.0
2024,7,8,1,2024-07-08,DL,7290,BOS,SLC,"Boston, MA",Massachusetts,"Salt Lake City, UT",Utah,1588,2092,84,90,1672,2182,24,5,1696,2177,2092,262,282,291,1,,0,0.0,25.0,1.0,3.0,61.0
2024,7,9,2,2024-07-09,DL,8335,PHL,PDX,"Philadelphia, PA",Pennsylvania,"Portland, OR",Oregon,868,625,-15,-5,853,620,19,15,872,605,2377,295,315,329,0,,0,0.0,0.0,0.0,0.0,0.0
2024,11,7,4,2024-11-07,DL,758,STL,IAH,"St. Louis, MO",Missouri,"Houston, TX",Texas,1369,2263,29,20,1398,2283,11,4,1409,2279,1036,124,144,139,0,,0,5.0,5.0,1.0,0.0,9.0
2024,4,26,5,2024-04-26,OO,7095,EWR,MCO,"Newark, NJ",New Jersey,"Orlando, FL",Florida,1527,600,14,5,1541,605,8,5,1549,600,2349,284,304,297,1,,0,0.0,0.0,0.0,0.0,0.0
2024,5,13,1,2024-05-13,HA,5876,JFK,EWR,"New York, NY",New York,"Newark, NJ",New Jersey,1185,693,-1,-5,1184,688,27,6,1211,682,1461,172,192,205,0,,0,0.0,0.0,0.0,0.0,0.0
2024,2,27,2,2024-02-27,AA,5393,JFK,SEA,"New York, NY",New York,"Seattle, WA",Washington,2171,1482,-10,-15,2161,1467,7,19,2168,1448,2525,308,328,334,0,,0,0.0,0.0,0.0,0.0,0.0
2024,2,13,2,2024-02-13,OH,1791,IAD,MCO,"Washington, DC",District of Columbia,"Orlando, FL",Florida,1413,1051,-11,-10,1402,1041,24,10,1426,1031,1012,135,155,169,0,,0,0.0,0.0,0.0,0.0,0.0
2024,6,21,5,2024-06-21,OO,9657,LAX,PHL,"Los Angeles, CA",California,"Philadelphia, PA",Pennsylvania,2279,1635,2,5,2281,1640,7,10,2288,1630,1195,156,176,173,0,,0,0.0,0.0,0.0,0.0,0.0
2024,6,8,6,2024-06-08,AA,7835,SFO,MDW,"San Francisco, CA",California,"Chicago, IL",Illinois,1583,2301,1,10,1584,2311,24,5,1608,2306,1996,242,262,271,0,,0,0.0,0.0,0.0,0.0,0.0
2024,6,21,5,2024-06-21,OH,3230,PDX,MIA,"Portland, OR",Oregon,"Miami, FL",Florida,1568,897,16,20,1584,917,14,17,1598,900,1827,228,248,259,0,,0,0.0,0.0,1.0,0.0,19.0
2024,11,12,2,2024-11-12,NK,7144,MIA,LAX,"Miami, FL",Florida,"Los Angeles, CA",California,1083,2043,-25,-15,1058,2028,7,13,1065,2015,1782,212,232,232,0,,0,0.0,0.0,0.0,0.0,0.0
2024,10,29,2,2024-10-29,HA,4633,DFW,BWI,"Dallas/Fort Worth, TX",Texas,"Baltimore, MD",Maryland,2130,2202,-1,-10,2129,2192,9,11,2138,2181,2078,255,275,275,0,,0,0.0,0.0,0.0,0.0,0.0
2024,5,28,2,2024-05-28,MQ,5647,DTW,SLC,"Detroit, MI",Michigan,"Salt Lake City, UT",Utah,1042,1790,-25,-20,1017,1770,24,13,1041,1757,1801,225,245,262,0,,0,0.0,0.0,0.0,0.0,0.0
2024,3,20,3,2024-03-20,OH,1067,TPA,JFK,"Tampa, FL",Florida,"New York, NY",New York,655,853,-8,-10,647,843,23,8,670,835,452,61,81,92,0,,0,0.0,0.0,0.0,0.0,0.0
2024,7,31,3,2024-07-31,OH,1504,DCA,MIA,"Washington, DC",District of Columbia,"Miami, FL",Florida,1387,2194,11,10,1398,2204,25,12,1423,2192,2057,265,285,302,0,,0,0.0,0.0,0.0,0.0,0.0
2024,7,21,7,2024-07-21,HA,8777,TPA,PDX,"Tampa, FL",Florida,"Portland, OR",Oregon,1251,1917,-2,-10,1249,1907,14,12,1263,1895,1993,251,271,277,0,,0,0.0,0.0,0.0,0.0,0.0
2024,9,8,7,2024-09-08,OH,3730,SEA,MIA,"Seattle, WA",Washington,"Miami, FL",Florida,563,1767,6,0,569,1767,13,15,582,1752,1013,116,136,144,0,,0,0.0,0.0,0.0,0.0,0.0
2024,8,16,5,2024-08-16,YX,3068,DFW,LAS,"Dallas/Fort Worth, TX",Texas,"Las Vegas, NV",Nevada,920,808,-11,-5,909,803,15,19,924,784,2956,370,390,404,0,,0,0.0,0.0,0.0,0.0,0.0
2024,6,12,3,2024-06-12,B6,7369,DCA,ATL,"Washington, DC",District of Columbia,"Atlanta, GA",Georgia,822,1849,-1,-5,821,1844,5,6,826,1838,853,96,116,107,0,,0,0.0,0.0,0.0,0.0,0.0
2024,8,14,3,2024-08-14,OO,1679,PDX,SLC,"Portland, OR",Oregon,"Salt Lake City, UT",Utah,1632,2081,3,0,1635,2081,24,3,1659,2078,2952,372,392,399,0,,0,0.0,0.0,0.0,0.0,0.0
2024,5,26,7,2024-05-26,UA,6092,ORD,HNL,"Chicago, IL",Illinois,"Honolulu, HI",Hawaii,1986,1506,-8,0,1978,1506,17,9,1995,1497,1519,191,211,217,0,,0,0.0,0.0,0.0,0.0,0.0
2024,1,20,6,2024-01-20,AA,150,DEN,SLC,"Denver, CO",Colorado,"Salt Lake City, UT",Utah,2103,883,-11,-5,2092,878,27,7,2119,871,2909,368,388,402,0,,0,0.0,0.0,0.0,0.0,0.0
2024,2,16,5,2024-02-16,OO,6552,JFK,HNL,"New York, NY",New York,"Honolulu, HI",Hawaii,1046,2226,8,5,1054,2231,8,18,1062,2213,2262,276,296,302,0,,0,0.0,0.0,0.0,0.0,0.0
2024,8,20,2,2024-08-20,9E,5253,BWI,MCO,"Baltimore, MD",Maryland,"Orlando, FL",Florida,750,2109,-13,-10,737,2099,28,7,765,2092,2055,249,269,284,0,,0,0.0,0.0,0.0,0.0,0.0
2024,10,31,4,2024-10-31,AS,9951,PHL,HNL,"Philadelphia, PA",Pennsylvania,"Honolulu, HI",Hawaii,1365,1734,0,0,1365,1734,27,12,1392,1722,2426,296,316,335,0,,0,0.0,0.0,0.0,0.0,0.0
2024,1,14,7,2024-01-14,OO,6123,SFO,LAS,"San Francisco, CA",California,"Las Vegas, NV",Nevada,1009,949,24,20,1033,969,25,18,1058,951,1895,233,253,276,0,,0,0.0,3.0,3.0,0.0,14.0
2024,5,22,3,2024-05-22,AA,4400,IAH,PHX,"Houston, TX",Texas,"Phoenix, AZ",Arizona,2071,1956,7,5,2078,1961,14,6,2092,1955,1446,184,204,204,0,,0,0.0,0.0,0.0,0.0,0.0
2024,1,1,1,2024-01-01,G4,2887,ORD,PDX,"Chicago, IL",Illinois,"Portland, OR",Oregon,940,1703,-11,-5,929,1698,8,3,937,1695,1438,184,204,195,0,,0,0.0,0.0,0.0,0.0,0.0
2024,2,23,5,2024-02-23,DL,2255,SAN,STL,"San Diego, CA",California,"St. Louis, MO",Missouri,953,2009,7,5,960,2014,12,10,972,2004,856,103,123,125,0,,0,0.0,0.0,0.0,0.0,0.0
2024,9,15,7,2024-09-15,AA,7119,LGA,IAD,"New York, NY",New York,"Washington, DC",District of Columbia,1143,2027,2,10,1145,2037,21,3,1166,2034,2629,325,345,349,0,,0,0.0,0.0,0.0,0.0,0.0
2024,5,23,4,2024-05-23,HA,5460,CLT,MIA,"Charlotte, NC",North Carolina,"Miami, FL",Florida,1316,2339,-3,-5,1313,2334,6,5,1319,2329,873,116,136,127,0,,0,0.0,0.0,0.0,0.0,0.0
2024,1,12,5,2024-01-12,YX,4330,PDX,LAX,"Portland, OR",Oregon,"Los Angeles, CA",California,2257,1951,5,5,2262,1956,25,4,2287,1952,1164,150,170,179,0,,0,0.0,0.0,0.0,0.0,0.0
2024,11,25,1,2024-11-25,NK,9906,STL,ATL,"St. Louis, MO",Missouri,"Atlanta, GA",Georgia,1178,1917,-7,-5,1171,1912,11,7,1182,1905,246,34,54,52,0,,0,0.0,0.0,0.0,0.0,0.0
2024,8,11,7,2024-08-11,AS,7707,LAX,MSP,"Los Angeles, CA",California,"Minneapolis, MN",Minnesota,773,2117,3,10,776,2127,29,13,805,2114,881,119,139,161,0,,0,0.0,0.0,0.0,0.0,0.0
2024,9,28,6,2024-09-28,AS,8698,MIA,SAN,"Miami, FL",Florida,"San Diego, CA",California,559,783,-4,-10,555,773,7,16,562,757,703,92,112,115,0,,0,0.0,0.0,0.0,0.0,0.0
2024,12,23,1,2024-12-23,OH,4297,PDX,LAX,"Portland, OR",Oregon,"Los Angeles, CA",California,841,811,19,15,860,826,25,12,885,814,308,43,63,80,0,,0,0.0,0.0,0.0,0.0,0.0
2024,6,4,2,2024-06-04,B6,9676,PDX,BWI,"Portland, OR",Oregon,"Baltimore, MD",Maryland,1917,1874,7,0,1924,1874,15,9,1939,1865,1404,166,186,190,0,,0,0.0,0.0,0.0,0.0,0.0
2024,1,8,1,2024-01-08,OO,5512,MCO,PHX,"Orlando, FL",Florida,"Phoenix, AZ",Arizona,612,766,0,-5,612,761,22,10,634,751,2261,277,297,309,0,,0,0.0,0.0,0.0,0.0,0.0
2024,5,1,3,2024-05-01,WN,4599,MSP,LAX,"Minneapolis, MN",Minnesota,"Los Angeles, CA",California,1744,2166,-14,-5,1730,2161,10,19,1740,2142,2208,276,296,305,0,,0,0.0,0.0,0.0,0.0,0.0
2024,12,13,5,2024-12-13,OO,5009,SAN,DTW,"San Diego, CA",California,"Detroit, MI",Michigan,567,2286,-10,-5,557,2281,26,9,583,2272,778,91,111,126,0,,0,0.0,0.0,0.0,0.0,0.0
2024,6,12,3,2024-06-12,WN,7269,TPA,JFK,"Tampa, FL",Florida,"New York, NY",New York,1838,1785,-14,-15,1824,1770,24,18,1848,1752,2477,313,333,355,0,,0,0.0,0.0,0.0,0.0,0.0
2024,3,30,6,2024-03-30,UA,9921,LAX,DEN,"Los Angeles, CA",California,"Denver, CO",Colorado,966,2231,-21,-15,945,2216,18,19,963,2197,2779,350,370,387,0,,0,0.0,0.0,0.0,0.0,0.0
2024,5,15,3,2024-05-15,9E,3362,BOS,MDW,"Boston, MA",Massachusetts,"Chicago, IL",Illinois,1357,1896,1,-5,1358,1891,17,6,1375,1885,1668,213,233,236,0,,0,0.0,0.0,0.0,0.0,0.0
2024,7,4,4,2024-07-04,F9,9318,SFO,SLC,"San Francisco, CA",California,"Salt Lake City, UT",Utah,762,1474,8,0,770,1474,6,6,776,1468,350,48,68,60,0,,0,0.0,0.0,0.0,0.0,0.0
2024,11,11,1,2024-11-11,NK,3089,MCO,IAD,"Orlando, FL",Florida,"Washington, DC",District of Columbia,1654,2159,-4,-5,1650,2154,20,3,1670,2151,2782,345,365,368,0,,0,0.0,0.0,0.0,0.0,0.0
2024,6,26,3,2024-06-26,G4,7754,BWI,ORD,"Baltimore, MD",Maryland,"Chicago, IL",Illinois,923,2042,-26,-20,897,2022,28,5,925,2017,2241,288,308,321,0,,0,0.0,0.0,0.0,0.0,0.0
2024,1,28,7,2024-01-28,AA,2324,SAN,IAH,"San Diego, CA",California,"Houston, TX",Texas,1790,2253,-4,0,1786,2253,12,14,1798,2239,1612,195,215,221,0,,0,0.0,0.0,0.0,0.0,0.0
2024,8,7,3,2024-08-07,NK,5476,LAX,PHX,"Los Angeles, CA",California,"Phoenix, AZ",Arizona,1219,1006,-24,-15,1195,991,19,19,1214,972,1424,175,195,213,0,,0,0.0,0.0,0.0,0.0,0.0
2024,12,22,7,2024-12-22,9E,3020,BOS,DEN,"Boston, MA",Massachusetts,"Denver, CO",Colorado,1735,2015,-9,-10,1726,2005,17,18,1743,1987,410,54,74,89,0,,0,0.0,0.0,0.0,0.0,0.0
2024,2,10,6,2024-02-10,WN,7801,MCO,SAN,"Orlando, FL",Florida,"San Diego, CA",California,1062,1037,-21,-15,1041,1022,5,16,1046,1006,780,95,115,116,0,,0,0.0,0.0,0.0,0.0,0.0
2024,8,15,4,2024-08-15,NK,6641,DEN,DCA,"Denver, CO",Colorado,"Washington, DC",District of Columbia,1482,1710,-3,0,1479,1710,6,5,1485,1705,1931,242,262,253,0,,0,0.0,0.0,0.0,0.0,0.0
2024,7,10,3,2024-07-10,MQ,5715,PHL,SFO,"Philadelphia, PA",Pennsylvania,"San Francisco, CA",California,1418,1004,-21,-15,1397,989,8,18,1405,971,665,87,107,113,0,,0,0.0,0.0,0.0,0.0,0.0
2024,5,24,5,2024-05-24,YX,4415,PHL,DEN,"Philadelphia, PA",Pennsylvania,"Denver, CO",Colorado,787,874,-5,-10,782,864,17,6,799,858,844,108,128,131,0,,0,0.0,0.0,0.0,0.0,0.0
2024,7,19,5,2024-07-19,AA,6200,DEN,MCO,"Denver, CO",Colorado,"Orlando, FL",Florida,924,2038,-2,0,922,2038,16,19,938,2019,430,44,64,79,0,,0,0.0,0.0,0.0,0.0,0.0
2024,7,30,2,2024-07-30,B6,2883,BWI,DFW,"Baltimore, MD",Maryland,"Dallas/Fort Worth, TX",Texas,1053,1161,-20,-10,1033,1151,16,14,1049,1137,1729,209,229,239,0,,0,0.0,0.0,0.0,0.0,0.0
2024,8,7,3,2024-08-07,UA,9705,TPA,SFO,"Tampa, FL",Florida,"San Francisco, CA",California,1258,1950,-11,-5,1247,1945,5,3,1252,1942,2836,351,371,359,0,,0,0.0,0.0,0.0,0.0,0.0
2024,8,27,2,2024-08-27,B6,2908,PHL,HNL,"Philadelphia, PA",Pennsylvania,"Honolulu, HI",Hawaii,2230,711,-15,-5,2215,706,10,14,2225,692,453,47,67,71,0,,0,0.0,0.0,0.0,0.0,0.0
2024,2,15,4,2024-02-15,WN,3431,PDX,SAN,"Portland, OR",Oregon,"San Diego, CA",California,743,1391,16,10,759,1401,15,14,774,1387,2977,380,400,409,0,,0,0.0,0.0,0.0,0.0,0.0
2024,2,4,7,2024-02-04,DL,2278,SLC,JFK,"Salt Lake City, UT",Utah,"New York, NY",New York,2235,901,-5,5,2230,906,20,19,2250,887,1431,185,205,224,0,,0,0.0,0.0,0.0,0.0,0.0
2024,9,9,1,2024-09-09,OO,897,LAS,IAD,"Las Vegas, NV",Nevada,"Washington, DC",District of Columbia,2156,735,49,45,2205,780,6,7,2211,773,1859,227,247,240,0,,0,6.0,4.0,6.0,1.0,28.0
2024,3,22,5,2024-03-22,WN,2946,BOS,SEA,"Boston, MA",Massachusetts,"Seattle, WA",Washington,1499,932,-6,0,1493,932,7,6,1500,926,2770,355,375,368,0,,0,0.0,0.0,0.0,0.0,0.0
2024,9,12,4,2024-09-12,UA,1029,SLC,BOS,"Salt Lake City, UT",Utah,"Boston, MA",Massachusetts,1857,1626,-2,0,1855,1626,15,7,1870,1619,266,38,58,60,0,,0,0.0,0.0,0.0,0.0,0.0
2024,7,15,1,2024-07-15,MQ,4918,DTW,PHL,"Detroit, MI",Michigan,"Philadelphia, PA",Pennsylvania,827,1785,22,15,849,1800,13,8,862,1792,2059,247,267,268,0,,0,0.0,0.0,0.0,0.0,0.0
2024,10,29,2,2024-10-29,AA,3191,JFK,PHL,"New York, NY",New York,"Philadelphia, PA",Pennsylvania,1214,2135,-10,-5,1204,2130,11,5,1215,2125,1573,194,214,210,0,,0,0.0,0.0,0.0,0.0,0.0
2024,1,10,3,2024-01-10,YX,2362,LAS,TPA,"Las Vegas, NV",Nevada,"Tampa, FL",Florida,1629,676,1,0,1630,676,8,17,1638,659,2298,278,298,303,0,,0,0.0,0.0,0.0,0.0,0.0
2024,11,7,4,2024-11-07,9E,9625,HNL,MCO,"Honolulu, HI",Hawaii,"Orlando, FL",Florida,2285,784,-2,-5,2283,779,14,5,2297,774,2563,324,344,343,0,,0,0.0,0.0,0.0,0.0,0.0
2024,10,12,6,2024-10-12,F9,9566,LGA,ORD,"New York, NY",New York,"Chicago, IL",Illinois,1300,1169,-4,0,1296,1169,5,15,1301,1154,1667,216,236,236,0,,0,0.0,0.0,0.0,0.0,0.0
2024,8,29,4,2024-08-29,HA,7649,PDX,ATL,"Portland, OR",Oregon,"Atlanta, GA",Georgia,1602,2103,-19,-15,1583,2088,17,7,1600,2081,1793,222,242,246,0,,0,0.0,0.0,0.0,0.0,0.0
2024,9,7,6,2024-09-07,B6,3580,CLT,MSP,"Charlotte, NC",North Carolina,"Minneapolis, MN",Minnesota,1688,1786,13,5,1701,1791,8,11,1709,1780,2323,288,308,307,0,,0,0.0,0.0,0.0,0.0,0.0
2024,12,30,1,2024-12-30,WN,3442,TPA,DCA,"Tampa, FL",Florida,"Washington, DC",District of Columbia,1130,1644,25,30,1155,1674,17,17,1172,1657,2941,361,381,395,0,,0,5.0,4.0,3.0,0.0,18.0
2024,1,5,5,2024-01-05,9E,6153,EWR,MSP,"Newark, NJ",New Jersey,"Minneapolis, MN",Minnesota,1580,2200,-23,-15,1557,2185,26,4,1583,2181,1990,241,261,271,0,,0,0.0,0.0,0.0,0.0,0.0
2024,4,28,7,2024-04-28,YX,7674,ORD,STL,"Chicago, IL",Illinois,"St. Louis, MO",Missouri,1459,2201,15,10,1474,2211,28,11,1502,2200,2296,281,301,320,0,,0,0.0,0.0,0.0,0.0,0.0
2024,10,15,2,2024-10-15,B6,7959,SLC,IAH,"Salt Lake City, UT",Utah,"Houston, TX",Texas,1459,1552,-5,-10,1454,1542,15,17,1469,1525,2396,300,320,332,0,,0,0.0,0.0,0.0,0.0,0.0
2024,3,5,2,2024-03-05,WN,9509,TPA,DFW,"Tampa, FL",Florida,"Dallas/Fort Worth, TX",Texas,1711,1921,-3,-10,1708,1911,29,5,1737,1906,946,108,128,142,0,,0,0.0,0.0,0.0,0.0,0.0
2024,5,25,6,2024-05-25,UA,9756,BWI,ORD,"Baltimore, MD",Maryland,"Chicago, IL",Illinois,1575,898,-1,5,1574,903,19,9,1593,894,280,43,63,71,0,,0,0.0,0.0,0.0,0.0,0.0
2024,8,11,7,2024-08-11,B6,4274,PDX,DEN,"Portland, OR",Oregon,"Denver, CO",Colorado,1595,1905,-11,-20,1584,1885,17,10,1601,1875,2558,317,337,344,0,,0,0.0,0.0,0.0,0.0,0.0
2024,8,26,1,2024-08-26,WN,7247,MIA,LGA,"Miami, FL",Florida,"New York, NY",New York,1252,1071,-7,0,1245,1071,8,15,1253,1056,1672,210,230,233,0,,0,0.0,0.0,0.0,0.0,0.0
2024,6,25,2,2024-06-25,HA,4870,LAX,EWR,"Los Angeles, CA",California,"Newark, NJ",New Jersey,823,1009,-15,-20,808,989,10,17,818,972,2223,279,299,306,0,,0,0.0,0.0,0.0,0.0,0.0
2024,9,23,1,2024-09-23,AA,5933,PHX,LGA,"Phoenix, AZ",Arizona,"New York, NY",New York,2135,2015,-7,0,2128,2015,6,8,2134,2007,347,52,72,66,0,,0,0.0,0.0,0.0,0.0,0.0
2024,12,6,5,2024-12-06,YX,8305,DFW,SLC,"Dallas/Fort Worth, TX",Texas,"Salt Lake City, UT",Utah,1861,1286,2,0,1863,1286,6,15,1869,1271,583,78,98,99,0,,0,0.0,0.0,0.0,0.0,0.0
2024,10,8,2,2024-10-08,UA,7102,ATL,MIA,"Atlanta, GA",Georgia,"Miami, FL",Florida,654,764,18,15,672,779,10,9,682,770,1584,190,210,209,1,,0,0.0,0.0,0.0,0.0,0.0
2024,3,3,7,2024-03-03,9E,2393,DFW,SLC,"Dallas/Fort Worth, TX",Texas,"Salt Lake City, UT",Utah,558,1705,11,5,569,1710,29,19,598,1691,2861,359,379,407,0,,0,0.0,0.0,0.0,0.0,0.0
2024,8,4,7,2024-08-04,HA,2145,DFW,MCO,"Dallas/Fort Worth, TX",Texas,"Orlando, FL",Florida,1798,1257,-23,-15,1775,1242,7,17,1782,1225,2469,311,331,335,0,,0,0.0,0.0,0.0,0.0,0.0
2024,12,7,6,2024-12-07,9E,1137,SLC,SAN,"Salt Lake City, UT",Utah,"San Diego, CA",California,2294,2339,-13,-5,2281,2334,24,7,2305,2327,1801,218,238,249,0,,0,0.0,0.0,0.0,0.0,0.0
2024,11,10,7,2024-11-10,F9,6342,DEN,LGA,"Denver, CO",Colorado,"New York, NY",New York,700,763,21,15,721,778,29,12,750,766,773,89,109,130,0,,0,0.0,0.0,0.0,0.0,0.0
2024,10,9,3,2024-10-09,NK,9751,LAS,JFK,"Las Vegas, NV",Nevada,"New York, NY",New York,794,703,7,5,801,708,29,14,830,694,2623,317,337,360,0,,0,0.0,0.0,0.0,0.0,0.0
2024,6,25,2,2024-06-25,DL,8548,STL,LGA,"St. Louis, MO",Missouri,"New York, NY",New York,1845,1753,9,0,1854,1753,15,6,1869,1747,2368,291,311,312,0,,0,0.0,0.0,0.0,0.0,0.0
2024,4,7,7,2024-04-07,AA,6262,BOS,PHX,"Boston, MA",Massachusetts,"Phoenix, AZ",Arizona,1852,1195,-1,0,1851,1195,19,15,1870,1180,1926,240,260,274,0,,0,0.0,0.0,0.0,0.0,0.0
2024,4,14,7,2024-04-14,UA,4173,MIA,BOS,"Miami, FL",Florida,"Boston, MA",Massachusetts,1913,719,-4,-5,1909,714,25,5,1934,709,359,35,55,65,0,,0,0.0,0.0,0.0,0.0,0.0
2024,4,8,1,2024-04-08,B6,1383,JFK,LAX,"New York, NY",New York,"Los Angeles, CA",California,1497,858,-2,0,1495,858,13,8,1508,850,2516,322,342,343,0,,0,0.0,0.0,0.0,0.0,0.0
2024,11,6,3,2024-11-06,9E,6832,SEA,IAH,"Seattle, WA",Washington,"Houston, TX",Texas,1807,1727,-5,5,1802,1732,25,8,1827,1724,2417,309,329,342,0,,0,0.0,0.0,0.0,0.0,0.0
2024,1,6,6,2024-01-06,HA,6045,DEN,MCO,"Denver, CO",Colorado,"Orlando, FL",Florida,1699,963,-22,-15,1677,948,25,6,1702,942,2422,311,331,342,0,,0,0.0,0.0,0.0,0.0,0.0
2024,7,15,1,2024-07-15,OO,3587,IAD,JFK,"Washington, DC",District of Columbia,"New York, NY",New York,1109,2169,28,20,1137,2189,11,6,1148,2183,2466,313,333,330,0,,0,1.0,4.0,0.0,0.0,15.0
2024,12,16,1,2024-12-16,YX,2284,MIA,MCO,"Miami, FL",Florida,"Orlando, FL",Florida,848,968,-15,-10,833,958,19,15,852,943,1667,200,220,234,0,,0,0.0,0.0,0.0,0.0,0.0
2024,5,12,7,2024-05-12,AA,8650,PHX,BOS,"Phoenix, AZ",Arizona,"Boston, MA",Massachusetts,1955,2309,-1,-5,1954,2304,26,12,1980,2292,1668,198,218,236,0,,0,0.0,0.0,0.0,0.0,0.0
2024,12,23,1,2024-12-23,UA,3287,SAN,SFO,"San Diego, CA",California,"San Francisco, CA",California,1462,1557,-13,-20,1449,1537,14,12,1463,1525,2817,343,363,369,1,,0,0.0,0.0,0.0,0.0,0.0
2024,9,15,7,2024-09-15,UA,9517,LGA,PHL,"New York, NY",New York,"Philadelphia, PA",Pennsylvania,2217,1949,-6,0,2211,1949,15,13,2226,1936,955,121,141,149,0,,0,0.0,0.0,0.0,0.0,0.0
2024,1,23,2,2024-01-23,B6,5595,SAN,SFO,"San Diego, CA",California,"San Francisco, CA",California,881,1808,-8,-5,873,1803,27,15,900,1788,2497,315,335,357,0,,0,0.0,0.0,0.0,0.0,0.0
2024,2,22,4,2024-02-22,UA,2397,PDX,DTW,"Portland, OR",Oregon,"Detroit, MI",Michigan,1795,993,-10,-10,1785,983,6,12,1791,971,2627,325,345,343,0,,0,0.0,0.0,0.0,0.0,0.0
2024,6,13,4,2024-06-13,MQ,7197,JFK,ORD,"New York, NY",New York,"Chicago, IL",Illinois,991,1967,24,30,1015,1997,18,13,1033,1984,1908,241,261,272,0,,0,3.0,6.0,3.0,0.0,18.0
2024,7,20,6,2024-07-20,G4,8569,BOS,SFO,"Boston, MA",Massachusetts,"San Francisco, CA",California,2070,1129,-8,-5,2062,1124,20,9,2082,1115,2043,250,270,279,0,,0,0.0,0.0,0.0,0.0,0.0
2024,3,23,6,2024-03-23,AA,3644,DFW,PDX,"Dallas/Fort Worth, TX",Texas,"Portland, OR",Oregon,830,2040,-5,-5,825,2035,13,11,838,2024,1410,177,197,201,0,,0,0.0,0.0,0.0,0.0,0.0
2024,5,24,5,2024-05-24,WN,6931,DTW,DCA,"Detroit, MI",Michigan,"Washington, DC",District of Columbia,1374,1854,9,0,1383,1854,26,15,1409,1839,2034,247,267,288,0,,0,0.0,0.0,0.0,0.0,0.0
2024,3,25,1,2024-03-25,MQ,491,ATL,SLC,"Atlanta, GA",Georgia,"Salt Lake City, UT",Utah,2122,734,-16,-15,2106,719,29,12,2135,707,2787,346,366,387,0,,0,0.0,0.0,0.0,0.0,0.0
2024,3,18,1,2024-03-18,MQ,1068,ORD,EWR,"Chicago, IL",Illinois,"Newark, NJ",New Jersey,657,644,-7,-5,650,639,20,17,670,622,2012,247,267,284,0,,0,0.0,0.0,0.0,0.0,0.0
2024,1,1,1,2024-01-01,9E,5251,HNL,DCA,"Honolulu, HI",Hawaii,"Washington, DC",District of Columbia,931,1223,-14,-5,917,1218,5,7,922,1211,361,35,55,47,0,,0,0.0,0.0,0.0,0.0,0.0
2024,2,20,2,2024-02-20,9E,4464,LGA,SAN,"New York, NY",New York,"San Diego, CA",California,1848,2115,6,0,1854,2115,6,17,1860,2098,2294,279,299,302,0,,0,0.0,0.0,0.0,0.0,0.0
2024,6,21,5,2024-06-21,WN,3407,STL,MSP,"St. Louis, MO",Missouri,"Minneapolis, MN",Minnesota,1639,1524,3,10,1642,1534,11,13,1653,1521,994,119,139,143,0,,0,0.0,0.0,0.0,0.0,0.0
2024,7,23,2,2024-07-23,AA,6225,MCO,DCA,"Orlando, FL",Florida,"Washington, DC",District of Columbia,2043,1194,-9,-10,2034,1184,16,8,2050,1176,716,89,109,113,0,,0,0.0,0.0,0.0,0.0,0.0
2024,9,16,1,2024-09-16,OH,4470,IAH,PHX,"Houston, TX",Texas,"Phoenix, AZ",Arizona,1118,2045,8,0,1126,2045,22,3,1148,2042,2520,312,332,337,0,,0,0.0,0.0,0.0,0.0,0.0
2024,10,14,1,2024-10-14,DL,4938,SEA,LGA,"Seattle, WA",Washington,"New York, NY",New York,1118,2174,-12,-20,1106,2154,10,16,1116,2138,2304,290,310,316,0,,0,0.0,0.0,0.0,0.0,0.0
2024,2,3,6,2024-02-03,OO,8377,TPA,LAS,"Tampa, FL",Florida,"Las Vegas, NV",Nevada,1125,1365,3,-5,1128,1360,6,17,1134,1343,2560,318,338,341,0,,0,0.0,0.0,0.0,0.0,0.0
2024,12,13,5,2024-12-13,AA,3234,TPA,ORD,"Tampa, FL",Florida,"Chicago, IL",Illinois,934,1768,-4,0,930,1768,18,9,948,1759,2807,358,378,385,0,,0,0.0,0.0,0.0,0.0,0.0
2024,4,4,4,2024-04-04,AS,1154,BOS,EWR,"Boston, MA",Massachusetts,"Newark, NJ",New Jersey,2045,1940,-13,-15,2032,1925,20,17,2052,1908,950,125,145,162,0,,0,0.0,0.0,0.0,0.0,0.0
2024,3,12,2,2024-03-12,UA,3829,MDW,DCA,"Chicago, IL",Illinois,"Washington, DC",District of Columbia,1295,2186,-9,0,1286,2186,14,18,1300,2168,2591,331,351,363,0,,0,0.0,0.0,0.0,0.0,0.0
2024,2,8,4,2024-02-08,NK,2769,DCA,IAH,"Washington, DC",District of Columbia,"Houston, TX",Texas,1431,892,-8,-5,1423,887,9,7,1432,880,1095,130,150,146,0,,0,0.0,0.0,0.0,0.0,0.0
2024,6,2,7,2024-06-02,B6,375,LAS,EWR,"Las Vegas, NV",Nevada,"Newark, NJ",New Jersey,1071,2202,40,45,1111,2247,26,8,1137,2239,2649,330,350,364,0,,0,11.0,1.0,8.0,0.0,25.0
2024,9,6,5,2024-09-06,G4,5817,PHL,ATL,"Philadelphia, PA",Pennsylvania,"Atlanta, GA",Georgia,765,1135,0,0,765,1135,20,11,785,1124,1721,219,239,250,0,,0,0.0,0.0,0.0,0.0,0.0
2024,6,10,1,2024-06-10,NK,9397,MSP,MCO,"Minneapolis, MN",Minnesota,"Orlando, FL",Florida,1921,1233,-12,-10,1909,1223,11,5,1920,1218,2230,275,295,291,0,,0,0.0,0.0,0.0,0.0,0.0
2024,4,27,6,2024-04-27,WN,8122,LAS,MCO,"Las Vegas, NV",Nevada,"Orlando, FL",Florida,601,1065,-18,-15,583,1050,19,19,602,1031,2545,326,346,364,0,,0,0.0,0.0,0.0,0.0,0.0
2024,9,15,7,2024-09-15,B6,8100,BWI,MCO,"Baltimore, MD",Maryland,"Orlando, FL",Florida,1586,648,-11,-20,1575,628,17,12,1592,616,1308,160,180,189,0,,0,0.0,0.0,0.0,0.0,0.0
2024,11,1,5,2024-11-01,B6,228,PHL,LAX,"Philadelphia, PA",Pennsylvania,"Los Angeles, CA",California,1496,1260,-6,-15,1490,1245,21,18,1511,1227,1106,142,162,181,0,,0,0.0,0.0,0.0,0.0,0.0
2024,9,24,2,2024-09-24,OO,7177,SEA,SFO,"Seattle, WA",Washington,"San Francisco, CA",California,2210,1058,9,5,2219,1063,22,3,2241,1060,367,53,73,78,0,,0,0.0,0.0,0.0,0.0,0.0
2024,2,23,5,2024-02-23,HA,4426,DTW,SFO,"Detroit, MI",Michigan,"San Francisco, CA",California,1208,1296,10,10,1218,1306,22,6,1240,1300,2243,273,293,301,0,,0,0.0,0.0,0.0,0.0,0.0
2024,8,23,5,2024-08-23,B6,3668,MIA,DEN,"Miami, FL",Florida,"Denver, CO",Colorado,1514,1361,-6,-10,1508,1351,21,3,1529,1348,2412,293,313,317,0,,0,0.0,0.0,0.0,0.0,0.0
2024,8,9,5,2024-08-09,9E,7722,DEN,JFK,"Denver, CO",Colorado,"New York, NY",New York,1323,1024,-11,-5,1312,1019,7,6,1319,1013,687,79,99,92,0,,0,0.0,0.0,0.0,0.0,0.0
2024,9,7,6,2024-09-07,G4,8180,LGA,MCO,"New York, NY",New York,"Orlando, FL",Florida,2034,2280,0,-5,2034,2275,16,13,2050,2262,1810,227,247,256,0,,0,0.0,0.0,0.0,0.0,0.0
2024,11,8,5,2024-11-08,9E,2502,ORD,PHL,"Chicago, IL",Illinois,"Philadelphia, PA",Pennsylvania,721,1354,-9,0,712,1354,10,6,722,1348,739,97,117,113,0,,0,0.0,0.0,0.0,0.0,0.0
2024,4,21,7,2024-04-21,UA,1747,ORD,MSP,"Chicago, IL",Illinois,"Minneapolis, MN",Minnesota,1414,1476,-6,-10,1408,1466,16,6,1424,1460,1893,233,253,255,0,,0,0.0,0.0,0.0,0.0,0.0
2024,9,11,3,2024-09-11,AS,3656,IAD,BWI,"Washington, DC",District of Columbia,"Baltimore, MD",Maryland,935,1260,14,20,949,1280,15,7,964,1273,629,87,107,109,0,,0,4.0,3.0,2.0,0.0,11.0
2024,10,29,2,2024-10-29,F9,2293,DTW,DEN,"Detroit, MI",Michigan,"Denver, CO",Colorado,1713,667,9,5,1722,672,13,15,1735,657,1045,137,157,165,0,,0,0.0,0.0,0.0,0.0,0.0
2024,7,25,4,2024-07-25,OO,3204,IAD,ORD,"Washington, DC",District of Columbia,"Chicago, IL",Illinois,1139,1108,20,20,1159,1128,23,6,1182,1122,2076,260,280,289,0,,0,4.0,0.0,3.0,0.0,13.0
2024,8,16,5,2024-08-16,G4,4455,MCO,STL,"Orlando, FL",Florida,"St. Louis, MO",Missouri,1444,1335,-15,-10,1429,1325,23,12,1452,1313,2983,366,386,401,0,,0,0.0,0.0,0.0,0.0,0.0
2024,12,6,5,2024-12-06,MQ,2234,SLC,PDX,"Salt Lake City, UT",Utah,"Portland, OR",Oregon,833,809,-5,0,828,809,6,5,834,804,1065,130,150,141,0,,0,0.0,0.0,0.0,0.0,0.0
2024,3,6,3,2024-03-06,HA,9134,ATL,SFO,"Atlanta, GA",Georgia,"San Francisco, CA",California,1406,1303,-1,5,1405,1308,17,7,1422,1301,975,118,138,142,0,,0,0.0,0.0,0.0,0.0,0.0
2024,3,15,5,2024-03-15,NK,4003,CLT,DEN,"Charlotte, NC",North Carolina,"Denver, CO",Colorado,2081,1923,-5,5,2076,1928,22,13,2098,1915,754,84,104,119,0,,0,0.0,0.0,0.0,0.0,0.0
2024,4,12,5,2024-04-12,YX,3713,PDX,JFK,"Portland, OR",Oregon,"New York, NY",New York,2104,723,-11,-20,2093,703,27,4,2120,699,1025,125,145,156,0,,0,0.0,0.0,0.0,0.0,0.0
2024,7,10,3,2024-07-10,UA,8683,DCA,MDW,"Washington, DC",District of Columbia,"Chicago, IL",Illinois,1824,1395,86,90,1910,1485,8,13,1918,1472,1756,227,247,248,0,,0,1.0,7.0,0.0,3.0,79.0
2024,9,8,7,2024-09-08,AA,2379,BOS,DTW,"Boston, MA",Massachusetts,"Detroit, MI",Michigan,850,891,20,15,870,906,26,14,896,892,2678,341,361,381,1,,0,0.0,0.0,0.0,0.0,0.0
2024,8,13,2,2024-08-13,WN,9192,PHL,IAD,"Philadelphia, PA",Pennsylvania,"Washington, DC",District of Columbia,1069,1020,-9,-15,1060,1005,28,18,1088,987,2554,328,348,374,0,,0,0.0,0.0,0.0,0.0,0.0
2024,10,20,7,2024-10-20,MQ,1252,BOS,PDX,"Boston, MA",Massachusetts,"Portland, OR",Oregon,1227,1411,4,0,1231,1411,18,4,1249,1407,2660,331,351,353,0,,0,0.0,0.0,0.0,0.0,0.0
2024,11,1,5,2024-11-01,AS,1394,MDW,CLT,"Chicago, IL",Illinois,"Charlotte, NC",North Carolina,614,649,4,-5,618,644,18,18,636,626,2263,279,299,315,0,,0,0.0,0.0,0.0,0.0,0.0
2024,4,7,7,2024-04-07,UA,8757,DCA,ORD,"Washington, DC",District of Columbia,"Chicago, IL",Illinois,2045,782,9,10,2054,792,9,18,2063,774,1547,195,215,222,0,,0,0.0,0.0,0.0,0.0,0.0
2024,12,3,2,2024-12-03,OH,5389,PHL,SFO,"Philadelphia, PA",Pennsylvania,"San Francisco, CA",California,1408,846,2,5,1410,851,23,6,1433,845,1203,144,164,173,0,,0,0.0,0.0,0.0,0.0,0.0
2024,10,12,6,2024-10-12,AA,3345,STL,ORD,"St. Louis, MO",Missouri,"Chicago, IL",Illinois,866,1711,-12,-10,854,1701,6,10,860,1691,1568,196,216,212,0,,0,0.0,0.0,0.0,0.0,0.0
2024,11,30,6,2024-11-30,AS,6168,ORD,LGA,"Chicago, IL",Illinois,"New York, NY",New York,1792,1249,-12,-20,1780,1229,20,6,1800,1223,1804,222,242,248,0,,0,0.0,0.0,0.0,0.0,0.0
2024,12,12,4,2024-12-12,OH,6816,SFO,ATL,"San Francisco, CA",California,"Atlanta, GA",Georgia,1303,1149,-11,-10,1292,1139,10,13,1302,1126,346,51,71,74,0,,0,0.0,0.0,0.0,0.0,0.0
2024,11,3,7,2024-11-03,AA,6754,DEN,SFO,"Denver, CO",Colorado,"San Francisco, CA",California,1609,1160,-11,-20,1598,1140,15,10,1613,1130,878,117,137,142,0,,0,0.0,0.0,0.0,0.0,0.0
2024,9,5,4,2024-09-05,G4,8779,JFK,PHX,"New York, NY",New York,"Phoenix, AZ",Arizona,1395,671,-23,-15,1372,656,16,14,1388,642,741,90,110,120,0,,0,0.0,0.0,0.0,0.0,0.0
2024,6,14,5,2024-06-14,OO,3038,MCO,DCA,"Orlando, FL",Florida,"Washington, DC",District of Columbia,1468,1369,0,0,1468,1369,28,6,1496,1363,1251,161,181,195,0,,0,0.0,0.0,0.0,0.0,0.0
2024,11,30,6,2024-11-30,OH,2726,ORD,JFK,"Chicago, IL",Illinois,"New York, NY",New York,877,1155,5,5,882,1160,17,9,899,1151,1974,247,267,273,0,,0,0.0,0.0,0.0,0.0,0.0
2024,1,30,2,2024-01-30,YX,1049,ORD,PDX,"Chicago, IL",Illinois,"Portland, OR",Oregon,1670,1914,-3,0,1667,1914,14,15,1681,1899,266,26,46,55,0,,0,0.0,0.0,0.0,0.0,0.0
2024,9,3,2,2024-09-03,AA,9341,JFK,DTW,"New York, NY",New York,"Detroit, MI",Michigan,1511,1103,-1,0,1510,1103,18,13,1528,1090,769,89,109,120,0,,0,0.0,0.0,0.0,0.0,0.0
2024,4,15,1,2024-04-15,MQ,4175,DTW,DCA,"Detroit, MI",Michigan,"Washington, DC",District of Columbia,617,1227,-12,-10,605,1217,8,12,613,1205,1194,150,170,170,0,,0,0.0,0.0,0.0,0.0,0.0
2024,2,20,2,2024-02-20,AS,9682,MCO,SEA,"Orlando, FL",Florida,"Seattle, WA",Washington,1513,1260,-6,-5,1507,1255,6,11,1513,1244,708,91,111,108,0,,0,0.0,0.0,0.0,0.0,0.0
2024,3,21,4,2024-03-21,AA,9375,IAH,PHX,"Houston, TX",Texas,"Phoenix, AZ",Arizona,1658,1936,4,5,1662,1941,23,8,1685,1933,1658,212,232,243,0,,0,0.0,0.0,0.0,0.0,0.0
2024,5,12,7,2024-05-12,YX,1758,ORD,PHL,"Chicago, IL",Illinois,"Philadelphia, PA",Pennsylvania,1026,1911,2,-5,1028,1906,23,19,1051,1887,200,26,46,68,0,,0,0.0,0.0,0.0,0.0,0.0
2024,10,11,5,2024-10-11,NK,7032,ORD,DEN,"Chicago, IL",Illinois,"Denver, CO",Colorado,1313,2353,-11,-5,1302,2348,19,15,1321,2333,1815,230,250,264,0,,0,0.0,0.0,0.0,0.0,0.0
2024,5,17,5,2024-05-17,UA,8153,LAX,BOS,"Los Angeles, CA",California,"Boston, MA",Massachusetts,705,1107,-16,-10,689,1097,13,8,702,1089,1439,169,189,190,0,,0,0.0,0.0,0.0,0.0,0.0
2024,7,2,2,2024-07-02,AS,7059,SEA,SAN,"Seattle, WA",Washington,"San Diego, CA",California,1756,1694,-4,0,1752,1694,8,19,1760,1675,2763,342,362,369,0,,0,0.0,0.0,0.0,0.0,0.0
2024,11,25,1,2024-11-25,NK,1917,STL,PHX,"St. Louis, MO",Missouri,"Phoenix, AZ",Arizona,1315,760,19,10,1334,770,26,15,1360,755,569,63,83,104,0,,0,0.0,0.0,0.0,0.0,0.0
2024,9,29,7,2024-09-29,AA,8482,HNL,DTW,"Honolulu, HI",Hawaii,"Detroit, MI",Michigan,565,726,9,0,574,726,17,17,591,709,1760,221,241,255,0,,0,0.0,0.0,0.0,0.0,0.0
2024,12,5,4,2024-12-05,AA,560,PDX,DFW,"Portland, OR",Oregon,"Dallas/Fort Worth, TX",Texas,503,2079,-18,-15,485,2064,13,18,498,2046,592,69,89,100,0,,0,0.0,0.0,0.0,0.0,0.0
2024,3,9,6,2024-03-09,MQ,8071,MSP,JFK,"Minneapolis, MN",Minnesota,"New York, NY",New York,502,2305,16,10,518,2315,16,9,534,2306,2002,248,268,273,0,,0,0.0,0.0,0.0,0.0,0.0
2024,2,3,6,2024-02-03,B6,6115,SFO,BWI,"San Francisco, CA",California,"Baltimore, MD",Maryland,1782,2152,-20,-15,1762,2137,18,15,1780,2122,398,58,78,91,0,,0,0.0,0.0,0.0,0.0,0.0
2024,9,18,3,2024-09-18,AS,6476,BWI,JFK,"Baltimore, MD",Maryland,"New York, NY",New York,2238,1927,2,0,2240,1927,28,8,2268,1919,1276,168,188,204,0,,0,0.0,0.0,0.0,0.0,0.0
2024,2,22,4,2024-02-22,HA,2621,ORD,PHX,"Chicago, IL",Illinois,"Phoenix, AZ",Arizona,824,1089,-8,-10,816,1079,16,10,832,1069,750,88,108,114,0,,0,0.0,0.0,0.0,0.0,0.0
2024,7,23,2,2024-07-23,HA,3576,IAD,BOS,"Washington, DC",District of Columbia,"Boston, MA",Massachusetts,1763,838,17,15,1780,853,29,12,1809,841,842,109,129,150,0,,0,0.0,0.0,0.0,0.0,0.0
2024,5,5,7,2024-05-05,G4,2805,IAH,DFW,"Houston, TX",Texas,"Dallas/Fort Worth, TX",Texas,1104,775,10,5,1114,780,26,12,1140,768,2958,362,382,400,0,,0,0.0,0.0,0.0,0.0,0.0
2024,8,22,4,2024-08-22,OH,4466,STL,DCA,"St. Louis, MO",Missouri,"Washington, DC",District of Columbia,1295,809,-9,0,1286,809,17,3,1303,806,1738,211,231,231,0,,0,0.0,0.0,0.0,0.0,0.0
2024,2,12,1,2024-02-12,AA,9449,DEN,MCO,"Denver, CO",Colorado,"Orlando, FL",Florida,1034,2192,-1,5,1033,2197,22,14,1055,2183,714,95,115,131,0,,0,0.0,0.0,0.0,0.0,0.0
2024,8,27,2,2024-08-27,MQ,127,HNL,LAS,"Honolulu, HI",Hawaii,"Las Vegas, NV",Nevada,1841,958,-1,0,1840,958,9,10,1849,948,1686,208,228,227,0,,0,0.0,0.0,0.0,0.0,0.0
2024,4,20,6,2024-04-20,WN,4331,BWI,JFK,"Baltimore, MD",Maryland,"New York, NY",New York,1098,1812,-16,-15,1082,1797,23,10,1105,1787,332,41,61,74,0,,0,0.0,0.0,0.0,0.0,0.0
2024,9,5,4,2024-09-05,9E,6648,MCO,MIA,"Orlando, FL",Florida,"Miami, FL",Florida,1574,2132,5,5,1579,2137,7,9,1586,2128,1264,154,174,170,0,,0,0.0,0.0,0.0,0.0,0.0
2024,5,30,4,2024-05-30,F9,3124,BWI,TPA,"Baltimore, MD",Maryland,"Tampa, FL",Florida,1993,2179,9,0,2002,2179,21,9,2023,2170,1592,194,214,224,0,,0,0.0,0.0,0.0,0.0,0.0
2024,7,1,1,2024-07-01,9E,1364,SAN,DCA,"San Diego, CA",California,"Washington, DC",District of Columbia,1331,1233,-2,0,1329,1233,24,17,1353,1216,2821,352,372,393,0,,0,0.0,0.0,0.0,0.0,0.0
2024,12,1,7,2024-12-01,G4,9147,TPA,CLT,"Tampa, FL",Florida,"Charlotte, NC",North Carolina,1566,1656,-18,-20,1548,1636,11,14,1559,1622,1700,215,235,240,0,,0,0.0,0.0,0.0,0.0,0.0
2024,4,4,4,2024-04-04,HA,6687,MDW,LGA,"Chicago, IL",Illinois,"New York, NY",New York,1727,1100,-13,-15,1714,1085,7,18,1721,1067,1562,195,215,220,0,,0,0.0,0.0,0.0,0.0,0.0
2024,1,8,1,2024-01-08,MQ,6677,LGA,IAD,"New York, NY",New York,"Washington, DC",District of Columbia,846,911,-9,0,837,911,11,18,848,893,2629,336,356,365,0,,0,0.0,0.0,0.0,0.0,0.0
2024,12,25,3,2024-12-25,UA,1351,ORD,ATL,"Chicago, IL",Illinois,"Atlanta, GA",Georgia,1581,2163,-6,0,1575,2163,10,4,1585,2159,2655,333,353,347,0,,0,0.0,0.0,0.0,0.0,0.0
2024,7,2,2,2024-07-02,OO,3970,MSP,ORD,"Minneapolis, MN",Minnesota,"Chicago, IL",Illinois,558,1774,-16,-10,542,1764,18,16,560,1748,2206,272,292,306,0,,0,0.0,0.0,0.0,0.0,0.0
2024,10,7,1,2024-10-07,DL,1426,MIA,STL,"Miami, FL",Florida,"St. Louis, MO",Missouri,1179,2198,-9,-10,1170,2188,5,18,1175,2170,739,100,120,123,0,,0,0.0,0.0,0.0,0.0,0.0
2024,7,13,6,2024-07-13,WN,6277,IAH,TPA,"Houston, TX",Texas,"Tampa, FL",Florida,2209,2142,9,0,2218,2142,18,16,2236,2126,2584,326,346,360,0,,0,0.0,0.0,0.0,0.0,0.0
2024,12,17,2,2024-12-17,DL,9317,SEA,ATL,"Seattle, WA",Washington,"Atlanta, GA",Georgia,1010,710,-18,-15,992,695,25,8,1017,687,208,20,40,53,0,,0,0.0,0.0,0.0,0.0,0.0
2024,7,13,6,2024-07-13,AA,461,DFW,CLT,"Dallas/Fort Worth, TX",Texas,"Charlotte, NC",North Carolina,1841,2265,-10,-5,1831,2260,26,12,1857,2248,2246,280,300,318,0,,0,0.0,0.0,0.0,0.0,0.0
2024,6,3,1,2024-06-03,YX,1318,EWR,HNL,"Newark, NJ",New Jersey,"Honolulu, HI",Hawaii,1956,1755,7,0,1963,1755,15,17,1978,1738,2684,326,346,358,0,,0,0.0,0.0,0.0,0.0,0.0
2024,4,2,2,2024-04-02,UA,705,ORD,HNL,"Chicago, IL",Illinois,"Honolulu, HI",Hawaii,1895,1119,-8,-5,1887,1114,13,11,1900,1103,2904,367,387,391,0,,0,0.0,0.0,0.0,0.0,0.0
2024,6,8,6,2024-06-08,NK,6059,EWR,MSP,"Newark, NJ",New Jersey,"Minneapolis, MN",Minnesota,706,1928,19,10,725,1938,14,18,739,1920,2128,271,291,303,0,,0,0.0,0.0,0.0,0.0,0.0
2024,3,1,5,2024-03-01,MQ,1770,TPA,JFK,"Tampa, FL",Florida,"New York, NY",New York,610,1652,-24,-15,586,1637,26,18,612,1619,1967,235,255,279,0,,0,0.0,0.0,0.0,0.0,0.0
2024,5,1,3,2024-05-01,MQ,4543,IAH,LGA,"Houston, TX",Texas,"New York, NY",New York,522,1449,9,10,531,1459,15,4,546,1455,1677,201,221,220,0,,0,0.0,0.0,0.0,0.0,0.0
2024,2,20,2,2024-02-20,AA,1377,BOS,DCA,"Boston, MA",Massachusetts,"Washington, DC",District of Columbia,1951,1532,14,5,1965,1537,28,17,1993,1520,2518,313,333,358,0,,0,0.0,0.0,0.0,0.0,0.0
2024,10,3,4,2024-10-03,DL,498,IAD,LAS,"Washington, DC",District of Columbia,"Las Vegas, NV",Nevada,2268,1974,-10,-5,2258,1969,22,13,2280,1956,822,95,115,130,0,,0,0.0,0.0,0.0,0.0,0.0
2024,1,5,5,2024-01-05,AA,2272,PHL,SFO,"Philadelphia, PA",Pennsylvania,"San Francisco, CA",California,1286,2141,9,15,1295,2156,21,10,1316,2146,2509,318,338,349,0,,0,0.0,0.0,0.0,0.0,0.0
2024,4,1,1,2024-04-01,F9,2910,MCO,HNL,"Orlando, FL",Florida,"Honolulu, HI",Hawaii,2207,2115,10,5,2217,2120,18,12,2235,2108,572,69,89,99,0,,0,0.0,0.0,0.0,0.0,0.0
2024,6,18,2,2024-06-18,B6,6374,MIA,LGA,"Miami, FL",Florida,"New York, NY",New York,1534,1007,7,15,1541,1022,21,8,1562,1014,694,79,99,108,0,,0,0.0,0.0,0.0,0.0,0.0
2024,11,12,2,2024-11-12,F9,5781,SLC,BWI,"Salt Lake City, UT",Utah,"Baltimore, MD",Maryland,1071,2131,-7,0,1064,2131,11,5,1075,2126,1113,147,167,163,0,,0,0.0,0.0,0.0,0.0,0.0
2024,1,22,1,2024-01-22,UA,3039,PHL,LGA,"Philadelphia, PA",Pennsylvania,"New York, NY",New York,2267,1223,-10,0,2257,1223,12,10,2269,1213,1709,221,241,243,0,,0,0.0,0.0,0.0,0.0,0.0
2024,11,21,4,2024-11-21,MQ,9113,PDX,HNL,"Portland, OR",Oregon,"Honolulu, HI",Hawaii,1246,1728,3,0,1249,1728,12,11,1261,1717,2873,358,378,381,0,,0,0.0,0.0,0.0,0.0,0.0
2024,1,1,1,2024-01-01,YX,1044,DFW,PHX,"Dallas/Fort Worth, TX",Texas,"Phoenix, AZ",Arizona,1014,1318,-12,-15,1002,1303,23,7,1025,1296,313,38,58,68,0,,0,0.0,0.0,0.0,0.0,0.0
2024,5,12,7,2024-05-12,NK,6065,LAS,CLT,"Las Vegas, NV",Nevada,"Charlotte, NC",North Carolina,643,1151,23,15,666,1166,9,7,675,1159,1445,183,203,199,0,,0,0.0,0.0,0.0,0.0,0.0
2024,8,20,2,2024-08-20,F9,6448,SFO,LGA,"San Francisco, CA",California,"New York, NY",New York,1491,1379,0,5,1491,1384,11,17,1502,1367,922,105,125,133,0,,0,0.0,0.0,0.0,0.0,0.0
2024,1,12,5,2024-01-12,HA,7870,BOS,EWR,"Boston, MA",Massachusetts,"Newark, NJ",New Jersey,2265,919,1,0,2266,919,17,4,2283,915,2817,357,377,378,0,,0,0.0,0.0,0.0,0.0,0.0
2024,12,11,3,2024-12-11,AS,7199,MCO,LAX,"Orlando, FL",Florida,"Los Angeles, CA",California,2044,1669,22,15,2066,1684,19,15,2085,1669,2595,333,353,367,0,,0,0.0,0.0,0.0,0.0,0.0
2024,2,15,4,2024-02-15,MQ,1296,BWI,MDW,"Baltimore, MD",Maryland,"Chicago, IL",Illinois,1308,1864,43,45,1351,1909,18,14,1369,1895,222,21,41,53,0,,0,15.0,6.0,6.0,0.0,18.0
2024,2,3,6,2024-02-03,MQ,1312,MIA,DCA,"Miami, FL",Florida,"Washington, DC",District of Columbia,793,1893,-1,-10,792,1883,29,5,821,1878,671,86,106,120,0,,0,0.0,0.0,0.0,0.0,0.0
2024,3,18,1,2024-03-18,NK,923,LAS,PHL,"Las Vegas, NV",Nevada,"Philadelphia, PA",Pennsylvania,824,1266,7,5,831,1271,25,7,856,1264,2274,291,311,323,0,,0,0.0,0.0,0.0,0.0,0.0
2024,8,5,1,2024-08-05,OH,7184,SEA,MSP,"Seattle, WA",Washington,"Minneapolis, MN",Minnesota,692,1227,8,0,700,1227,19,13,719,1214,1729,213,233,245,0,,0,0.0,0.0,0.0,0.0,0.0
2024,10,27,7,2024-10-27,YX,635,LGA,TPA,"New York, NY",New York,"Tampa, FL",Florida,1814,1660,2,0,1816,1660,18,18,1834,1642,2068,257,277,293,0,,0,0.0,0.0,0.0,0.0,0.0
2024,3,13,3,2024-03-13,DL,3110,TPA,IAD,"Tampa, FL",Florida,"Washington, DC",District of Columbia,2162,1828,28,20,2190,1848,17,11,2207,1837,786,90,110,118,0,,0,6.0,2.0,2.0,0.0,10.0
2024,10,8,2,2024-10-08,F9,7637,JFK,BWI,"New York, NY",New York,"Baltimore, MD",Maryland,1942,2109,18,10,1960,2119,24,11,1984,2108,2661,329,349,364,0,,0,0.0,0.0,0.0,0.0,0.0
2024,9,5,4,2024-09-05,B6,1049,EWR,PHL,"Newark, NJ",New Jersey,"Philadelphia, PA",Pennsylvania,959,1733,4,5,963,1738,8,14,971,1724,589,77,97,99,1,,0,0.0,0.0,0.0,0.0,0.0
2024,2,16,5,2024-02-16,NK,643,MIA,SEA,"Miami, FL",Florida,"Seattle, WA",Washington,1571,2109,-10,-5,1561,2104,26,13,1587,2091,2238,282,302,321,0,,0,0.0,0.0,0.0,0.0,0.0
2024,4,30,2,2024-04-30,AA,4000,ATL,CLT,"Atlanta, GA",Georgia,"Charlotte, NC",North Carolina,1630,1941,-3,5,1627,1946,13,3,1640,1943,230,20,40,36,0,,0,0.0,0.0,0.0,0.0,0.0
2024,8,1,4,2024-08-01,B6,4324,PHX,SLC,"Phoenix, AZ",Arizona,"Salt Lake City, UT",Utah,1787,2215,5,0,1792,2215,18,8,1810,2207,978,126,146,152,0,,0,0.0,0.0,0.0,0.0,0.0
2024,8,26,1,2024-08-26,AA,2966,PHL,DCA,"Philadelphia, PA",Pennsylvania,"Washington, DC",District of Columbia,1776,675,-12,-10,1764,665,21,15,1785,650,1174,136,156,172,0,,0,0.0,0.0,0.0,0.0,0.0
2024,2,25,7,2024-02-25,YX,2346,ORD,STL,"Chicago, IL",Illinois,"St. Louis, MO",Missouri,2062,1209,6,0,2068,1209,5,4,2073,1205,1079,130,150,139,0,,0,0.0,0.0,0.0,0.0,0.0
2024,12,15,7,2024-12-15,MQ,1936,EWR,DTW,"Newark, NJ",New Jersey,"Detroit, MI",Michigan,2044,2121,-12,-10,2032,2111,5,18,2037,2093,991,126,146,149,0,,0,0.0,0.0,0.0,0.0,0.0
2024,4,16,2,2024-04-16,F9,8368,EWR,MIA,"Newark, NJ",New Jersey,"Miami, FL",Florida,2255,1078,-6,0,2249,1078,8,12,2257,1066,1292,154,174,174,0,,0,0.0,0.0,0.0,0.0,0.0
2024,11,14,4,2024-11-14,HA,8660,LGA,ORD,"New York, NY",New York,"Chicago, IL",Illinois,1681,2012,13,5,1694,2017,24,19,1718,1998,2870,361,381,404,0,,0,0.0,0.0,0.0,0.0,0.0
2024,2,17,6,2024-02-17,WN,7076,MCO,SAN,"Orlando, FL",Florida,"San Diego, CA",California,1025,1187,-16,-20,1009,1167,12,18,1021,1149,2341,290,310,320,0,,0,0.0,0.0,0.0,0.0,0.0
2024,3,1,5,2024-03-01,WN,448,LGA,IAH,"New York, NY",New York,"Houston, TX",Texas,1418,1192,4,5,1422,1197,9,19,1431,1178,1219,151,171,179,0,,0,0.0,0.0,0.0,0.0,0.0
2024,12,2,1,2024-12-02,DL,4701,DCA,IAD,"Washington, DC",District of Columbia,"Washington, DC",District of Columbia,528,963,-27,-20,501,943,18,17,519,926,2033,253,273,288,0,,0,0.0,0.0,0.0,0.0,0.0
2024,1,26,5,2024-01-26,B6,4433,ATL,SAN,"Atlanta, GA",Georgia,"San Diego, CA",California,1037,908,1,0,1038,908,24,5,1062,903,449,52,72,81,0,,0,0.0,0.0,0.0,0.0,0.0
2024,10,18,5,2024-10-18,AA,5499,DCA,PHL,"Washington, DC",District of Columbia,"Philadelphia, PA",Pennsylvania,2249,1686,3,0,2252,1686,28,5,2280,1681,1851,235,255,268,0,,0,0.0,0.0,0.0,0.0,0.0
2024,9,13,5,2024-09-13,G4,5796,MDW,LAX,"Chicago, IL",Illinois,"Los Angeles, CA",California,642,866,9,5,651,871,27,11,678,860,227,21,41,59,0,,0,0.0,0.0,0.0,0.0,0.0
2024,1,8,1,2024-01-08,B6,1555,PDX,MIA,"Portland, OR",Oregon,"Miami, FL",Florida,1126,632,13,5,1139,637,18,7,1157,630,656,89,109,114,0,,0,0.0,0.0,0.0,0.0,0.0
2024,4,22,1,2024-04-22,AS,2285,TPA,MIA,"Tampa, FL",Florida,"Miami, FL",Florida,1340,639,-11,-5,1329,634,26,19,1355,615,1672,214,234,259,0,,0,0.0,0.0,0.0,0.0,0.0
2024,12,20,5,2024-12-20,DL,7536,IAH,CLT,"Houston, TX",Texas,"Charlotte, NC",North Carolina,717,1285,-14,-15,703,1270,6,18,709,1252,261,40,60,64,0,,0,0.0,0.0,0.0,0.0,0.0
2024,9,9,1,2024-09-09,9E,3911,DCA,MIA,"Washington, DC",District of Columbia,"Miami, FL",Florida,1092,859,-3,5,1089,864,25,11,1114,853,1149,140,160,176,0,,0,0.0,0.0,0.0,0.0,0.0
2024,6,28,5,2024-06-28,9E,7409,SAN,LAX,"San Diego, CA",California,"Los Angeles, CA",California,1212,1335,4,0,1216,1335,16,17,1232,1318,2275,289,309,322,0,,0,0.0,0.0,0.0,0.0,0.0
2024,7,25,4,2024-07-25,AA,8186,SFO,MCO,"San Francisco, CA",California,"Orlando, FL",Florida,566,2358,-1,-5,565,2353,22,11,587,2342,2535,311,331,344,0,,0,0.0,0.0,0.0,0.0,0.0
2024,10,29,2,2024-10-29,WN,3782,IAD,ATL,"Washington, DC",District of Columbia,"Atlanta, GA",Georgia,1260,866,-9,-10,1251,856,10,15,1261,841,1409,184,204,209,0,,0,0.0,0.0,0.0,0.0,0.0
2024,5,6,1,2024-05-06,NK,1946,MSP,TPA,"Minneapolis, MN",Minnesota,"Tampa, FL",Florida,643,1266,-11,-15,632,1251,13,3,645,1248,781,96,116,112,0,,0,0.0,0.0,0.0,0.0,0.0
2024,2,25,7,2024-02-25,AS,1954,STL,CLT,"St. Louis, MO",Missouri,"Charlotte, NC",North Carolina,1664,2284,-15,-10,1649,2274,13,18,1662,2256,2061,259,279,290,0,,0,0.0,0.0,0.0,0.0,0.0
2024,8,1,4,2024-08-01,9E,3085,DEN,PDX,"Denver, CO",Colorado,"Portland, OR",Oregon,1869,1848,6,0,1875,1848,26,11,1901,1837,2115,269,289,306,0,,0,0.0,0.0,0.0,0.0,0.0
2024,1,14,7,2024-01-14,AA,2994,JFK,IAH,"New York, NY",New York,"Houston, TX",Texas,964,2006,4,0,968,2006,8,15,976,1991,2695,327,347,350,0,,0,0.0,0.0,0.0,0.0,0.0
2024,1,28,7,2024-01-28,AA,7596,SFO,BWI,"San Francisco, CA",California,"Baltimore, MD",Maryland,595,2121,4,0,599,2121,14,16,613,2105,669,80,100,110,0,,0,0.0,0.0,0.0,0.0,0.0
2024,3,18,1,2024-03-18,F9,658,HNL,MSP,"Honolulu, HI",Hawaii,"Minneapolis, MN",Minnesota,907,1238,-5,-5,902,1233,16,13,918,1220,1242,153,173,182,0,,0,0.0,0.0,0.0,0.0,0.0
2024,8,3,6,2024-08-03,WN,2996,TPA,EWR,"Tampa, FL",Florida,"Newark, NJ",New Jersey,1641,1628,16,15,1657,1643,29,3,1686,1640,2255,277,297,309,0,,0,0.0,0.0,0.0,0.0,0.0
2024,12,30,1,2024-12-30,B6,1354,MCO,MDW,"Orlando, FL",Florida,"Chicago, IL",Illinois,2220,1620,8,0,2228,1620,25,16,2253,1604,1691,205,225,246,0,,0,0.0,0.0,0.0,0.0,0.0
2024,6,2,7,2024-06-02,MQ,1781,BOS,LAX,"Boston, MA",Massachusetts,"Los Angeles, CA",California,1303,1045,-15,-5,1288,1040,12,3,1300,1037,2502,309,329,324,0,,0,0.0,0.0,0.0,0.0,0.0
2024,1,14,7,2024-01-14,NK,5371,DFW,LGA,"Dallas/Fort Worth, TX",Texas,"New York, NY",New York,1967,887,-15,-20,1952,867,29,3,1981,864,2567,312,332,344,0,,0,0.0,0.0,0.0,0.0,0.0
2024,7,5,5,2024-07-05,F9,6383,HNL,MCO,"Honolulu, HI",Hawaii,"Orlando, FL",Florida,1256,1681,0,0,1256,1681,25,19,1281,1662,1951,245,265,289,0,,0,0.0,0.0,0.0,0.0,0.0
2024,11,7,4,2024-11-07,HA,8954,TPA,DEN,"Tampa, FL",Florida,"Denver, CO",Colorado,1903,1695,-10,0,1893,1695,26,4,1919,1691,2452,315,335,345,0,,0,0.0,0.0,0.0,0.0,0.0
2024,1,7,7,2024-01-07,9E,3425,DEN,BOS,"Denver, CO",Colorado,"Boston, MA",Massachusetts,1212,2290,-7,0,1205,2290,24,18,1229,2272,1861,240,260,282,0,,0,0.0,0.0,0.0,0.0,0.0
2024,1,3,3,2024-01-03,NK,1341,DCA,LAS,"Washington, DC",District of Columbia,"Las Vegas, NV",Nevada,777,1393,5,10,782,1403,20,7,802,1396,752,95,115,122,0,,0,0.0,0.0,0.0,0.0,0.0
2024,4,20,6,2024-04-20,DL,3243,JFK,SEA,"New York, NY",New York,"Seattle, WA",Washington,860,2303,-2,5,858,2308,16,7,874,2301,2108,271,291,294,0,,0,0.0,0.0,0.0,0.0,0.0
2024,8,25,7,2024-08-25,OH,3137,SFO,MDW,"San Francisco, CA",California,"Chicago, IL",Illinois,1893,2164,1,10,1894,2174,21,9,1915,2165,1402,172,192,202,0,,0,0.0,0.0,0.0,0.0,0.0
2024,12,28,6,2024-12-28,HA,8453,BOS,LAS,"Boston, MA",Massachusetts,"Las Vegas, NV",Nevada,2145,1705,-9,-15,2136,1690,21,6,2157,1684,1742,225,245,252,1,,0,0.0,0.0,0.0,0.0,0.0
2024,8,26,1,2024-08-26,WN,1881,IAH,SEA,"Houston, TX",Texas,"Seattle, WA",Washington,711,1374,-15,-5,696,1369,25,3,721,1366,2756,339,359,367,0,,0,0.0,0.0,0.0,0.0,0.0
2024,9,30,1,2024-09-30,9E,4775,PDX,SLC,"Portland, OR",Oregon,"Salt Lake City, UT",Utah,1782,2241,-3,-5,1779,2236,23,12,1802,2224,2427,299,319,334,0,,0,0.0,0.0,0.0,0.0,0.0
2024,10,20,7,2024-10-20,YX,1577,CLT,MSP,"Charlotte, NC",North Carolina,"Minneapolis, MN",Minnesota,2199,876,6,5,2205,881,11,9,2216,872,271,39,59,59,0,,0,0.0,0.0,0.0,0.0,0.0
2024,8,14,3,2024-08-14,AA,7248,IAD,STL,"Washington, DC",District of Columbia,"St. Louis, MO",Missouri,1620,1562,-14,-5,1606,1557,24,13,1630,1544,930,120,140,157,0,,0,0.0,0.0,0.0,0.0,0.0
2024,1,15,1,2024-01-15,9E,7651,SEA,LAS,"Seattle, WA",Washington,"Las Vegas, NV",Nevada,1733,2145,13,5,1746,2150,8,3,1754,2147,946,121,141,132,0,,0,0.0,0.0,0.0,0.0,0.0
2024,7,10,3,2024-07-10,G4,206,PHL,BWI,"Philadelphia, PA",Pennsylvania,"Baltimore, MD",Maryland,2071,2197,-4,-5,2067,2192,24,8,2091,2184,1482,189,209,221,0,,0,0.0,0.0,0.0,0.0,0.0
2024,4,28,7,2024-04-28,UA,2768,MCO,TPA,"Orlando, FL",Florida,"Tampa, FL",Florida,1277,1335,-17,-10,1260,1325,26,7,1286,1318,344,40,60,73,0,,0,0.0,0.0,0.0,0.0,0.0
2024,1,28,7,2024-01-28,YX,5035,IAH,JFK,"Houston, TX",Texas,"New York, NY",New York,2135,1759,-3,-10,2132,1749,13,15,2145,1734,1996,246,266,274,0,,0,0.0,0.0,0.0,0.0,0.0
2024,7,20,6,2024-07-20,UA,7370,DTW,LAX,"Detroit, MI",Michigan,"Los Angeles, CA",California,520,1335,-19,-10,501,1325,16,19,517,1306,1718,223,243,258,0,,0,0.0,0.0,0.0,0.0,0.0
2024,2,8,4,2024-02-08,9E,1264,MCO,IAH,"Orlando, FL",Florida,"Houston, TX",Texas,1228,713,-20,-10,1208,703,17,9,1225,694,1594,194,214,220,0,,0,0.0,0.0,0.0,0.0,0.0
2024,9,29,7,2024-09-29,G4,1257,EWR,CLT,"Newark, NJ",New Jersey,"Charlotte, NC",North Carolina,1956,1371,-8,-10,1948,1361,13,8,1961,1353,1359,161,181,182,0,,0,0.0,0.0,0.0,0.0,0.0
2024,8,18,7,2024-08-18,9E,2346,HNL,PHX,"Honolulu, HI",Hawaii,"Phoenix, AZ",Arizona,1115,756,-26,-20,1089,736,15,9,1104,727,2163,275,295,299,0,,0,0.0,0.0,0.0,0.0,0.0
2024,3,26,2,2024-03-26,UA,6753,SFO,SLC,"San Francisco, CA",California,"Salt Lake City, UT",Utah,870,2019,13,5,883,2024,9,14,892,2010,1121,132,152,155,0,,0,0.0,0.0,0.0,0.0,0.0
2024,5,5,7,2024-05-05,F9,8958,LAX,ORD,"Los Angeles, CA",California,"Chicago, IL",Illinois,1916,1612,-15,-5,1901,1607,12,8,1913,1599,283,37,57,57,0,,0,0.0,0.0,0.0,0.0,0.0
2024,10,26,6,2024-10-26,DL,7749,MCO,TPA,"Orlando, FL",Florida,"Tampa, FL",Florida,1123,1852,-29,-20,1094,1832,24,18,1118,1814,481,64,84,106,0,,0,0.0,0.0,0.0,0.0,0.0
2024,1,25,4,2024-01-25,OH,611,MDW,STL,"Chicago, IL",Illinois,"St. Louis, MO",Missouri,1742,2235,-2,-5,1740,2230,16,10,1756,2220,2305,287,307,313,0,,0,0.0,0.0,0.0,0.0,0.0
2024,5,24,5,2024-05-24,MQ,8541,SAN,LAX,"San Diego, CA",California,"Los Angeles, CA",California,2027,854,13,15,2040,869,28,17,2068,852,2621,325,345,370,0,,0,0.0,0.0,0.0,0.0,0.0
2024,1,13,6,2024-01-13,UA,988,SAN,CLT,"San Diego, CA",California,"Charlotte, NC",North Carolina,1131,1802,-3,0,1128,1802,20,11,1148,1791,2231,282,302,313,0,,0,0.0,0.0,0.0,0.0,0.0
2024,7,30,2,2024-07-30,DL,9315,MSP,STL,"Minneapolis, MN",Minnesota,"St. Louis, MO",Missouri,1260,1852,30,30,1290,1882,14,15,1304,1867,641,81,101,110,0,,0,1.0,8.0,2.0,0.0,19.0
2024,1,25,4,2024-01-25,AA,8083,LGA,DFW,"New York, NY",New York,"Dallas/Fort Worth, TX",Texas,1346,1990,-7,0,1339,1990,19,14,1358,1976,807,108,128,141,0,,0,0.0,0.0,0.0,0.0,0.0
2024,3,8,5,2024-03-08,DL,8891,IAD,EWR,"Washington, DC",District of Columbia,"Newark, NJ",New Jersey,1447,1654,12,20,1459,1674,29,16,1488,1658,935,114,134,159,0,,0,2.0,5.0,3.0,0.0,10.0
2024,3,7,4,2024-03-07,F9,3122,DCA,MSP,"Washington, DC",District of Columbia,"Minneapolis, MN",Minnesota,1619,707,-16,-10,1603,697,16,10,1619,687,2253,273,293,299,0,,0,0.0,0.0,0.0,0.0,0.0
2024,8,20,2,2024-08-20,G4,2630,LAS,MSP,"Las Vegas, NV",Nevada,"Minneapolis, MN",Minnesota,1955,881,-7,-10,1948,871,28,17,1976,854,1737,219,239,264,0,,0,0.0,0.0,0.0,0.0,0.0
2024,4,18,4,2024-04-18,MQ,6415,SEA,ORD,"Seattle, WA",Washington,"Chicago, IL",Illinois,687,1220,4,5,691,1225,28,6,719,1219,1758,212,232,246,1,,0,0.0,0.0,0.0,0.0,0.0
2024,5,25,6,2024-05-25,DL,2164,SAN,DFW,"San Diego, CA",California,"Dallas/Fort Worth, TX",Texas,1000,989,25,30,1025,1019,18,11,1043,1008,804,92,112,121,0,,0,9.0,2.0,4.0,0.0,15.0
2024,4,20,6,2024-04-20,NK,5513,ORD,PHL,"Chicago, IL",Illinois,"Philadelphia, PA",Pennsylvania,1375,2164,9,10,1384,2174,29,8,1413,2166,2766,339,359,376,0,,0,0.0,0.0,0.0,0.0,0.0
2024,8,15,4,2024-08-15,HA,6637,JFK,LGA,"New York, NY",New York,"New York, NY",New York,874,1128,0,0,874,1128,17,8,891,1120,645,89,109,114,0,,0,0.0,0.0,0.0,0.0,0.0
2024,4,20,6,2024-04-20,B6,3669,JFK,PHL,"New York, NY",New York,"Philadelphia, PA",Pennsylvania,933,2027,-6,-15,927,2012,20,4,947,2008,2277,282,302,306,0,,0,0.0,0.0,0.0,0.0,0.0
2024,2,3,6,2024-02-03,UA,1342,MSP,PHL,"Minneapolis, MN",Minnesota,"Philadelphia, PA",Pennsylvania,1946,1793,-8,-5,1938,1788,14,9,1952,1779,2839,361,381,384,1,,0,0.0,0.0,0.0,0.0,0.0
2024,4,20,6,2024-04-20,G4,4429,STL,BOS,"St. Louis, MO",Missouri,"Boston, MA",Massachusetts,1667,1477,-22,-15,1645,1462,12,3,1657,1459,1480,184,204,199,0,,0,0.0,0.0,0.0,0.0,0.0
2024,9,20,5,2024-09-20,HA,2025,MIA,DCA,"Miami, FL",Florida,"Washington, DC",District of Columbia,2063,1798,2,-5,2065,1793,24,11,2089,1782,605,83,103,118,0,,0,0.0,0.0,0.0,0.0,0.0
2024,8,23,5,2024-08-23,AS,3495,ORD,STL,"Chicago, IL",Illinois,"St. Louis, MO",Missouri,998,1697,-1,-10,997,1687,18,7,1015,1680,2212,280,300,305,0,,0,0.0,0.0,0.0,0.0,0.0
2024,3,23,6,2024-03-23,OO,540,SFO,LAX,"San Francisco, CA",California,"Los Angeles, CA",California,505,1053,-2,-5,503,1048,9,11,512,1037,2490,318,338,338,0,,0,0.0,0.0,0.0,0.0,0.0
2024,2,11,7,2024-02-11,AA,5331,DEN,IAD,"Denver, CO",Colorado,"Washington, DC",District of Columbia,1840,1108,2,10,1842,1118,10,15,1852,1103,2803,346,366,371,0,,0,0.0,0.0,0.0,0.0,0.0
2024,4,10,3,2024-04-10,B6,8281,LAS,SEA,"Las Vegas, NV",Nevada,"Seattle, WA",Washington,2297,1863,-9,-10,2288,1853,25,3,2313,1850,2256,274,294,302,0,,0,0.0,0.0,0.0,0.0,0.0
2024,1,6,6,2024-01-06,NK,2843,ORD,IAD,"Chicago, IL",Illinois,"Washington, DC",District of Columbia,1753,695,-1,-5,1752,690,13,17,1765,673,1773,212,232,242,0,,0,0.0,0.0,0.0,0.0,0.0
2024,6,28,5,2024-06-28,WN,8139,PHL,DFW,"Philadelphia, PA",Pennsylvania,"Dallas/Fort Worth, TX",Texas,1645,2137,-13,-10,1632,2127,17,19,1649,2108,2269,283,303,319,0,,0,0.0,0.0,0.0,0.0,0.0
2024,10,8,2,2024-10-08,F9,8298,SFO,MCO,"San Francisco, CA",California,"Orlando, FL",Florida,2018,801,-7,-10,2011,791,17,10,2028,781,880,114,134,141,0,,0,0.0,0.0,0.0,0.0,0.0
2024,11,15,5,2024-11-15,9E,1686,LAS,IAH,"Las Vegas, NV",Nevada,"Houston, TX",Texas,2229,1660,-10,-5,2219,1655,6,17,2225,1638,457,53,73,76,0,,0,0.0,0.0,0.0,0.0,0.0
2024,8,13,2,2024-08-13,B6,925,MCO,IAD,"Orlando, FL",Florida,"Washington, DC",District of Columbia,1116,690,-7,-10,1109,680,26,13,1135,667,328,49,69,88,0,,0,0.0,0.0,0.0,0.0,0.0
2024,11,10,7,2024-11-10,G4,3924,IAH,ORD,"Houston, TX",Texas,"Chicago, IL",Illinois,1210,832,8,15,1218,847,17,10,1235,837,1233,148,168,175,0,,0,0.0,0.0,0.0,0.0,0.0
2024,12,30,1,2024-12-30,G4,1368,MCO,MSP,"Orlando, FL",Florida,"Minneapolis, MN",Minnesota,974,1258,4,-5,978,1253,6,8,984,1245,377,55,75,69,0,,0,0.0,0.0,0.0,0.0,0.0
2024,8,16,5,2024-08-16,G4,7715,LAS,EWR,"Las Vegas, NV",Nevada,"Newark, NJ",New Jersey,1073,1610,-20,-15,1053,1595,19,8,1072,1587,947,117,137,144,0,,0,0.0,0.0,0.0,0.0,0.0
2024,10,15,2,2024-10-15,AA,3536,LGA,MSP,"New York, NY",New York,"Minneapolis, MN",Minnesota,1295,1408,5,0,1300,1408,28,10,1328,1398,2933,370,390,408,0,,0,0.0,0.0,0.0,0.0,0.0
2024,5,29,3,2024-05-29,DL,8189,DTW,TPA,"Detroit, MI",Michigan,"Tampa, FL",Florida,1007,1511,-4,-10,1003,1501,28,11,1031,1490,827,93,113,132,0,,0,0.0,0.0,0.0,0.0,0.0
2024,10,3,4,2024-10-03,UA,1410,SAN,MSP,"San Diego, CA",California,"Minneapolis, MN",Minnesota,1091,852,-19,-10,1072,842,25,8,1097,834,915,120,140,153,0,,0,0.0,0.0,0.0,0.0,0.0
2024,7,16,2,2024-07-16,OH,9919,DCA,MSP,"Washington, DC",District of Columbia,"Minneapolis, MN",Minnesota,674,1994,-3,-10,671,1984,16,7,687,1977,387,47,67,70,0,,0,0.0,0.0,0.0,0.0,0.0
2024,3,10,7,2024-03-10,WN,9328,EWR,BWI,"Newark, NJ",New Jersey,"Baltimore, MD",Maryland,2044,1323,-13,-15,2031,1308,14,18,2045,1290,1029,121,141,153,0,,0,0.0,0.0,0.0,0.0,0.0
2024,4,21,7,2024-04-21,9E,577,MIA,DFW,"Miami, FL",Florida,"Dallas/Fort Worth, TX",Texas,1191,2067,14,5,1205,2072,28,9,1233,2063,1355,175,195,212,0,,0,0.0,0.0,0.0,0.0,0.0
2024,1,4,4,2024-01-04,G4,9006,SLC,STL,"Salt Lake City, UT",Utah,"St. Louis, MO",Missouri,1794,1040,10,5,1804,1045,25,3,1829,1042,1956,243,263,271,0,,0,0.0,0.0,0.0,0.0,0.0
2024,12,15,7,2024-12-15,9E,9968,JFK,HNL,"New York, NY",New York,"Honolulu, HI",Hawaii,2197,1595,-3,-5,2194,1590,8,12,2202,1578,1378,173,193,193,0,,0,0.0,0.0,0.0,0.0,0.0
2024,11,26,2,2024-11-26,MQ,2262,DTW,DCA,"Detroit, MI",Michigan,"Washington, DC",District of Columbia,1287,663,8,5,1295,668,29,7,1324,661,2212,276,296,312,0,,0,0.0,0.0,0.0,0.0,0.0
2024,11,13,3,2024-11-13,AS,608,PDX,BWI,"Portland, OR",Oregon,"Baltimore, MD",Maryland,2241,604,2,-5,2243,599,12,11,2255,588,2560,312,332,335,0,,0,0.0,0.0,0.0,0.0,0.0
2024,12,15,7,2024-12-15,AA,7419,MSP,DEN,"Minneapolis, MN",Minnesota,"Denver, CO",Colorado,1071,2281,-13,-10,1058,2271,8,5,1066,2266,2569,329,349,342,0,,0,0.0,0.0,0.0,0.0,0.0
2024,4,4,4,2024-04-04,YX,481,CLT,ATL,"Charlotte, NC",North Carolina,"Atlanta, GA",Georgia,685,671,-11,-5,674,666,6,11,680,655,242,37,57,54,0,,0,0.0,0.0,0.0,0.0,0.0
2024,5,31,5,2024-05-31,G4,9472,DEN,DCA,"Denver, CO",Colorado,"Washington, DC",District of Columbia,1086,2020,-2,0,1084,2020,22,18,1106,2002,2230,285,305,325,0,,0,0.0,0.0,0.0,0.0,0.0
2024,11,6,3,2024-11-06,AS,1945,HNL,IAH,"Honolulu, HI",Hawaii,"Houston, TX",Texas,1617,1216,-16,-20,1601,1196,22,4,1623,1192,2985,366,386,392,0,,0,0.0,0.0,0.0,0.0,0.0
2024,5,16,4,2024-05-16,WN,7400,DEN,MDW,"Denver, CO",Colorado,"Chicago, IL",Illinois,2102,929,3,5,2105,934,18,10,2123,924,723,84,104,112,0,,0,0.0,0.0,0.0,0.0,0.0
2024,9,3,2,2024-09-03,OH,9392,SLC,BOS,"Salt Lake City, UT",Utah,"Boston, MA",Massachusetts,1013,2171,14,5,1027,2176,14,16,1041,2160,290,28,48,58,0,,0,0.0,0.0,0.0,0.0,0.0
2024,8,30,5,2024-08-30,WN,9009,MIA,MDW,"Miami, FL",Florida,"Chicago, IL",Illinois,1701,1770,9,10,1710,1780,16,8,1726,1772,637,69,89,93,0,,0,0.0,0.0,0.0,0.0,0.0
2024,1,31,3,2024-01-31,UA,7817,PHL,SLC,"Philadelphia, PA",Pennsylvania,"Salt Lake City, UT",Utah,1153,2038,-8,-15,1145,2023,12,14,1157,2009,1809,232,252,258,0,,0,0.0,0.0,0.0,0.0,0.0
2024,2,9,5,2024-02-09,NK,8609,MDW,TPA,"Chicago, IL",Illinois,"Tampa, FL",Florida,1055,948,-17,-20,1038,928,26,3,1064,925,2538,323,343,352,0,,0,0.0,0.0,0.0,0.0,0.0
2024,8,16,5,2024-08-16,UA,4729,IAH,DCA,"Houston, TX",Texas,"Washington, DC",District of Columbia,2209,964,-8,-15,2201,949,21,9,2222,940,487,69,89,99,0,,0,0.0,0.0,0.0,0.0,0.0
2024,2,5,1,2024-02-05,DL,5804,MCO,LAX,"Orlando, FL",Florida,"Los Angeles, CA",California,794,1390,20,15,814,1405,16,14,830,1391,411,41,61,71,0,,0,0.0,0.0,0.0,0.0,0.0
2024,8,10,6,2024-08-10,9E,1876,MSP,PHL,"Minneapolis, MN",Minnesota,"Philadelphia, PA",Pennsylvania,1754,1015,-1,5,1753,1020,24,14,1777,1006,418,42,62,80,0,,0,0.0,0.0,0.0,0.0,0.0
2024,1,6,6,2024-01-06,F9,8203,CLT,EWR,"Charlotte, NC",North Carolina,"Newark, NJ",New Jersey,1759,1224,9,10,1768,1234,7,8,1775,1226,545,61,81,76,0,,0,0.0,0.0,0.0,0.0,0.0
2024,11,17,7,2024-11-17,WN,2384,DCA,BWI,"Washington, DC",District of Columbia,"Baltimore, MD",Maryland,1616,1106,9,0,1625,1106,14,4,1639,1102,1234,152,172,170,0,,0,0.0,0.0,0.0,0.0,0.0
2024,8,7,3,2024-08-07,F9,1344,MCO,PHL,"Orlando, FL",Florida,"Philadelphia, PA",Pennsylvania,2010,1122,-5,0,2005,1122,15,13,2020,1109,1252,151,171,179,0,,0,0.0,0.0,0.0,0.0,0.0
2024,3,15,5,2024-03-15,AA,1433,DFW,LAX,"Dallas/Fort Worth, TX",Texas,"Los Angeles, CA",California,543,1305,-12,-10,531,1295,18,18,549,1277,1859,233,253,269,0,,0,0.0,0.0,0.0,0.0,0.0
2024,1,4,4,2024-01-04,HA,3769,MDW,SLC,"Chicago, IL",Illinois,"Salt Lake City, UT",Utah,1038,849,15,10,1053,859,11,3,1064,856,819,104,124,118,0,,0,0.0,0.0,0.0,0.0,0.0
2024,11,30,6,2024-11-30,B6,1300,ORD,MSP,"Chicago, IL",Illinois,"Minneapolis, MN",Minnesota,1998,1500,10,10,2008,1510,9,8,2017,1502,859,116,136,133,0,,0,0.0,0.0,0.0,0.0,0.0
2024,5,13,1,2024-05-13,MQ,1894,MCO,PHX,"Orlando, FL",Florida,"Phoenix, AZ",Arizona,538,848,4,-5,542,843,5,12,547,831,2290,286,306,303,0,,0,0.0,0.0,0.0,0.0,0.0
2024,4,27,6,2024-04-27,G4,6281,EWR,LAX,"Newark, NJ",New Jersey,"Los Angeles, CA",California,1908,1974,2,-5,1910,1969,16,11,1926,1958,781,98,118,125,0,,0,0.0,0.0,0.0,0.0,0.0
2024,4,3,3,2024-04-03,AA,1554,PHX,STL,"Phoenix, AZ",Arizona,"St. Louis, MO",Missouri,1958,1892,-1,5,1957,1897,20,12,1977,1885,2383,296,316,328,0,,0,0.0,0.0,0.0,0.0,0.0
2024,3,2,6,2024-03-02,OO,2033,DEN,SEA,"Denver, CO",Colorado,"Seattle, WA",Washington,788,1453,-22,-20,766,1433,10,11,776,1422,1396,179,199,200,0,,0,0.0,0.0,0.0,0.0,0.0
2024,7,12,5,2024-07-12,MQ,846,PDX,SFO,"Portland, OR",Oregon,"San Francisco, CA",California,747,1047,10,10,757,1057,24,15,781,1042,2614,332,352,371,0,,0,0.0,0.0,0.0,0.0,0.0
2024,11,30,6,2024-11-30,WN,7470,SFO,MIA,"San Francisco, CA",California,"Miami, FL",Florida,2085,682,-7,-5,2078,677,14,12,2092,665,2057,259,279,285,0,,0,0.0,0.0,0.0,0.0,0.0
2024,7,21,7,2024-07-21,AS,9132,PDX,MCO,"Portland, OR",Oregon,"Orlando, FL",Florida,858,2164,-12,-5,846,2159,19,11,865,2148,2942,357,377,387,0,,0,0.0,0.0,0.0,0.0,0.0
2024,1,26,5,2024-01-26,9E,8073,STL,IAD,"St. Louis, MO",Missouri,"Washington, DC",District of Columbia,1961,2030,2,5,1963,2035,19,6,1982,2029,1826,226,246,251,0,,0,0.0,0.0,0.0,0.0,0.0
2024,6,21,5,2024-06-21,F9,6927,MIA,CLT,"Miami, FL",Florida,"Charlotte, NC",North Carolina,708,938,-6,0,702,938,10,17,712,921,2203,272,292,299,0,,0,0.0,0.0,0.0,0.0,0.0
2024,10,26,6,2024-10-26,OH,9380,ORD,LAS,"Chicago, IL",Illinois,"Las Vegas, NV",Nevada,623,1703,-18,-10,605,1693,27,10,632,1683,2213,283,303,320,0,,0,0.0,0.0,0.0,0.0,0.0
2024,5,12,7,2024-05-12,UA,892,STL,MIA,"St. Louis, MO",Missouri,"Miami, FL",Florida,1474,694,8,15,1482,709,29,4,1511,705,1060,122,142,155,0,,0,0.0,0.0,0.0,0.0,0.0
2024,11,21,4,2024-11-21,B6,7027,SAN,MCO,"San Diego, CA",California,"Orlando, FL",Florida,2284,1511,35,30,2319,1541,5,6,2324,1535,2441,297,317,308,0,,0,4.0,0.0,0.0,0.0,26.0
2024,4,27,6,2024-04-27,NK,1367,DFW,PHX,"Dallas/Fort Worth, TX",Texas,"Phoenix, AZ",Arizona,902,858,2,0,904,858,10,8,914,850,1750,208,228,226,0,,0,0.0,0.0,0.0,0.0,0.0
2024,11,19,2,2024-11-19,AA,9842,LAX,MIA,"Los Angeles, CA",California,"Miami, FL",Florida,783,721,-8,0,775,721,17,9,792,712,2079,249,269,275,0,,0,0.0,0.0,0.0,0.0,0.0
2024,10,1,2,2024-10-01,HA,6469,MDW,BWI,"Chicago, IL",Illinois,"Baltimore, MD",Maryland,1162,1747,-7,0,1155,1747,15,15,1170,1732,368,54,74,84,0,,0,0.0,0.0,0.0,0.0,0.0
2024,7,30,2,2024-07-30,NK,2790,LAS,BOS,"Las Vegas, NV",Nevada,"Boston, MA",Massachusetts,1075,1134,-10,0,1065,1134,28,7,1093,1127,1100,144,164,179,0,,0,0.0,0.0,0.0,0.0,0.0
2024,8,12,1,2024-08-12,MQ,7974,MIA,PHX,"Miami, FL",Florida,"Phoenix, AZ",Arizona,740,1552,12,15,752,1567,24,6,776,1561,1099,138,158,168,0,,0,0.0,0.0,0.0,0.0,0.0
2024,1,20,6,2024-01-20,YX,392,SEA,DEN,"Seattle, WA",Washington,"Denver, CO",Colorado,666,1504,-12,-10,654,1494,29,8,683,1486,2668,328,348,365,0,,0,0.0,0.0,0.0,0.0,0.0
2024,4,22,1,2024-04-22,OO,6964,STL,IAD,"St. Louis, MO",Missouri,"Washington, DC",District of Columbia,2275,1546,-21,-15,2254,1531,24,7,2278,1524,2748,349,369,380,0,,0,0.0,0.0,0.0,0.0,0.0
2024,5,19,7,2024-05-19,F9,4122,MIA,IAD,"Miami, FL",Florida,"Washington, DC",District of Columbia,1060,2351,16,15,1076,2366,24,7,1100,2359,1236,155,175,186,0,,0,0.0,0.0,0.0,0.0,0.0
2024,2,16,5,2024-02-16,F9,9696,LGA,SLC,"New York, NY",New York,"Salt Lake City, UT",Utah,2222,1912,-12,-10,2210,1902,16,9,2226,1893,348,34,54,59,0,,0,0.0,0.0,0.0,0.0,0.0
2024,1,1,1,2024-01-01,G4,1748,EWR,CLT,"Newark, NJ",New Jersey,"Charlotte, NC",North Carolina,647,2085,-2,5,645,2090,18,7,663,2083,2514,307,327,332,0,,0,0.0,0.0,0.0,0.0,0.0
2024,3,30,6,2024-03-30,AS,5271,DEN,DCA,"Denver, CO",Colorado,"Washington, DC",District of Columbia,1200,691,-4,-10,1196,681,13,6,1209,675,213,22,42,41,0,,0,0.0,0.0,0.0,0.0,0.0
2024,5,21,2,2024-05-21,YX,9689,SFO,MIA,"San Francisco, CA",California,"Miami, FL",Florida,1122,1647,21,20,1143,1667,17,11,1160,1656,2228,269,289,297,0,,0,5.0,5.0,1.0,0.0,9.0
2024,11,15,5,2024-11-15,AS,1793,SEA,DTW,"Seattle, WA",Washington,"Detroit, MI",Michigan,764,1730,7,5,771,1735,8,7,779,1728,1473,193,213,208,0,,0,0.0,0.0,0.0,0.0,0.0
2024,2,7,3,2024-02-07,DL,6810,TPA,LAS,"Tampa, FL",Florida,"Las Vegas, NV",Nevada,1000,651,15,15,1015,666,13,4,1028,662,619,86,106,103,0,,0,0.0,0.0,0.0,0.0,0.0
2024,10,19,6,2024-10-19,UA,1137,ORD,LGA,"Chicago, IL",Illinois,"New York, NY",New York,778,1310,26,20,804,1330,5,19,809,1311,1620,206,226,230,0,,0,1.0,3.0,2.0,0.0,14.0
2024,5,18,6,2024-05-18,WN,3952,HNL,MDW,"Honolulu, HI",Hawaii,"Chicago, IL",Illinois,1248,893,-11,-15,1237,878,12,9,1249,869,780,93,113,114,0,,0,0.0,0.0,0.0,0.0,0.0
2024,12,21,6,2024-12-21,WN,5559,IAH,LAS,"Houston, TX",Texas,"Las Vegas, NV",Nevada,1402,899,-7,-5,1395,894,6,19,1401,875,1500,195,215,220,0,,0,0.0,0.0,0.0,0.0,0.0
2024,11,28,4,2024-11-28,F9,9854,SLC,MDW,"Salt Lake City, UT",Utah,"Chicago, IL",Illinois,658,944,-7,0,651,944,28,19,679,925,2439,296,316,343,0,,0,0.0,0.0,0.0,0.0,0.0
2024,9,15,7,2024-09-15,OH,9404,LGA,SLC,"New York, NY",New York,"Salt Lake City, UT",Utah,1583,2005,11,10,1594,2015,25,18,1619,1997,1058,130,150,173,0,,0,0.0,0.0,0.0,0.0,0.0
2024,6,9,7,2024-06-09,AA,7148,EWR,MSP,"Newark, NJ",New Jersey,"Minneapolis, MN",Minnesota,998,2191,-18,-10,980,2181,17,10,997,2171,1672,210,230,237,0,,0,0.0,0.0,0.0,0.0,0.0
2024,6,26,3,2024-06-26,9E,6284,PHL,LGA,"Philadelphia, PA",Pennsylvania,"New York, NY",New York,1840,793,24,15,1864,808,17,15,1881,793,634,86,106,118,0,,0,0.0,0.0,0.0,0.0,0.0
2024,1,10,3,2024-01-10,OH,9583,PHL,JFK,"Philadelphia, PA",Pennsylvania,"New York, NY",New York,2110,2180,-4,-10,2106,2170,5,16,2111,2154,396,41,61,62,0,,0,0.0,0.0,0.0,0.0,0.0
2024,9,17,2,2024-09-17,WN,1261,PDX,BOS,"Portland, OR",Oregon,"Boston, MA",Massachusetts,987,1035,6,10,993,1045,5,15,998,1030,531,64,84,84,0,,0,0.0,0.0,0.0,0.0,0.0
2024,5,17,5,2024-05-17,OO,1129,ATL,LGA,"Atlanta, GA",Georgia,"New York, NY",New York,964,984,-4,0,960,984,10,12,970,972,2272,279,299,301,0,,0,0.0,0.0,0.0,0.0,0.0
2024,6,20,4,2024-06-20,YX,1078,STL,DFW,"St. Louis, MO",Missouri,"Dallas/Fort Worth, TX",Texas,727,1454,1,0,728,1454,20,16,748,1438,2387,292,312,328,0,,0,0.0,0.0,0.0,0.0,0.0
2024,1,13,6,2024-01-13,MQ,8809,LAX,ATL,"Los Angeles, CA",California,"Atlanta, GA",Georgia,1165,1350,-6,-5,1159,1345,21,12,1180,1333,805,98,118,131,0,,0,0.0,0.0,0.0,0.0,0.0
2024,6,16,7,2024-06-16,OO,9074,SLC,ATL,"Salt Lake City, UT",Utah,"Atlanta, GA",Georgia,1879,1995,-18,-15,1861,1980,17,8,1878,1972,1527,193,213,218,0,,1,0.0,0.0,0.0,0.0,0.0
2024,5,9,4,2024-05-09,OO,5229,SAN,LAS,"San Diego, CA",California,"Las Vegas, NV",Nevada,1989,919,-7,-5,1982,914,22,19,2004,895,2210,267,287,308,0,,0,0.0,0.0,0.0,0.0,0.0
2024,3,24,7,2024-03-24,WN,237,SAN,CLT,"San Diego, CA",California,"Charlotte, NC",North Carolina,1321,838,-2,-5,1319,833,7,19,1326,814,1560,187,207,213,0,,0,0.0,0.0,0.0,0.0,0.0
2024,11,16,6,2024-11-16,AA,9045,TPA,SEA,"Tampa, FL",Florida,"Seattle, WA",Washington,1298,991,-5,0,1293,991,19,13,1312,978,1042,120,140,152,0,,0,0.0,0.0,0.0,0.0,0.0
2024,11,14,4,2024-11-14,UA,4908,MIA,PDX,"Miami, FL",Florida,"Portland, OR",Oregon,1252,1247,13,5,1265,1252,6,15,1271,1237,1040,123,143,144,0,,0,0.0,0.0,0.0,0.0,0.0
2024,4,10,3,2024-04-10,B6,2555,MIA,IAH,"Miami, FL",Florida,"Houston, TX",Texas,1750,1908,-1,-5,1749,1903,29,14,1778,1889,857,109,129,152,0,,0,0.0,0.0,0.0,0.0,0.0
2024,11,24,7,2024-11-24,AS,7492,EWR,DCA,"Newark, NJ",New Jersey,"Washington, DC",District of Columbia,1692,612,4,-5,1696,607,10,14,1706,593,1736,214,234,238,0,,0,0.0,0.0,0.0,0.0,0.0
2024,9,29,7,2024-09-29,G4,8871,ORD,IAD,"Chicago, IL",Illinois,"Washington, DC",District of Columbia,1807,2008,24,15,1831,2023,29,6,1860,2017,781,104,124,139,0,,0,0.0,0.0,0.0,0.0,0.0
2024,9,21,6,2024-09-21,G4,3366,LGA,DTW,"New York, NY",New York,"Detroit, MI",Michigan,761,1140,1,5,762,1145,25,18,787,1127,1868,242,262,285,0,,0,0.0,0.0,0.0,0.0,0.0
2024,2,7,3,2024-02-07,G4,4749,MSP,SFO,"Minneapolis, MN",Minnesota,"San Francisco, CA",California,1359,1289,-23,-20,1336,1269,24,3,1360,1266,714,82,102,109,0,,0,0.0,0.0,0.0,0.0,0.0
2024,4,3,3,2024-04-03,OO,8687,SAN,DTW,"San Diego, CA",California,"Detroit, MI",Michigan,863,1916,2,10,865,1926,18,16,883,1910,801,96,116,130,0,,0,0.0,0.0,0.0,0.0,0.0
2024,4,4,4,2024-04-04,AA,5353,LAX,SAN,"Los Angeles, CA",California,"San Diego, CA",California,2044,856,30,30,2074,886,22,15,2096,871,1967,247,267,284,0,,0,9.0,0.0,3.0,0.0,18.0
2024,10,31,4,2024-10-31,YX,5528,SFO,SLC,"San Francisco, CA",California,"Salt Lake City, UT",Utah,597,707,8,15,605,722,8,9,613,713,1677,199,219,216,0,,0,0.0,0.0,0.0,0.0,0.0
2024,3,9,6,2024-03-09,G4,6085,STL,DCA,"St. Louis, MO",Missouri,"Washington, DC",District of Columbia,1535,2204,1,10,1536,2214,12,8,1548,2206,2066,265,285,285,0,,0,0.0,0.0,0.0,0.0,0.0
2024,11,13,3,2024-11-13,MQ,2689,LGA,PHX,"New York, NY",New York,"Phoenix, AZ",Arizona,1283,2311,-10,0,1273,2311,6,3,1279,2308,1519,192,212,201,0,,0,0.0,0.0,0.0,0.0,0.0
2024,8,23,5,2024-08-23,F9,7276,LAX,PHL,"Los Angeles, CA",California,"Philadelphia, PA",Pennsylvania,1082,782,-14,-10,1068,772,28,3,1096,769,301,34,54,65,0,,0,0.0,0.0,0.0,0.0,0.0
2024,11,29,5,2024-11-29,DL,3134,PHL,DTW,"Philadelphia, PA",Pennsylvania,"Detroit, MI",Michigan,1426,2329,6,5,1432,2334,6,17,1438,2317,1815,225,245,248,0,,0,0.0,0.0,0.0,0.0,0.0
2024,5,16,4,2024-05-16,MQ,269,IAD,BWI,"Washington, DC",District of Columbia,"Baltimore, MD",Maryland,1940,966,2,5,1942,971,21,14,1963,957,2971,368,388,403,0,,0,0.0,0.0,0.0,0.0,0.0
2024,3,16,6,2024-03-16,OO,3339,SAN,TPA,"San Diego, CA",California,"Tampa, FL",Florida,2024,1619,-8,-10,2016,1609,8,17,2024,1592,2331,283,303,308,0,,0,0.0,0.0,0.0,0.0,0.0
2024,2,4,7,2024-02-04,AA,3515,MCO,TPA,"Orlando, FL",Florida,"Tampa, FL",Florida,634,1430,-15,-10,619,1420,27,5,646,1415,2721,332,352,364,0,,0,0.0,0.0,0.0,0.0,0.0
2024,1,1,1,2024-01-01,AA,3668,IAD,IAH,"Washington, DC",District of Columbia,"Houston, TX",Texas,758,2157,-9,-5,749,2152,20,12,769,2140,2561,315,335,347,0,,0,0.0,0.0,0.0,0.0,0.0
2024,10,22,2,2024-10-22,YX,3584,SEA,SFO,"Seattle, WA",Washington,"San Francisco, CA",California,1415,1461,9,0,1424,1461,6,3,1430,1458,2474,309,329,318,0,,0,0.0,0.0,0.0,0.0,0.0
2024,11,15,5,2024-11-15,AS,4935,MSP,DTW,"Minneapolis, MN",Minnesota,"Detroit, MI",Michigan,1016,2146,-15,-10,1001,2136,23,3,1024,2133,2503,305,325,331,0,,0,0.0,0.0,0.0,0.0,0.0
2024,2,29,4,2024-02-29,G4,1941,LGA,SEA,"New York, NY",New York,"Seattle, WA",Washington,2274,1908,1,0,2275,1908,10,18,2285,1890,436,63,83,91,0,,0,0.0,0.0,0.0,0.0,0.0
2024,11,15,5,2024-11-15,NK,6978,BOS,PDX,"Boston, MA",Massachusetts,"Portland, OR",Oregon,1817,1473,6,10,1823,1483,6,7,1829,1476,689,91,111,104,0,,0,0.0,0.0,0.0,0.0,0.0
2024,12,14,6,2024-12-14,B6,4652,DTW,HNL,"Detroit, MI",Michigan,"Honolulu, HI",Hawaii,2134,1882,-11,-10,2123,1872,13,7,2136,1865,2912,364,384,384,0,,0,0.0,0.0,0.0,0.0,0.0
2024,11,23,6,2024-11-23,OO,6944,HNL,DTW,"Honolulu, HI",Hawaii,"Detroit, MI",Michigan,1963,772,16,20,1979,792,10,13,1989,779,1509,197,217,220,0,,0,2.0,0.0,2.0,0.0,16.0
2024,9,23,1,2024-09-23,DL,3126,BOS,LGA,"Boston, MA",Massachusetts,"New York, NY",New York,650,2340,4,0,654,2340,10,13,664,2327,1903,228,248,251,0,,0,0.0,0.0,0.0,0.0,0.0
2024,12,26,4,2024-12-26,AA,6289,DFW,MCO,"Dallas/Fort Worth, TX",Texas,"Orlando, FL",Florida,2004,1359,-24,-15,1980,1344,12,14,1992,1330,736,86,106,112,0,,0,0.0,0.0,0.0,0.0,0.0
2024,8,16,5,2024-08-16,DL,4065,DTW,LGA,"Detroit, MI",Michigan,"New York, NY",New York,1781,1370,-18,-15,1763,1355,5,16,1768,1339,209,20,40,41,0,,0,0.0,0.0,0.0,0.0,0.0
2024,9,26,4,2024-09-26,AA,7284,EWR,MIA,"Newark, NJ",New Jersey,"Miami, FL",Florida,1367,1953,1,-5,1368,1948,20,3,1388,1945,564,75,95,98,0,,0,0.0,0.0,0.0,0.0,0.0
2024,11,11,1,2024-11-11,UA,9893,TPA,EWR,"Tampa, FL",Florida,"Newark, NJ",New Jersey,1672,1051,-5,-10,1667,1041,14,10,1681,1031,1536,195,215,219,0,,0,0.0,0.0,0.0,0.0,0.0
2024,10,12,6,2024-10-12,AS,5579,MCO,EWR,"Orlando, FL",Florida,"Newark, NJ",New Jersey,1473,1070,12,10,1485,1080,23,5,1508,1075,874,105,125,133,0,,0,0.0,0.0,0.0,0.0,0.0
2024,10,17,4,2024-10-17,MQ,5480,PDX,BOS,"Portland, OR",Oregon,"Boston, MA",Massachusetts,641,1704,12,5,653,1709,22,4,675,1705,2530,306,326,332,0,,0,0.0,0.0,0.0,0.0,0.0
2024,7,31,3,2024-07-31,F9,1246,EWR,TPA,"Newark, NJ",New Jersey,"Tampa, FL",Florida,750,920,3,10,753,930,20,11,773,919,2499,303,323,334,0,,0,0.0,0.0,0.0,0.0,0.0
2024,6,13,4,2024-06-13,UA,4426,MSP,SAN,"Minneapolis, MN",Minnesota,"San Diego, CA",California,1457,1040,1,0,1458,1040,5,14,1463,1026,1797,227,247,246,0,,0,0.0,0.0,0.0,0.0,0.0
2024,1,5,5,2024-01-05,9E,211,LGA,DFW,"New York, NY",New York,"Dallas/Fort Worth, TX",Texas,2269,998,-5,-5,2264,993,19,13,2283,980,2967,364,384,396,0,,0,0.0,0.0,0.0,0.0,0.0
2024,12,4,3,2024-12-04,G4,692,SFO,DFW,"San Francisco, CA",California,"Dallas/Fort Worth, TX",Texas,1406,787,-19,-10,1387,777,20,3,1407,774,612,78,98,101,0,,0,0.0,0.0,0.0,0.0,0.0
2024,3,18,1,2024-03-18,9E,7513,IAH,PHX,"Houston, TX",Texas,"Phoenix, AZ",Arizona,1143,2061,9,0,1152,2061,15,18,1167,2043,554,71,91,104,0,,0,0.0,0.0,0.0,0.0,0.0
2024,3,2,6,2024-03-02,B6,8279,SLC,DFW,"Salt Lake City, UT",Utah,"Dallas/Fort Worth, TX",Texas,1570,1484,5,0,1575,1484,10,3,1585,1481,2396,295,315,308,0,,0,0.0,0.0,0.0,0.0,0.0
2024,5,11,6,2024-05-11,NK,1338,LGA,MCO,"New York, NY",New York,"Orlando, FL",Florida,1895,1449,-3,-5,1892,1444,18,11,1910,1433,368,50,70,79,0,,0,0.0,0.0,0.0,0.0,0.0
2024,3,29,5,2024-03-29,F9,6083,MDW,MIA,"Chicago, IL",Illinois,"Miami, FL",Florida,593,2071,8,15,601,2086,20,7,621,2079,2662,331,351,358,0,,0,0.0,0.0,0.0,0.0,0.0
2024,8,24,6,2024-08-24,UA,2894,IAD,IAH,"Washington, DC",District of Columbia,"Houston, TX",Texas,1260,1342,-9,0,1251,1342,8,7,1259,1335,346,34,54,49,0,,0,0.0,0.0,0.0,0.0,0.0
2024,2,11,7,2024-02-11,DL,3698,DFW,LAX,"Dallas/Fort Worth, TX",Texas,"Los Angeles, CA",California,855,2093,17,10,872,2103,26,10,898,2093,1715,222,242,258,0,,0,0.0,0.0,0.0,0.0,0.0
2024,3,29,5,2024-03-29,DL,3903,DCA,SLC,"Washington, DC",District of Columbia,"Salt Lake City, UT",Utah,1031,2163,-10,0,1021,2163,12,16,1033,2147,493,63,83,91,0,,0,0.0,0.0,0.0,0.0,0.0
2024,10,22,2,2024-10-22,B6,1626,PHL,MDW,"Philadelphia, PA",Pennsylvania,"Chicago, IL",Illinois,1191,1461,-10,-5,1181,1456,27,6,1208,1450,1127,135,155,168,0,,0,0.0,0.0,0.0,0.0,0.0
2024,11,23,6,2024-11-23,HA,8009,JFK,PHL,"New York, NY",New York,"Philadelphia, PA",Pennsylvania,1795,2084,14,5,1809,2089,23,14,1832,2075,1227,143,163,180,0,,0,0.0,0.0,0.0,0.0,0.0
2024,10,21,1,2024-10-21,AA,2069,MSP,BOS,"Minneapolis, MN",Minnesota,"Boston, MA",Massachusetts,1952,1114,-1,-10,1951,1104,23,4,1974,1100,2325,280,300,307,0,,0,0.0,0.0,0.0,0.0,0.0
2024,4,13,6,2024-04-13,HA,9243,SFO,HNL,"San Francisco, CA",California,"Honolulu, HI",Hawaii,1147,1860,8,0,1155,1860,26,8,1181,1852,776,98,118,132,0,,0,0.0,0.0,0.0,0.0,0.0
2024,1,14,7,2024-01-14,DL,1602,MSP,LAX,"Minneapolis, MN",Minnesota,"Los Angeles, CA",California,2272,780,-6,-5,2266,775,5,16,2271,759,303,40,60,61,0,,0,0.0,0.0,0.0,0.0,0.0
2024,10,14,1,2024-10-14,MQ,4567,IAD,LAS,"Washington, DC",District of Columbia,"Las Vegas, NV",Nevada,1201,1009,-17,-15,1184,994,7,15,1191,979,2842,355,375,377,0,,0,0.0,0.0,0.0,0.0,0.0
2024,6,27,4,2024-06-27,G4,6507,DTW,IAH,"Detroit, MI",Michigan,"Houston, TX",Texas,1223,1115,1,-5,1224,1110,12,5,1236,1105,1271,148,168,165,0,,0,0.0,0.0,0.0,0.0,0.0
2024,5,4,6,2024-05-04,NK,8401,BWI,LAS,"Baltimore, MD",Maryland,"Las Vegas, NV",Nevada,1416,1511,-1,-5,1415,1506,17,7,1432,1499,2663,326,346,350,0,,0,0.0,0.0,0.0,0.0,0.0
2024,12,18,3,2024-12-18,HA,2454,MIA,IAH,"Miami, FL",Florida,"Houston, TX",Texas,563,1459,-24,-15,539,1444,23,14,562,1430,2511,305,325,342,0,,0,0.0,0.0,0.0,0.0,0.0
2024,1,23,2,2024-01-23,HA,5419,EWR,DEN,"Newark, NJ",New Jersey,"Denver, CO",Colorado,1425,1695,16,10,1441,1705,5,13,1446,1692,2892,363,383,381,0,,0,0.0,0.0,0.0,0.0,0.0
2024,3,3,7,2024-03-03,AS,325,MIA,ATL,"Miami, FL",Florida,"Atlanta, GA",Georgia,1687,781,-4,0,1683,781,17,6,1700,775,911,107,127,130,0,,0,0.0,0.0,0.0,0.0,0.0
2024,5,22,3,2024-05-22,G4,3111,PDX,SLC,"Portland, OR",Oregon,"Salt Lake City, UT",Utah,1912,703,0,-5,1912,698,14,14,1926,684,2424,305,325,333,1,,0,0.0,0.0,0.0,0.0,0.0
2024,6,1,6,2024-06-01,NK,4226,STL,LAX,"St. Louis, MO",Missouri,"Los Angeles, CA",California,1992,1895,6,0,1998,1895,20,9,2018,1886,1933,240,260,269,0,,0,0.0,0.0,0.0,0.0,0.0
2024,5,24,5,2024-05-24,OH,713,DEN,SEA,"Denver, CO",Colorado,"Seattle, WA",Washington,2073,886,-5,5,2068,891,13,12,2081,879,2858,349,369,374,0,,0,0.0,0.0,0.0,0.0,0.0
2024,8,12,1,2024-08-12,OO,198,STL,DEN,"St. Louis, MO",Missouri,"Denver, CO",Colorado,1226,686,-15,-20,1211,666,6,3,1217,663,508,53,73,62,0,,0,0.0,0.0,0.0,0.0,0.0
2024,11,4,1,2024-11-04,B6,5558,SAN,ORD,"San Diego, CA",California,"Chicago, IL",Illinois,2054,985,-7,0,2047,985,27,18,2074,967,2363,297,317,342,0,,1,0.0,0.0,0.0,0.0,0.0
2024,4,13,6,2024-04-13,HA,9102,SFO,JFK,"San Francisco, CA",California,"New York, NY",New York,1265,1696,5,0,1270,1696,12,6,1282,1690,2819,346,366,364,0,,0,0.0,0.0,0.0,0.0,0.0
2024,4,13,6,2024-04-13,G4,6016,LAX,SAN,"Los Angeles, CA",California,"San Diego, CA",California,2109,1202,2,10,2111,1212,7,14,2118,1198,2692,336,356,357,0,,0,0.0,0.0,0.0,0.0,0.0
2024,2,8,4,2024-02-08,AS,3437,DEN,EWR,"Denver, CO",Colorado,"Newark, NJ",New Jersey,1422,2308,-10,0,1412,2308,27,15,1439,2293,645,81,101,123,0,,0,0.0,0.0,0.0,0.0,0.0
2024,7,16,2,2024-07-16,AS,2799,ATL,DFW,"Atlanta, GA",Georgia,"Dallas/Fort Worth, TX",Texas,1152,1933,-9,-15,1143,1918,24,5,1167,1913,1682,210,230,239,0,,0,0.0,0.0,0.0,0.0,0.0
2024,5,13,1,2024-05-13,OO,6017,SFO,MCO,"San Francisco, CA",California,"Orlando, FL",Florida,1404,1298,-11,-5,1393,1293,6,18,1399,1275,2042,259,279,283,0,,0,0.0,0.0,0.0,0.0,0.0
2024,3,7,4,2024-03-07,WN,7617,LAS,PHX,"Las Vegas, NV",Nevada,"Phoenix, AZ",Arizona,1540,1042,-8,0,1532,1042,8,4,1540,1038,612,71,91,83,0,,0,0.0,0.0,0.0,0.0,0.0
2024,6,27,4,2024-06-27,MQ,1119,CLT,HNL,"Charlotte, NC",North Carolina,"Honolulu, HI",Hawaii,1106,1859,-12,-20,1094,1839,20,11,1114,1828,1755,211,231,242,0,,0,0.0,0.0,0.0,0.0,0.0
2024,2,11,7,2024-02-11,YX,3125,TPA,PHX,"Tampa, FL",Florida,"Phoenix, AZ",Arizona,1245,2297,10,10,1255,2307,12,8,1267,2299,1514,194,214,214,0,,0,0.0,0.0,0.0,0.0,0.0
2024,1,15,1,2024-01-15,AA,3628,ORD,LGA,"Chicago, IL",Illinois,"New York, NY",New York,1439,1184,-11,-15,1428,1169,19,12,1447,1157,1313,166,186,197,0,,0,0.0,0.0,0.0,0.0,0.0
2024,4,20,6,2024-04-20,B6,3986,CLT,DCA,"Charlotte, NC",North Carolina,"Washington, DC",District of Columbia,1824,1853,-29,-20,1795,1833,20,19,1815,1814,570,76,96,115,0,,0,0.0,0.0,0.0,0.0,0.0
2024,6,5,3,2024-06-05,OO,6331,DFW,DEN,"Dallas/Fort Worth, TX",Texas,"Denver, CO",Colorado,587,853,-24,-20,563,833,22,7,585,826,1819,221,241,250,0,,0,0.0,0.0,0.0,0.0,0.0
2024,10,15,2,2024-10-15,G4,5282,PHL,BOS,"Philadelphia, PA",Pennsylvania,"Boston, MA",Massachusetts,1062,1551,12,5,1074,1556,26,14,1100,1542,1454,185,205,225,0,,0,0.0,0.0,0.0,0.0,0.0
2024,8,18,7,2024-08-18,MQ,5678,IAH,LAS,"Houston, TX",Texas,"Las Vegas, NV",Nevada,1768,2297,-10,0,1758,2297,14,10,1772,2287,1586,203,223,227,0,,0,0.0,0.0,0.0,0.0,0.0
2024,6,5,3,2024-06-05,F9,6829,CLT,SFO,"Charlotte, NC",North Carolina,"San Francisco, CA",California,1990,954,-18,-15,1972,939,23,14,1995,925,1776,212,232,249,0,,0,0.0,0.0,0.0,0.0,0.0
2024,2,7,3,2024-02-07,F9,7061,IAH,MIA,"Houston, TX",Texas,"Miami, FL",Florida,1965,2118,15,10,1980,2128,18,14,1998,2114,2998,371,391,403,0,,0,0.0,0.0,0.0,0.0,0.0
2024,4,6,6,2024-04-06,B6,6113,SFO,DEN,"San Francisco, CA",California,"Denver, CO",Colorado,1636,1009,-6,-10,1630,999,23,12,1653,987,1395,183,203,218,0,,0,0.0,0.0,0.0,0.0,0.0
2024,10,15,2,2024-10-15,YX,896,JFK,MSP,"New York, NY",New York,"Minneapolis, MN",Minnesota,941,1822,-12,-5,929,1817,26,15,955,1802,499,56,76,97,0,,0,0.0,0.0,0.0,0.0,0.0
2024,9,10,2,2024-09-10,G4,2057,MCO,CLT,"Orlando, FL",Florida,"Charlotte, NC",North Carolina,1531,1028,-8,-10,1523,1018,18,3,1541,1015,2904,359,379,380,0,,0,0.0,0.0,0.0,0.0,0.0
2024,7,14,7,2024-07-14,UA,3166,SLC,PHL,"Salt Lake City, UT",Utah,"Philadelphia, PA",Pennsylvania,2072,1074,16,15,2088,1089,7,4,2095,1085,2111,262,282,273,0,,0,0.0,0.0,0.0,0.0,0.0
2024,3,26,2,2024-03-26,UA,2780,MCO,STL,"Orlando, FL",Florida,"St. Louis, MO",Missouri,1058,1187,3,5,1061,1192,18,17,1079,1175,1849,236,256,271,0,,0,0.0,0.0,0.0,0.0,0.0
2024,11,17,7,2024-11-17,AA,4541,HNL,CLT,"Honolulu, HI",Hawaii,"Charlotte, NC",North Carolina,1623,1576,7,5,1630,1581,6,12,1636,1569,2850,350,370,368,0,,0,0.0,0.0,0.0,0.0,0.0
2024,1,10,3,2024-01-10,G4,3048,DEN,BWI,"Denver, CO",Colorado,"Baltimore, MD",Maryland,1868,1516,-20,-20,1848,1496,6,3,1854,1493,1714,223,243,232,0,,0,0.0,0.0,0.0,0.0,0.0
2024,1,5,5,2024-01-05,AS,3831,DFW,JFK,"Dallas/Fort Worth, TX",Texas,"New York, NY",New York,2208,941,1,0,2209,941,7,3,2216,938,1201,150,170,160,0,,0,0.0,0.0,0.0,0.0,0.0
2024,5,2,4,2024-05-02,DL,1201,SFO,ATL,"San Francisco, CA",California,"Atlanta, GA",Georgia,1252,1073,-7,0,1245,1073,6,14,1251,1059,1959,251,271,271,0,,0,0.0,0.0,0.0,0.0,0.0
2024,11,25,1,2024-11-25,F9,5584,SFO,EWR,"San Francisco, CA",California,"Newark, NJ",New Jersey,1400,996,-13,-5,1387,991,10,10,1397,981,2738,351,371,371,0,,0,0.0,0.0,0.0,0.0,0.0
2024,12,18,3,2024-12-18,YX,9329,PHL,DEN,"Philadelphia, PA",Pennsylvania,"Denver, CO",Colorado,980,2049,-11,-5,969,2044,8,11,977,2033,350,45,65,64,0,,0,0.0,0.0,0.0,0.0,0.0
2024,4,27,6,2024-04-27,G4,4331,MSP,BOS,"Minneapolis, MN",Minnesota,"Boston, MA",Massachusetts,1202,1668,5,10,1207,1678,5,4,1212,1674,237,37,57,46,0,,0,0.0,0.0,0.0,0.0,0.0
2024,10,20,7,2024-10-20,G4,9083,LAX,TPA,"Los Angeles, CA",California,"Tampa, FL",Florida,1865,1966,-27,-20,1838,1946,7,18,1845,1928,2416,303,323,328,0,,0,0.0,0.0,0.0,0.0,0.0
2024,6,7,5,2024-06-07,DL,1081,BWI,CLT,"Baltimore, MD",Maryland,"Charlotte, NC",North Carolina,1442,1290,-10,0,1432,1290,20,16,1452,1274,1254,163,183,199,0,,0,0.0,0.0,0.0,0.0,0.0
2024,10,29,2,2024-10-29,DL,9557,STL,BWI,"St. Louis, MO",Missouri,"Baltimore, MD",Maryland,1757,1333,-11,-5,1746,1328,19,3,1765,1325,599,78,98,100,0,,0,0.0,0.0,0.0,0.0,0.0
2024,8,15,4,2024-08-15,MQ,5270,DCA,MCO,"Washington, DC",District of Columbia,"Orlando, FL",Florida,1292,1640,-4,5,1288,1645,15,16,1303,1629,1098,132,152,163,0,,0,0.0,0.0,0.0,0.0,0.0
2024,12,30,1,2024-12-30,NK,9035,IAD,IAH,"Washington, DC",District of Columbia,"Houston, TX",Texas,1758,818,-7,-10,1751,808,23,19,1774,789,1082,134,154,176,0,,0,0.0,0.0,0.0,0.0,0.0
2024,8,3,6,2024-08-03,OO,2531,BOS,PHL,"Boston, MA",Massachusetts,"Philadelphia, PA",Pennsylvania,625,1195,-10,-10,615,1185,8,8,623,1177,855,112,132,128,0,,0,0.0,0.0,0.0,0.0,0.0
2024,7,2,2,2024-07-02,WN,8666,PHL,PHX,"Philadelphia, PA",Pennsylvania,"Phoenix, AZ",Arizona,1189,790,-2,0,1187,790,26,10,1213,780,1803,224,244,260,0,,0,0.0,0.0,0.0,0.0,0.0
2024,1,15,1,2024-01-15,MQ,6449,MCO,IAD,"Orlando, FL",Florida,"Washington, DC",District of Columbia,976,2014,17,20,993,2034,5,10,998,2024,2316,282,302,297,0,,0,0.0,4.0,0.0,0.0,16.0
2024,6,5,3,2024-06-05,AA,3997,LAS,MIA,"Las Vegas, NV",Nevada,"Miami, FL",Florida,1184,2062,16,20,1200,2082,6,10,1206,2072,1443,177,197,193,0,,0,3.0,5.0,3.0,0.0,9.0
2024,5,15,3,2024-05-15,F9,7648,EWR,MDW,"Newark, NJ",New Jersey,"Chicago, IL",Illinois,871,1243,-6,-10,865,1233,14,4,879,1229,1009,120,140,138,0,,0,0.0,0.0,0.0,0.0,0.0
2024,9,17,2,2024-09-17,DL,2091,STL,BWI,"St. Louis, MO",Missouri,"Baltimore, MD",Maryland,1643,2120,-17,-15,1626,2105,7,18,1633,2087,391,56,76,81,0,,0,0.0,0.0,0.0,0.0,0.0
2024,6,5,3,2024-06-05,OH,3028,DCA,DTW,"Washington, DC",District of Columbia,"Detroit, MI",Michigan,1041,693,-1,0,1040,693,25,15,1065,678,2373,303,323,343,0,,0,0.0,0.0,0.0,0.0,0.0
2024,2,16,5,2024-02-16,UA,5530,IAH,LAX,"Houston, TX",Texas,"Los Angeles, CA",California,1059,1718,2,-5,1061,1713,27,16,1088,1697,1754,224,244,267,0,,0,0.0,0.0,0.0,0.0,0.0
2024,11,19,2,2024-11-19,B6,3546,SEA,BOS,"Seattle, WA",Washington,"Boston, MA",Massachusetts,678,2319,13,5,691,2324,21,9,712,2315,2848,349,369,379,0,,0,0.0,0.0,0.0,0.0,0.0
2024,11,27,3,2024-11-27,OH,6875,DEN,JFK,"Denver, CO",Colorado,"New York, NY",New York,1617,2267,-9,0,1608,2267,16,5,1624,2262,794,95,115,116,0,,0,0.0,0.0,0.0,0.0,0.0
2024,6,21,5,2024-06-21,UA,8883,MSP,MIA,"Minneapolis, MN",Minnesota,"Miami, FL",Florida,1066,1705,3,0,1069,1705,6,10,1075,1695,1541,189,209,205,0,,0,0.0,0.0,0.0,0.0,0.0
2024,5,9,4,2024-05-09,NK,5261,SAN,PDX,"San Diego, CA",California,"Portland, OR",Oregon,1247,939,-1,0,1246,939,17,3,1263,936,458,61,81,81,0,,0,0.0,0.0,0.0,0.0,0.0
2024,4,4,4,2024-04-04,NK,2669,STL,DEN,"St. Louis, MO",Missouri,"Denver, CO",Colorado,1450,1407,-21,-15,1429,1392,8,19,1437,1373,2977,370,390,397,0,,0,0.0,0.0,0.0,0.0,0.0
2024,4,24,3,2024-04-24,OH,2972,STL,DCA,"St. Louis, MO",Missouri,"Washington, DC",District of Columbia,801,959,-1,5,800,964,19,10,819,954,1638,200,220,229,0,,0,0.0,0.0,0.0,0.0,0.0
2024,8,30,5,2024-08-30,DL,9468,PHX,IAD,"Phoenix, AZ",Arizona,"Washington, DC",District of Columbia,1941,711,-9,0,1932,711,21,8,1953,703,2010,249,269,278,0,,0,0.0,0.0,0.0,0.0,0.0
2024,10,18,5,2024-10-18,MQ,1435,LAX,JFK,"Los Angeles, CA",California,"New York, NY",New York,1085,902,12,10,1097,912,15,13,1112,899,1854,240,260,268,0,,0,0.0,0.0,0.0,0.0,0.0
2024,10,8,2,2024-10-08,MQ,5513,ATL,SAN,"Atlanta, GA",Georgia,"San Diego, CA",California,1975,650,-19,-15,1956,635,5,10,1961,625,920,105,125,120,0,,0,0.0,0.0,0.0,0.0,0.0
2024,10,25,5,2024-10-25,NK,212,SFO,ORD,"San Francisco, CA",California,"Chicago, IL",Illinois,1940,1405,-1,-5,1939,1400,29,10,1968,1390,520,61,81,100,0,,0,0.0,0.0,0.0,0.0,0.0
2024,10,9,3,2024-10-09,OO,3872,STL,PHL,"St. Louis, MO",Missouri,"Philadelphia, PA",Pennsylvania,1645,1300,24,20,1669,1320,26,12,1695,1308,1020,118,138,156,0,,0,1.0,3.0,1.0,0.0,15.0
2024,3,9,6,2024-03-09,AS,5394,MCO,DCA,"Orlando, FL",Florida,"Washington, DC",District of Columbia,556,2343,-5,0,551,2343,6,12,557,2331,2004,254,274,272,0,,0,0.0,0.0,0.0,0.0,0.0
2024,5,27,1,2024-05-27,9E,2087,JFK,ATL,"New York, NY",New York,"Atlanta, GA",Georgia,1523,1260,11,15,1534,1275,14,15,1548,1260,1794,223,243,252,0,,0,0.0,0.0,0.0,0.0,0.0
2024,1,11,4,2024-01-11,G4,4929,PHX,STL,"Phoenix, AZ",Arizona,"St. Louis, MO",Missouri,1662,1904,-2,5,1660,1909,11,5,1671,1904,211,24,44,40,0,,0,0.0,0.0,0.0,0.0,0.0
2024,9,10,2,2024-09-10,MQ,2085,BOS,LGA,"Boston, MA",Massachusetts,"New York, NY",New York,1722,1736,8,15,1730,1751,26,19,1756,1732,2335,296,316,341,0,,0,0.0,0.0,0.0,0.0,0.0
2024,11,25,1,2024-11-25,G4,5191,MSP,LAS,"Minneapolis, MN",Minnesota,"Las Vegas, NV",Nevada,1220,635,-15,-5,1205,630,15,17,1220,613,2345,288,308,320,0,,0,0.0,0.0,0.0,0.0,0.0
2024,12,25,3,2024-12-25,DL,352,IAH,DCA,"Houston, TX",Texas,"Washington, DC",District of Columbia,1884,1222,-15,-15,1869,1207,26,8,1895,1199,607,76,96,110,0,,0,0.0,0.0,0.0,0.0,0.0
2024,2,7,3,2024-02-07,NK,8415,LGA,PHX,"New York, NY",New York,"Phoenix, AZ",Arizona,2173,1282,4,10,2177,1292,28,19,2205,1273,2161,267,287,314,0,,0,0.0,0.0,0.0,0.0,0.0
2024,5,13,1,2024-05-13,B6,9528,LAX,LAS,"Los Angeles, CA",California,"Las Vegas, NV",Nevada,909,1701,1,10,910,1711,23,3,933,1708,1616,200,220,226,0,,0,0.0,0.0,0.0,0.0,0.0
2024,7,18,4,2024-07-18,MQ,723,SFO,BOS,"San Francisco, CA",California,"Boston, MA",Massachusetts,1145,1448,-6,0,1139,1448,14,5,1153,1443,1911,234,254,253,0,,0,0.0,0.0,0.0,0.0,0.0
2024,1,23,2,2024-01-23,AS,3256,LAS,IAD,"Las Vegas, NV",Nevada,"Washington, DC",District of Columbia,2051,2163,-6,0,2045,2163,6,10,2051,2153,267,36,56,52,0,,0,0.0,0.0,0.0,0.0,0.0
2024,10,29,2,2024-10-29,AA,3489,DEN,TPA,"Denver, CO",Colorado,"Tampa, FL",Florida,2138,1559,24,15,2162,1574,18,10,2180,1564,1887,235,255,263,0,,0,0.0,0.0,0.0,0.0,0.0
2024,12,11,3,2024-12-11,NK,3517,HNL,SEA,"Honolulu, HI",Hawaii,"Seattle, WA",Washington,1766,644,-8,-10,1758,634,29,13,1787,621,1582,198,218,240,0,,0,0.0,0.0,0.0,0.0,0.0
2024,10,28,1,2024-10-28,AS,9947,PDX,SFO,"Portland, OR",Oregon,"San Francisco, CA",California,1613,1472,1,0,1614,1472,25,18,1639,1454,544,76,96,119,0,,0,0.0,0.0,0.0,0.0,0.0
2024,12,28,6,2024-12-28,WN,9558,PHL,SFO,"Philadelphia, PA",Pennsylvania,"San Francisco, CA",California,2039,1551,-21,-20,2018,1531,26,3,2044,1528,900,111,131,140,0,,0,0.0,0.0,0.0,0.0,0.0
2024,8,5,1,2024-08-05,AA,3045,ATL,EWR,"Atlanta, GA",Georgia,"Newark, NJ",New Jersey,561,1927,-13,-15,548,1912,11,13,559,1899,2367,303,323,327,0,,0,0.0,0.0,0.0,0.0,0.0
2024,5,20,1,2024-05-20,G4,9452,DEN,CLT,"Denver, CO",Colorado,"Charlotte, NC",North Carolina,1735,2015,-7,-5,1728,2010,17,19,1745,1991,2513,316,336,352,0,,0,0.0,0.0,0.0,0.0,0.0
2024,4,13,6,2024-04-13,WN,8732,HNL,MCO,"Honolulu, HI",Hawaii,"Orlando, FL",Florida,747,1253,4,10,751,1263,6,15,757,1248,781,89,109,110,0,,0,0.0,0.0,0.0,0.0,0.0
2024,7,28,7,2024-07-28,DL,2192,SFO,ORD,"San Francisco, CA",California,"Chicago, IL",Illinois,2227,614,0,5,2227,619,10,4,2237,615,2491,316,336,330,0,,0,0.0,0.0,0.0,0.0,0.0
2024,4,20,6,2024-04-20,F9,2805,DCA,JFK,"Washington, DC",District of Columbia,"New York, NY",New York,996,1239,26,20,1022,1259,5,7,1027,1252,1693,205,225,217,0,,0,5.0,3.0,2.0,0.0,10.0
2024,4,13,6,2024-04-13,DL,3859,MSP,LAX,"Minneapolis, MN",Minnesota,"Los Angeles, CA",California,555,766,-26,-20,529,746,29,14,558,732,1438,176,196,219,0,,0,0.0,0.0,0.0,0.0,0.0
2024,11,11,1,2024-11-11,B6,5212,PDX,SAN,"Portland, OR",Oregon,"San Diego, CA",California,958,2288,-5,-5,953,2283,26,17,979,2266,673,74,94,117,0,,0,0.0,0.0,0.0,0.0,0.0
2024,6,19,3,2024-06-19,OO,653,SAN,DCA,"San Diego, CA",California,"Washington, DC",District of Columbia,1418,662,-15,-10,1403,652,15,9,1418,643,2773,349,369,373,0,,0,0.0,0.0,0.0,0.0,0.0
2024,12,21,6,2024-12-21,AS,5004,LAS,EWR,"Las Vegas, NV",Nevada,"Newark, NJ",New Jersey,1812,2194,-22,-20,1790,2174,11,8,1801,2166,2565,329,349,348,0,,0,0.0,0.0,0.0,0.0,0.0
2024,11,19,2,2024-11-19,OO,1212,CLT,BOS,"Charlotte, NC",North Carolina,"Boston, MA",Massachusetts,2066,802,-9,-10,2057,792,9,7,2066,785,1479,178,198,194,0,,0,0.0,0.0,0.0,0.0,0.0
2024,5,12,7,2024-05-12,MQ,2877,CLT,STL,"Charlotte, NC",North Carolina,"St. Louis, MO",Missouri,1993,1780,-17,-10,1976,1770,22,17,1998,1753,1043,135,155,174,0,,0,0.0,0.0,0.0,0.0,0.0
2024,10,19,6,2024-10-19,F9,7197,DEN,SFO,"Denver, CO",Colorado,"San Francisco, CA",California,1912,2138,2,-5,1914,2133,24,5,1938,2128,1016,117,137,146,0,,0,0.0,0.0,0.0,0.0,0.0
2024,11,23,6,2024-11-23,OO,1414,SEA,DFW,"Seattle, WA",Washington,"Dallas/Fort Worth, TX",Texas,1944,2174,-11,-15,1933,2159,16,11,1949,2148,2071,250,270,277,0,,0,0.0,0.0,0.0,0.0,0.0
2024,5,6,1,2024-05-06,AA,3593,PHX,MSP,"Phoenix, AZ",Arizona,"Minneapolis, MN",Minnesota,2036,877,-7,0,2029,877,25,19,2054,858,1395,166,186,210,0,,0,0.0,0.0,0.0,0.0,0.0
2024,4,15,1,2024-04-15,AA,8390,EWR,MSP,"Newark, NJ",New Jersey,"Minneapolis, MN",Minnesota,2233,1724,18,15,2251,1739,22,16,2273,1723,1045,130,150,168,0,,0,0.0,0.0,0.0,0.0,0.0
2024,4,1,1,2024-04-01,YX,7573,PHL,DFW,"Philadelphia, PA",Pennsylvania,"Dallas/Fort Worth, TX",Texas,1056,1494,12,5,1068,1499,13,9,1081,1490,574,71,91,93,0,,0,0.0,0.0,0.0,0.0,0.0
2024,10,13,7,2024-10-13,WN,7115,ATL,PHL,"Atlanta, GA",Georgia,"Philadelphia, PA",Pennsylvania,2082,1792,16,10,2098,1802,6,17,2104,1785,774,105,125,128,0,,0,0.0,0.0,0.0,0.0,0.0
2024,2,20,2,2024-02-20,B6,9771,IAH,BWI,"Houston, TX",Texas,"Baltimore, MD",Maryland,1463,2155,1,10,1464,2165,22,9,1486,2156,479,53,73,84,0,,0,0.0,0.0,0.0,0.0,0.0
2024,1,29,1,2024-01-29,MQ,5810,PDX,BOS,"Portland, OR",Oregon,"Boston, MA",Massachusetts,2257,1002,3,-5,2260,997,6,15,2266,982,967,121,141,142,0,,0,0.0,0.0,0.0,0.0,0.0
2024,10,22,2,2024-10-22,HA,1322,DCA,LGA,"Washington, DC",District of Columbia,"New York, NY",New York,1604,1764,8,5,1612,1769,6,16,1618,1753,793,94,114,116,0,,0,0.0,0.0,0.0,0.0,0.0
2024,10,23,3,2024-10-23,MQ,4683,MSP,IAH,"Minneapolis, MN",Minnesota,"Houston, TX",Texas,943,946,-2,5,941,951,25,13,966,938,803,105,125,143,0,,0,0.0,0.0,0.0,0.0,0.0
2024,8,1,4,2024-08-01,G4,5620,LAX,IAD,"Los Angeles, CA",California,"Washington, DC",District of Columbia,1291,1386,-19,-10,1272,1376,18,15,1290,1361,2976,367,387,400,0,,0,0.0,0.0,0.0,0.0,0.0
2024,9,23,1,2024-09-23,OO,7972,STL,EWR,"St. Louis, MO",Missouri,"Newark, NJ",New Jersey,1810,1575,12,10,1822,1585,11,14,1833,1571,2671,331,351,356,0,,0,0.0,0.0,0.0,0.0,0.0
2024,9,13,5,2024-09-13,OH,9296,SAN,DCA,"San Diego, CA",California,"Washington, DC",District of Columbia,1807,1433,-4,0,1803,1433,5,4,1808,1429,2766,344,364,353,0,,0,0.0,0.0,0.0,0.0,0.0
2024,10,28,1,2024-10-28,NK,8768,SAN,CLT,"San Diego, CA",California,"Charlotte, NC",North Carolina,990,792,-23,-20,967,772,13,12,980,760,1716,217,237,242,0,,0,0.0,0.0,0.0,0.0,0.0
2024,4,10,3,2024-04-10,NK,5531,LAS,ORD,"Las Vegas, NV",Nevada,"Chicago, IL",Illinois,1911,1498,-1,0,1910,1498,26,13,1936,1485,2751,347,367,386,0,,0,0.0,0.0,0.0,0.0,0.0
2024,12,11,3,2024-12-11,F9,9427,SAN,MIA,"San Diego, CA",California,"Miami, FL",Florida,2224,751,-3,5,2221,756,16,18,2237,738,1683,206,226,240,0,,0,0.0,0.0,0.0,0.0,0.0
2024,4,19,5,2024-04-19,HA,1805,DFW,SAN,"Dallas/Fort Worth, TX",Texas,"San Diego, CA",California,2074,985,-7,0,2067,985,5,19,2072,966,627,87,107,111,0,,0,0.0,0.0,0.0,0.0,0.0
2024,6,30,7,2024-06-30,B6,617,IAD,HNL,"Washington, DC",District of Columbia,"Honolulu, HI",Hawaii,1094,1831,-15,-10,1079,1821,5,16,1084,1805,1726,209,229,230,0,,0,0.0,0.0,0.0,0.0,0.0
2024,11,8,5,2024-11-08,B6,1320,PHL,DCA,"Philadelphia, PA",Pennsylvania,"Washington, DC",District of Columbia,907,1588,9,0,916,1588,13,15,929,1573,2356,290,310,318,0,,0,0.0,0.0,0.0,0.0,0.0
2024,1,1,1,2024-01-01,AA,2606,ORD,BWI,"Chicago, IL",Illinois,"Baltimore, MD",Maryland,826,2172,-9,-5,817,2167,20,19,837,2148,1690,208,228,247,0,,0,0.0,0.0,0.0,0.0,0.0
2024,11,14,4,2024-11-14,OH,4425,ORD,CLT,"Chicago, IL",Illinois,"Charlotte, NC",North Carolina,1441,2011,16,20,1457,2031,29,7,1486,2024,1675,212,232,248,0,,0,2.0,3.0,1.0,0.0,14.0
2024,2,24,6,2024-02-24,G4,9483,BWI,MCO,"Baltimore, MD",Maryland,"Orlando, FL",Florida,1448,1701,16,10,1464,1711,21,6,1485,1705,2377,301,321,328,0,,0,0.0,0.0,0.0,0.0,0.0
2024,5,28,2,2024-05-28,AS,5579,DCA,PHX,"Washington, DC",District of Columbia,"Phoenix, AZ",Arizona,1699,771,0,5,1699,776,5,13,1704,763,2719,345,365,363,0,,0,0.0,0.0,0.0,0.0,0.0
2024,11,4,1,2024-11-04,G4,7536,HNL,STL,"Honolulu, HI",Hawaii,"St. Louis, MO",Missouri,2044,2180,-2,-10,2042,2170,9,19,2051,2151,244,39,59,67,0,,0,0.0,0.0,0.0,0.0,0.0
2024,5,16,4,2024-05-16,UA,3190,CLT,MIA,"Charlotte, NC",North Carolina,"Miami, FL",Florida,882,936,2,-5,884,931,20,5,904,926,1695,216,236,241,0,,0,0.0,0.0,0.0,0.0,0.0
2024,7,20,6,2024-07-20,B6,6597,BWI,DCA,"Baltimore, MD",Maryland,"Washington, DC",District of Columbia,1513,2219,-4,-5,1509,2214,9,4,1518,2210,1474,182,202,195,0,,0,0.0,0.0,0.0,0.0,0.0
2024,11,8,5,2024-11-08,DL,5268,MCO,MDW,"Orlando, FL",Florida,"Chicago, IL",Illinois,1781,1491,8,0,1789,1491,11,3,1800,1488,2448,306,326,320,0,,0,0.0,0.0,0.0,0.0,0.0
2024,4,26,5,2024-04-26,9E,7093,JFK,IAH,"New York, NY",New York,"Houston, TX",Texas,846,2054,-20,-20,826,2034,24,18,850,2016,1742,210,230,252,0,,0,0.0,0.0,0.0,0.0,0.0
2024,6,2,7,2024-06-02,B6,1073,PHX,MSP,"Phoenix, AZ",Arizona,"Minneapolis, MN",Minnesota,771,1204,6,0,777,1204,21,13,798,1191,228,19,39,53,0,,0,0.0,0.0,0.0,0.0,0.0
2024,10,17,4,2024-10-17,HA,5377,BWI,PHX,"Baltimore, MD",Maryland,"Phoenix, AZ",Arizona,1784,1088,-13,-5,1771,1083,10,9,1781,1074,1706,204,224,223,0,,0,0.0,0.0,0.0,0.0,0.0
2024,3,3,7,2024-03-03,MQ,8357,PHX,IAH,"Phoenix, AZ",Arizona,"Houston, TX",Texas,895,1265,4,0,899,1265,7,7,906,1258,1887,239,259,253,0,,0,0.0,0.0,0.0,0.0,0.0
2024,8,31,6,2024-08-31,MQ,6192,SAN,BWI,"San Diego, CA",California,"Baltimore, MD",Maryland,2215,705,-26,-20,2189,685,11,6,2200,679,2570,318,338,335,0,,0,0.0,0.0,0.0,0.0,0.0
2024,1,25,4,2024-01-25,MQ,3006,MDW,DTW,"Chicago, IL",Illinois,"Detroit, MI",Michigan,653,1469,-12,-5,641,1464,18,10,659,1454,2504,318,338,346,0,,0,0.0,0.0,0.0,0.0,0.0
2024,3,30,6,2024-03-30,HA,670,CLT,DEN,"Charlotte, NC",North Carolina,"Denver, CO",Colorado,2050,1832,-5,5,2045,1837,21,8,2066,1829,808,98,118,127,0,,0,0.0,0.0,0.0,0.0,0.0
2024,3,15,5,2024-03-15,OH,407,PDX,IAH,"Portland, OR",Oregon,"Houston, TX",Texas,1590,2339,-8,0,1582,2339,18,3,1600,2336,2619,321,341,342,0,,0,0.0,0.0,0.0,0.0,0.0
2024,10,20,7,2024-10-20,F9,3842,MDW,STL,"Chicago, IL",Illinois,"St. Louis, MO",Missouri,1340,1971,4,5,1344,1976,24,9,1368,1967,1653,206,226,239,0,,0,0.0,0.0,0.0,0.0,0.0
2024,7,28,7,2024-07-28,OO,9074,MCO,SFO,"Orlando, FL",Florida,"San Francisco, CA",California,2222,951,7,5,2229,956,16,8,2245,948,1522,184,204,208,0,,0,0.0,0.0,0.0,0.0,0.0
2024,12,12,4,2024-12-12,DL,865,MCO,MDW,"Orlando, FL",Florida,"Chicago, IL",Illinois,847,1447,6,10,853,1457,13,3,866,1454,1105,135,155,151,0,,0,0.0,0.0,0.0,0.0,0.0
2024,1,17,3,2024-01-17,F9,9064,DFW,BOS,"Dallas/Fort Worth, TX",Texas,"Boston, MA",Massachusetts,1586,647,-17,-20,1569,627,10,9,1579,618,2838,359,379,378,0,,0,0.0,0.0,0.0,0.0,0.0
2024,5,7,2,2024-05-07,WN,7914,SEA,LGA,"Seattle, WA",Washington,"New York, NY",New York,855,1869,-8,-10,847,1859,6,16,853,1843,2834,349,369,371,0,,0,0.0,0.0,0.0,0.0,0.0
2024,12,29,7,2024-12-29,9E,7835,MIA,IAD,"Miami, FL",Florida,"Washington, DC",District of Columbia,1804,630,-6,0,1798,630,10,8,1808,622,2757,339,359,357,0,,0,0.0,0.0,0.0,0.0,0.0
2024,9,7,6,2024-09-07,9E,8136,SFO,HNL,"San Francisco, CA",California,"Honolulu, HI",Hawaii,1564,2318,15,15,1579,2333,13,12,1592,2321,1199,145,165,170,0,,0,0.0,0.0,0.0,0.0,0.0
2024,6,27,4,2024-06-27,HA,7696,MDW,DTW,"Chicago, IL",Illinois,"Detroit, MI",Michigan,2063,1074,8,5,2071,1079,15,18,2086,1061,2692,343,363,376,0,,0,0.0,0.0,0.0,0.0,0.0
2024,6,30,7,2024-06-30,AA,639,LGA,JFK,"New York, NY",New York,"New York, NY",New York,866,1076,-10,0,856,1076,5,14,861,1062,2215,268,288,287,0,,0,0.0,0.0,0.0,0.0,0.0
2024,5,31,5,2024-05-31,MQ,8085,CLT,BOS,"Charlotte, NC",North Carolina,"Boston, MA",Massachusetts,1514,1880,-21,-15,1493,1865,16,13,1509,1852,2285,288,308,317,0,,0,0.0,0.0,0.0,0.0,0.0
2024,1,25,4,2024-01-25,B6,2149,LGA,MDW,"New York, NY",New York,"Chicago, IL",Illinois,776,1749,-8,0,768,1749,9,10,777,1739,1883,241,261,260,0,,0,0.0,0.0,0.0,0.0,0.0
2024,6,28,5,2024-06-28,MQ,3383,LAX,SEA,"Los Angeles, CA",California,"Seattle, WA",Washington,720,818,-15,-5,705,813,17,17,722,796,2599,323,343,357,0,,0,0.0,0.0,0.0,0.0,0.0
2024,7,16,2,2024-07-16,AA,4775,SLC,CLT,"Salt Lake City, UT",Utah,"Charlotte, NC",North Carolina,2252,844,11,5,2263,849,28,14,2291,835,2703,342,362,384,0,,0,0.0,0.0,0.0,0.0,0.0
2024,12,9,1,2024-12-09,NK,1763,MCO,SFO,"Orlando, FL",Florida,"San Francisco, CA",California,2257,2103,4,-5,2261,2098,19,9,2280,2089,2859,366,386,394,0,,0,0.0,0.0,0.0,0.0,0.0
2024,6,9,7,2024-06-09,F9,6576,ATL,HNL,"Atlanta, GA",Georgia,"Honolulu, HI",Hawaii,560,1042,-4,-5,556,1037,17,18,573,1019,2633,337,357,372,0,,0,0.0,0.0,0.0,0.0,0.0
2024,6,25,2,2024-06-25,UA,9339,BOS,PHL,"Boston, MA",Massachusetts,"Philadelphia, PA",Pennsylvania,1626,2274,-13,-15,1613,2259,27,6,1640,2253,695,87,107,120,0,,0,0.0,0.0,0.0,0.0,0.0
2024,10,11,5,2024-10-11,UA,3539,IAD,MSP,"Washington, DC",District of Columbia,"Minneapolis, MN",Minnesota,1708,1100,-25,-20,1683,1080,6,3,1689,1077,699,90,110,99,0,,0,0.0,0.0,0.0,0.0,0.0
2024,3,3,7,2024-03-03,NK,8797,HNL,SFO,"Honolulu, HI",Hawaii,"San Francisco, CA",California,1670,1850,-13,-5,1657,1845,28,3,1685,1842,2857,357,377,388,0,,0,0.0,0.0,0.0,0.0,0.0
2024,5,29,3,2024-05-29,WN,7243,HNL,DFW,"Honolulu, HI",Hawaii,"Dallas/Fort Worth, TX",Texas,574,1497,-5,-5,569,1492,13,17,582,1475,1362,160,180,190,0,,0,0.0,0.0,0.0,0.0,0.0
2024,6,2,7,2024-06-02,UA,3347,DEN,LGA,"Denver, CO",Colorado,"New York, NY",New York,972,1368,0,0,972,1368,28,16,1000,1352,789,97,117,141,0,,0,0.0,0.0,0.0,0.0,0.0
2024,6,4,2,2024-06-04,HA,3600,SAN,PDX,"San Diego, CA",California,"Portland, OR",Oregon,1524,854,4,5,1528,859,26,17,1554,842,1689,211,231,254,0,,0,0.0,0.0,0.0,0.0,0.0
2024,2,18,7,2024-02-18,F9,2010,LAS,PHX,"Las Vegas, NV",Nevada,"Phoenix, AZ",Arizona,915,669,-20,-20,895,649,29,4,924,645,2001,243,263,276,0,,0,0.0,0.0,0.0,0.0,0.0
2024,12,2,1,2024-12-02,UA,832,PHX,PHL,"Phoenix, AZ",Arizona,"Philadelphia, PA",Pennsylvania,1992,1054,5,0,1997,1054,12,18,2009,1036,2526,322,342,352,0,,0,0.0,0.0,0.0,0.0,0.0
2024,3,24,7,2024-03-24,MQ,3613,BOS,DFW,"Boston, MA",Massachusetts,"Dallas/Fort Worth, TX",Texas,1888,1177,19,10,1907,1187,8,7,1915,1180,543,67,87,82,0,,0,0.0,0.0,0.0,0.0,0.0
2024,12,26,4,2024-12-26,OH,9863,PHX,BWI,"Phoenix, AZ",Arizona,"Baltimore, MD",Maryland,2197,1625,-1,0,2196,1625,19,13,2215,1612,1267,155,175,187,0,,0,0.0,0.0,0.0,0.0,0.0
2024,6,25,2,2024-06-25,NK,4709,LAS,TPA,"Las Vegas, NV",Nevada,"Tampa, FL",Florida,516,1094,1,0,517,1094,26,13,543,1081,2096,258,278,297,0,,0,0.0,0.0,0.0,0.0,0.0
2024,5,27,1,2024-05-27,DL,4556,BWI,DFW,"Baltimore, MD",Maryland,"Dallas/Fort Worth, TX",Texas,2033,924,8,0,2041,924,9,3,2050,921,2687,341,361,353,0,,0,0.0,0.0,0.0,0.0,0.0
2024,4,27,6,2024-04-27,OO,3435,SLC,SEA,"Salt Lake City, UT",Utah,"Seattle, WA",Washington,2278,1380,-7,-5,2271,1375,14,4,2285,1371,1123,135,155,153,0,,0,0.0,0.0,0.0,0.0,0.0
2024,12,7,6,2024-12-07,OO,8268,DFW,MCO,"Dallas/Fort Worth, TX",Texas,"Orlando, FL",Florida,1962,1002,-22,-15,1940,987,13,3,1953,984,1399,173,193,189,0,,0,0.0,0.0,0.0,0.0,0.0
2024,3,3,7,2024-03-03,AA,7156,PHL,SAN,"Philadelphia, PA",Pennsylvania,"San Diego, CA",California,2054,1450,-11,-15,2043,1435,8,5,2051,1430,1222,153,173,166,0,,0,0.0,0.0,0.0,0.0,0.0
2024,7,7,7,2024-07-07,YX,2853,STL,MDW,"St. Louis, MO",Missouri,"Chicago, IL",Illinois,1582,728,-14,-10,1568,718,5,3,1573,715,775,87,107,95,0,,0,0.0,0.0,0.0,0.0,0.0
2024,12,25,3,2024-12-25,AS,1472,STL,LAX,"St. Louis, MO",Missouri,"Los Angeles, CA",California,2236,2106,-1,5,2235,2111,15,19,2250,2092,2550,320,340,354,0,,0,0.0,0.0,0.0,0.0,0.0
2024,2,18,7,2024-02-18,F9,9736,HNL,DTW,"Honolulu, HI",Hawaii,"Detroit, MI",Michigan,1638,745,-2,-10,1636,735,29,4,1665,731,694,88,108,121,0,,0,0.0,0.0,0.0,0.0,0.0
2024,11,22,5,2024-11-22,AA,3476,EWR,CLT,"Newark, NJ",New Jersey,"Charlotte, NC",North Carolina,702,2248,19,15,721,2263,15,16,736,2247,1016,121,141,152,0,,0,0.0,0.0,0.0,0.0,0.0
2024,9,13,5,2024-09-13,MQ,8581,ORD,SLC,"Chicago, IL",Illinois,"Salt Lake City, UT",Utah,2066,1719,5,10,2071,1729,13,4,2084,1725,2057,252,272,269,0,,0,0.0,0.0,0.0,0.0,0.0
2024,8,11,7,2024-08-11,9E,163,DFW,JFK,"Dallas/Fort Worth, TX",Texas,"New York, NY",New York,1717,1100,14,5,1731,1105,27,10,1758,1095,756,99,119,136,0,,0,0.0,0.0,0.0,0.0,0.0
2024,5,20,1,2024-05-20,YX,4045,EWR,MCO,"Newark, NJ",New Jersey,"Orlando, FL",Florida,971,2079,9,5,980,2084,9,10,989,2074,257,39,59,58,0,,0,0.0,0.0,0.0,0.0,0.0
2024,8,2,5,2024-08-02,G4,429,MCO,SFO,"Orlando, FL",Florida,"San Francisco, CA",California,1629,2027,-14,-20,1615,2007,27,9,1642,1998,1074,140,160,176,0,,0,0.0,0.0,0.0,0.0,0.0
2024,7,29,1,2024-07-29,HA,4958,SLC,CLT,"Salt Lake City, UT",Utah,"Charlotte, NC",North Carolina,1378,607,8,0,1386,607,29,13,1415,594,1288,170,190,212,0,,0,0.0,0.0,0.0,0.0,0.0
2024,11,13,3,2024-11-13,UA,2063,LGA,HNL,"New York, NY",New York,"Honolulu, HI",Hawaii,1464,819,7,15,1471,834,23,9,1494,825,1605,204,224,236,0,,0,0.0,0.0,0.0,0.0,0.0
2024,2,1,4,2024-02-01,UA,3188,JFK,IAH,"New York, NY",New York,"Houston, TX",Texas,1317,1324,-13,-20,1304,1304,25,9,1329,1295,2571,325,345,359,0,,0,0.0,0.0,0.0,0.0,0.0
2024,6,6,4,2024-06-06,WN,240,LAX,IAH,"Los Angeles, CA",California,"Houston, TX",Texas,1649,701,-11,-10,1638,691,7,19,1645,672,2487,314,334,340,0,,0,0.0,0.0,0.0,0.0,0.0
2024,10,11,5,2024-10-11,OO,4639,CLT,ORD,"Charlotte, NC",North Carolina,"Chicago, IL",Illinois,913,2301,-11,-15,902,2286,12,17,914,2269,823,95,115,124,0,,0,0.0,0.0,0.0,0.0,0.0
2024,10,31,4,2024-10-31,HA,2573,SFO,ORD,"San Francisco, CA",California,"Chicago, IL",Illinois,2138,1373,7,0,2145,1373,20,9,2165,1364,1482,183,203,212,0,,0,0.0,0.0,0.0,0.0,0.0
2024,10,12,6,2024-10-12,AA,5694,PHL,DEN,"Philadelphia, PA",Pennsylvania,"Denver, CO",Colorado,2198,601,-11,-15,2187,586,21,19,2208,567,465,59,79,99,0,,0,0.0,0.0,0.0,0.0,0.0
2024,5,23,4,2024-05-23,G4,4003,DTW,MCO,"Detroit, MI",Michigan,"Orlando, FL",Florida,2033,2337,8,0,2041,2337,8,16,2049,2321,2513,317,337,341,0,,0,0.0,0.0,0.0,0.0,0.0
2024,1,19,5,2024-01-19,OO,5464,DFW,SAN,"Dallas/Fort Worth, TX",Texas,"San Diego, CA",California,1000,2113,14,5,1014,2118,27,7,1041,2111,1800,215,235,249,0,,0,0.0,0.0,0.0,0.0,0.0
2024,1,18,4,2024-01-18,UA,549,LAS,BOS,"Las Vegas, NV",Nevada,"Boston, MA",Massachusetts,620,1294,-16,-10,604,1284,19,14,623,1270,2561,319,339,352,0,,0,0.0,0.0,0.0,0.0,0.0
2024,9,13,5,2024-09-13,MQ,4546,MCO,MDW,"Orlando, FL",Florida,"Chicago, IL",Illinois,2275,1370,5,5,2280,1375,17,14,2297,1361,2578,326,346,357,0,,0,0.0,0.0,0.0,0.0,0.0
2024,3,18,1,2024-03-18,9E,4794,LAX,SEA,"Los Angeles, CA",California,"Seattle, WA",Washington,1106,1433,-17,-15,1089,1418,13,4,1102,1414,2025,253,273,270,0,,0,0.0,0.0,0.0,0.0,0.0
2024,6,23,7,2024-06-23,WN,4906,DEN,SLC,"Denver, CO",Colorado,"Salt Lake City, UT",Utah,1731,1339,-21,-15,1710,1324,14,6,1724,1318,1105,128,148,148,0,,0,0.0,0.0,0.0,0.0,0.0
2024,7,12,5,2024-07-12,AA,969,DFW,IAH,"Dallas/Fort Worth, TX",Texas,"Houston, TX",Texas,2184,799,-10,-10,2174,789,6,4,2180,785,2541,314,334,324,0,,0,0.0,0.0,0.0,0.0,0.0
2024,4,22,1,2024-04-22,WN,6179,SAN,STL,"San Diego, CA",California,"St. Louis, MO",Missouri,849,625,1,5,850,630,29,7,879,623,2755,342,362,378,0,,0,0.0,0.0,0.0,0.0,0.0
2024,4,23,2,2024-04-23,MQ,7407,EWR,SAN,"Newark, NJ",New Jersey,"San Diego, CA",California,1319,1543,1,10,1320,1553,10,4,1330,1549,2697,329,349,343,0,,0,0.0,0.0,0.0,0.0,0.0
2024,8,9,5,2024-08-09,AA,3759,MCO,BWI,"Orlando, FL",Florida,"Baltimore, MD",Maryland,1716,1973,-1,-10,1715,1963,27,15,1742,1948,2833,344,364,386,0,,0,0.0,0.0,0.0,0.0,0.0
2024,6,14,5,2024-06-14,B6,3702,HNL,DEN,"Honolulu, HI",Hawaii,"Denver, CO",Colorado,1153,701,-6,-15,1147,686,24,5,1171,681,228,27,47,56,0,,0,0.0,0.0,0.0,0.0,0.0
2024,11,14,4,2024-11-14,B6,8684,DCA,ORD,"Washington, DC",District of Columbia,"Chicago, IL",Illinois,1283,2271,18,10,1301,2281,9,17,1310,2264,1913,234,254,260,0,,0,0.0,0.0,0.0,0.0,0.0
2024,5,11,6,2024-05-11,OH,9133,PDX,MDW,"Portland, OR",Oregon,"Chicago, IL",Illinois,1916,1562,7,0,1923,1562,21,18,1944,1544,1544,201,221,240,0,,0,0.0,0.0,0.0,0.0,0.0
2024,9,20,5,2024-09-20,OO,2548,LAS,IAD,"Las Vegas, NV",Nevada,"Washington, DC",District of Columbia,996,1954,-5,-10,991,1944,8,16,999,1928,1587,191,211,215,0,,0,0.0,0.0,0.0,0.0,0.0
2024,2,24,6,2024-02-24,NK,7692,HNL,SLC,"Honolulu, HI",Hawaii,"Salt Lake City, UT",Utah,891,1456,-10,0,881,1456,12,6,893,1450,2501,320,340,338,0,,0,0.0,0.0,0.0,0.0,0.0
2024,12,24,2,2024-12-24,OH,3053,STL,PHL,"St. Louis, MO",Missouri,"Philadelphia, PA",Pennsylvania,2236,971,2,10,2238,981,26,19,2264,962,296,33,53,78,1,,0,0.0,0.0,0.0,0.0,0.0
2024,5,10,5,2024-05-10,F9,5231,IAH,STL,"Houston, TX",Texas,"St. Louis, MO",Missouri,2197,796,-17,-15,2180,781,27,14,2207,767,949,119,139,160,0,,0,0.0,0.0,0.0,0.0,0.0
2024,10,14,1,2024-10-14,WN,1458,CLT,IAD,"Charlotte, NC",North Carolina,"Washington, DC",District of Columbia,1632,1109,-9,-15,1623,1094,5,4,1628,1090,1887,229,249,238,0,,0,0.0,0.0,0.0,0.0,0.0
2024,9,22,7,2024-09-22,NK,9282,ATL,BWI,"Atlanta, GA",Georgia,"Baltimore, MD",Maryland,1428,1614,-13,-10,1415,1604,27,16,1442,1588,880,118,138,161,0,,0,0.0,0.0,0.0,0.0,0.0
2024,6,10,1,2024-06-10,WN,9330,TPA,PHL,"Tampa, FL",Florida,"Philadelphia, PA",Pennsylvania,969,1653,10,5,979,1658,26,5,1005,1653,1245,163,183,194,0,,0,0.0,0.0,0.0,0.0,0.0
2024,3,27,3,2024-03-27,UA,8319,BWI,JFK,"Baltimore, MD",Maryland,"New York, NY",New York,849,1522,-9,-10,840,1512,8,18,848,1494,721,99,119,125,0,,0,0.0,0.0,0.0,0.0,0.0
2024,2,24,6,2024-02-24,HA,487,STL,PHL,"St. Louis, MO",Missouri,"Philadelphia, PA",Pennsylvania,1274,898,3,10,1277,908,22,10,1299,898,2803,346,366,378,0,,0,0.0,0.0,0.0,0.0,0.0
2024,10,14,1,2024-10-14,AS,932,STL,LAS,"St. Louis, MO",Missouri,"Las Vegas, NV",Nevada,2245,1756,-1,5,2244,1761,17,14,2261,1747,2947,371,391,402,0,,0,0.0,0.0,0.0,0.0,0.0
2024,6,26,3,2024-06-26,WN,8541,PHL,MIA,"Philadelphia, PA",Pennsylvania,"Miami, FL",Florida,648,2155,-4,0,644,2155,22,11,666,2144,1377,170,190,203,0,,0,0.0,0.0,0.0,0.0,0.0
2024,12,14,6,2024-12-14,OH,9820,PHL,CLT,"Philadelphia, PA",Pennsylvania,"Charlotte, NC",North Carolina,755,1931,-8,-15,747,1916,27,3,774,1913,1621,196,216,226,0,,0,0.0,0.0,0.0,0.0,0.0
2024,1,8,1,2024-01-08,UA,4293,ATL,SEA,"Atlanta, GA",Georgia,"Seattle, WA",Washington,1912,620,39,30,1951,650,7,3,1958,647,2267,290,310,300,0,,0,10.0,6.0,2.0,0.0,12.0
2024,11,16,6,2024-11-16,HA,1938,LGA,IAD,"New York, NY",New York,"Washington, DC",District of Columbia,1722,1664,3,0,1725,1664,22,11,1747,1653,2239,277,297,310,0,,0,0.0,0.0,0.0,0.0,0.0
2024,11,8,5,2024-11-08,HA,9652,ORD,CLT,"Chicago, IL",Illinois,"Charlotte, NC",North Carolina,1966,2121,-3,0,1963,2121,14,17,1977,2104,490,55,75,86,0,,0,0.0,0.0,0.0,0.0,0.0
2024,9,3,2,2024-09-03,G4,9615,SEA,DFW,"Seattle, WA",Washington,"Dallas/Fort Worth, TX",Texas,1709,1563,62,60,1771,1623,23,12,1794,1611,413,56,76,91,0,,0,11.0,8.0,5.0,0.0,36.0
2024,11,18,1,2024-11-18,B6,991,DCA,MDW,"Washington, DC",District of Columbia,"Chicago, IL",Illinois,843,2095,3,10,846,2105,6,19,852,2086,2822,350,370,375,0,,0,0.0,0.0,0.0,0.0,0.0
2024,9,11,3,2024-09-11,MQ,5688,EWR,LAX,"Newark, NJ",New Jersey,"Los Angeles, CA",California,1176,1566,1,0,1177,1566,18,4,1195,1562,856,116,136,138,0,,0,0.0,0.0,0.0,0.0,0.0
2024,11,23,6,2024-11-23,OH,1405,SFO,IAD,"San Francisco, CA",California,"Washington, DC",District of Columbia,607,2287,-13,-5,594,2282,23,5,617,2277,2071,258,278,286,0,,0,0.0,0.0,0.0,0.0,0.0
2024,2,23,5,2024-02-23,NK,5383,LAX,ATL,"Los Angeles, CA",California,"Atlanta, GA",Georgia,1094,1931,-21,-15,1073,1916,9,12,1082,1904,2846,358,378,379,0,,0,0.0,0.0,0.0,0.0,0.0
2024,9,5,4,2024-09-05,YX,4648,DFW,ATL,"Dallas/Fort Worth, TX",Texas,"Atlanta, GA",Georgia,1603,1058,8,15,1611,1073,20,11,1631,1062,441,47,67,78,0,,0,0.0,0.0,0.0,0.0,0.0
2024,8,26,1,2024-08-26,OH,4292,TPA,BWI,"Tampa, FL",Florida,"Baltimore, MD",Maryland,1776,1113,14,10,1790,1123,14,5,1804,1118,2731,350,370,369,0,,0,0.0,0.0,0.0,0.0,0.0
2024,8,16,5,2024-08-16,AS,6552,IAD,LAX,"Washington, DC",District of Columbia,"Los Angeles, CA",California,524,2126,-11,-5,513,2121,9,11,522,2110,1502,183,203,203,0,,0,0.0,0.0,0.0,0.0,0.0
2024,3,7,4,2024-03-07,9E,8553,DTW,HNL,"Detroit, MI",Michigan,"Honolulu, HI",Hawaii,782,1667,3,5,785,1672,18,13,803,1659,934,116,136,147,0,,0,0.0,0.0,0.0,0.0,0.0
2024,2,20,2,2024-02-20,HA,2440,ATL,TPA,"Atlanta, GA",Georgia,"Tampa, FL",Florida,2086,640,8,5,2094,645,11,11,2105,634,2390,304,324,326,0,,0,0.0,0.0,0.0,0.0,0.0
2024,4,6,6,2024-04-06,B6,1893,SFO,BWI,"San Francisco, CA",California,"Baltimore, MD",Maryland,1386,1437,-5,-10,1381,1427,14,7,1395,1420,2132,273,293,294,0,,0,0.0,0.0,0.0,0.0,0.0
2024,4,1,1,2024-04-01,NK,6494,PHX,LAS,"Phoenix, AZ",Arizona,"Las Vegas, NV",Nevada,1437,862,-8,0,1429,862,15,14,1444,848,1181,155,175,184,0,,0,0.0,0.0,0.0,0.0,0.0
2024,9,20,5,2024-09-20,OO,424,DTW,DFW,"Detroit, MI",Michigan,"Dallas/Fort Worth, TX",Texas,1119,1917,-6,-10,1113,1907,23,19,1136,1888,335,47,67,89,0,,0,0.0,0.0,0.0,0.0,0.0
2024,10,17,4,2024-10-17,AS,9277,DEN,SLC,"Denver, CO",Colorado,"Salt Lake City, UT",Utah,737,1284,12,5,749,1289,15,19,764,1270,661,80,100,114,0,,0,0.0,0.0,0.0,0.0,0.0
2024,4,5,5,2024-04-05,9E,7948,PHX,PDX,"Phoenix, AZ",Arizona,"Portland, OR",Oregon,1437,1632,-3,-10,1434,1622,7,18,1441,1604,316,42,62,67,0,,0,0.0,0.0,0.0,0.0,0.0
2024,3,28,4,2024-03-28,DL,8214,ATL,SFO,"Atlanta, GA",Georgia,"San Francisco, CA",California,815,1676,8,5,823,1681,11,16,834,1665,1806,225,245,252,0,,0,0.0,0.0,0.0,0.0,0.0
2024,3,18,1,2024-03-18,MQ,6744,STL,DTW,"St. Louis, MO",Missouri,"Detroit, MI",Michigan,1339,1622,-9,-5,1330,1617,18,11,1348,1606,1304,167,187,196,0,,0,0.0,0.0,0.0,0.0,0.0
2024,10,14,1,2024-10-14,MQ,4882,MCO,DFW,"Orlando, FL",Florida,"Dallas/Fort Worth, TX",Texas,962,727,-11,-20,951,707,10,15,961,692,1214,144,164,169,0,,0,0.0,0.0,0.0,0.0,0.0
2024,4,29,1,2024-04-29,MQ,3237,DEN,IAD,"Denver, CO",Colorado,"Washington, DC",District of Columbia,2221,1130,-20,-15,2201,1115,26,5,2227,1110,1312,172,192,203,0,,0,0.0,0.0,0.0,0.0,0.0
2024,10,28,1,2024-10-28,UA,3998,MCO,DFW,"Orlando, FL",Florida,"Dallas/Fort Worth, TX",Texas,1091,1243,10,5,1101,1248,24,7,1125,1241,1084,133,153,164,0,,0,0.0,0.0,0.0,0.0,0.0
2024,6,13,4,2024-06-13,DL,935,MCO,SLC,"Orlando, FL",Florida,"Salt Lake City, UT",Utah,1339,1124,-2,-10,1337,1114,17,10,1354,1104,1928,232,252,259,0,,0,0.0,0.0,0.0,0.0,0.0
2024,6,30,7,2024-06-30,YX,4254,STL,DCA,"St. Louis, MO",Missouri,"Washington, DC",District of Columbia,1495,2355,-2,0,1493,2355,18,5,1511,2350,1762,217,237,240,0,,0,0.0,0.0,0.0,0.0,0.0
2024,8,10,6,2024-08-10,UA,2878,SLC,EWR,"Salt Lake City, UT",Utah,"Newark, NJ",New Jersey,2131,1356,4,-5,2135,1351,24,18,2159,1333,2227,274,294,316,0,,0,0.0,0.0,0.0,0.0,0.0
2024,11,6,3,2024-11-06,AA,9688,EWR,ORD,"Newark, NJ",New Jersey,"Chicago, IL",Illinois,1905,1565,-5,5,1900,1570,19,6,1919,1564,2222,284,304,309,0,,0,0.0,0.0,0.0,0.0,0.0
2024,1,7,7,2024-01-07,F9,6509,DCA,DFW,"Washington, DC",District of Columbia,"Dallas/Fort Worth, TX",Texas,1988,1763,7,0,1995,1763,22,11,2017,1752,2055,264,284,297,0,,0,0.0,0.0,0.0,0.0,0.0
2024,11,25,1,2024-11-25,AS,9968,STL,BWI,"St. Louis, MO",Missouri,"Baltimore, MD",Maryland,649,1493,-2,-5,647,1488,15,9,662,1479,1218,159,179,183,0,,0,0.0,0.0,0.0,0.0,0.0
2024,9,19,4,2024-09-19,MQ,4413,DTW,MSP,"Detroit, MI",Michigan,"Minneapolis, MN",Minnesota,851,1358,-12,-15,839,1343,26,19,865,1324,784,102,122,147,0,,0,0.0,0.0,0.0,0.0,0.0
2024,6,9,7,2024-06-09,DL,5746,PHL,SLC,"Philadelphia, PA",Pennsylvania,"Salt Lake City, UT",Utah,941,831,-8,-5,933,826,14,8,947,818,1701,212,232,234,0,,0,0.0,0.0,0.0,0.0,0.0
2024,5,30,4,2024-05-30,F9,7708,DFW,EWR,"Dallas/Fort Worth, TX",Texas,"Newark, NJ",New Jersey,894,1532,6,0,900,1532,15,12,915,1520,2570,322,342,349,0,,0,0.0,0.0,0.0,0.0,0.0
2024,3,25,1,2024-03-25,AS,3821,SAN,MDW,"San Diego, CA",California,"Chicago, IL",Illinois,1888,2191,12,5,1900,2196,23,7,1923,2189,1702,204,224,234,0,,0,0.0,0.0,0.0,0.0,0.0
2024,5,26,7,2024-05-26,NK,8011,SAN,MCO,"San Diego, CA",California,"Orlando, FL",Florida,505,687,-6,-10,499,677,26,17,525,660,1916,232,252,275,0,,0,0.0,0.0,0.0,0.0,0.0
2024,4,21,7,2024-04-21,OO,1771,STL,MSP,"St. Louis, MO",Missouri,"Minneapolis, MN",Minnesota,1033,1365,4,5,1037,1370,19,4,1056,1366,1274,166,186,189,0,,0,0.0,0.0,0.0,0.0,0.0
2024,2,5,1,2024-02-05,AA,1016,PHX,DEN,"Phoenix, AZ",Arizona,"Denver, CO",Colorado,719,2187,-1,-10,718,2177,7,17,725,2160,1895,237,257,261,0,,0,0.0,0.0,0.0,0.0,0.0
2024,10,11,5,2024-10-11,NK,5688,BWI,SAN,"Baltimore, MD",Maryland,"San Diego, CA",California,1370,1236,-5,-10,1365,1226,7,11,1372,1215,2805,355,375,373,0,,0,0.0,0.0,0.0,0.0,0.0
2024,7,6,6,2024-07-06,UA,9209,BOS,PHL,"Boston, MA",Massachusetts,"Philadelphia, PA",Pennsylvania,511,800,-4,0,507,800,5,8,512,792,2959,370,390,383,0,,0,0.0,0.0,0.0,0.0,0.0
2024,3,22,5,2024-03-22,OO,9425,STL,JFK,"St. Louis, MO",Missouri,"New York, NY",New York,1294,1585,-4,-10,1290,1575,19,6,1309,1569,302,33,53,58,0,,0,0.0,0.0,0.0,0.0,0.0
2024,1,2,2,2024-01-02,YX,6596,SFO,TPA,"San Francisco, CA",California,"Tampa, FL",Florida,1908,2011,-1,5,1907,2016,17,16,1924,2000,1873,235,255,268,0,,0,0.0,0.0,0.0,0.0,0.0
2024,10,29,2,2024-10-29,F9,1936,EWR,ATL,"Newark, NJ",New Jersey,"Atlanta, GA",Georgia,1203,960,27,20,1230,980,19,11,1249,969,2079,252,272,282,0,,0,4.0,3.0,0.0,0.0,13.0
2024,7,15,1,2024-07-15,AS,2238,MCO,LAS,"Orlando, FL",Florida,"Las Vegas, NV",Nevada,957,731,-12,-15,945,716,25,3,970,713,1459,187,207,215,0,,0,0.0,0.0,0.0,0.0,0.0
2024,1,11,4,2024-01-11,WN,4107,DCA,BWI,"Washington, DC",District of Columbia,"Baltimore, MD",Maryland,724,776,7,0,731,776,22,12,753,764,538,72,92,106,0,,0,0.0,0.0,0.0,0.0,0.0
2024,8,21,3,2024-08-21,OO,2005,BOS,SEA,"Boston, MA",Massachusetts,"Seattle, WA",Washington,835,1675,22,15,857,1690,22,8,879,1682,2318,295,315,325,0,,0,0.0,0.0,0.0,0.0,0.0
2024,7,13,6,2024-07-13,F9,4089,SFO,IAH,"San Francisco, CA",California,"Houston, TX",Texas,666,2169,-6,-10,660,2159,13,5,673,2154,1021,136,156,154,0,,0,0.0,0.0,0.0,0.0,0.0
2024,4,28,7,2024-04-28,G4,3585,DEN,MCO,"Denver, CO",Colorado,"Orlando, FL",Florida,1839,621,-5,-5,1834,616,22,12,1856,604,1191,146,166,180,0,,0,0.0,0.0,0.0,0.0,0.0
2024,1,20,6,2024-01-20,9E,4897,STL,PDX,"St. Louis, MO",Missouri,"Portland, OR",Oregon,1639,1252,-21,-15,1618,1237,15,6,1633,1231,2158,272,292,293,0,,0,0.0,0.0,0.0,0.0,0.0
2024,9,17,2,2024-09-17,DL,2832,MIA,MDW,"Miami, FL",Florida,"Chicago, IL",Illinois,997,1942,5,0,1002,1942,22,10,1024,1932,2020,246,266,278,0,,0,0.0,0.0,0.0,0.0,0.0
2024,10,19,6,2024-10-19,HA,7814,SLC,DCA,"Salt Lake City, UT",Utah,"Washington, DC",District of Columbia,647,1382,2,5,649,1387,10,18,659,1369,2163,277,297,305,0,,0,0.0,0.0,0.0,0.0,0.0
2024,9,12,4,2024-09-12,AS,1421,ORD,CLT,"Chicago, IL",Illinois,"Charlotte, NC",North Carolina,535,767,7,5,542,772,21,4,563,768,1932,242,262,267,0,,0,0.0,0.0,0.0,0.0,0.0
2024,8,9,5,2024-08-09,B6,3454,HNL,SFO,"Honolulu, HI",Hawaii,"San Francisco, CA",California,1930,1661,6,0,1936,1661,28,17,1964,1644,2008,247,267,292,0,,0,0.0,0.0,0.0,0.0,0.0
2024,8,13,2,2024-08-13,B6,9820,MSP,PHL,"Minneapolis, MN",Minnesota,"Philadelphia, PA",Pennsylvania,1908,1472,3,5,1911,1477,21,10,1932,1467,1777,213,233,244,0,,0,0.0,0.0,0.0,0.0,0.0
2024,2,22,4,2024-02-22,9E,7201,LGA,LAX,"New York, NY",New York,"Los Angeles, CA",California,2280,2190,-16,-20,2264,2170,13,19,2277,2151,2543,324,344,356,0,,0,0.0,0.0,0.0,0.0,0.0
2024,12,20,5,2024-12-20,OO,4843,MSP,PHL,"Minneapolis, MN",Minnesota,"Philadelphia, PA",Pennsylvania,1489,1539,16,20,1505,1559,24,15,1529,1544,2919,356,376,395,0,,0,2.0,2.0,3.0,0.0,13.0
2024,12,7,6,2024-12-07,UA,9051,TPA,PHL,"Tampa, FL",Florida,"Philadelphia, PA",Pennsylvania,1934,1996,-3,-10,1931,1986,7,5,1938,1981,1650,210,230,222,0,,0,0.0,0.0,0.0,0.0,0.0
2024,12,29,7,2024-12-29,YX,7114,LAS,ORD,"Las Vegas, NV",Nevada,"Chicago, IL",Illinois,807,1231,-12,-15,795,1216,27,12,822,1204,1197,149,169,188,0,,0,0.0,0.0,0.0,0.0,0.0
2024,10,6,7,2024-10-06,F9,3512,MIA,SLC,"Miami, FL",Florida,"Salt Lake City, UT",Utah,1141,2201,12,15,1153,2216,28,15,1181,2201,2307,287,307,330,0,,0,0.0,0.0,0.0,0.0,0.0
2024,3,21,4,2024-03-21,OH,7925,SEA,CLT,"Seattle, WA",Washington,"Charlotte, NC",North Carolina,739,1433,1,10,740,1443,16,13,756,1430,2259,291,311,320,0,,0,0.0,0.0,0.0,0.0,0.0
2024,7,20,6,2024-07-20,F9,1457,DEN,MDW,"Denver, CO",Colorado,"Chicago, IL",Illinois,1416,2050,12,5,1428,2055,25,3,1453,2052,797,107,127,135,0,,0,0.0,0.0,0.0,0.0,0.0
2024,6,6,4,2024-06-06,YX,3581,HNL,MCO,"Honolulu, HI",Hawaii,"Orlando, FL",Florida,1404,1789,-22,-15,1382,1774,7,16,1389,1758,1852,233,253,256,0,,0,0.0,0.0,0.0,0.0,0.0
2024,4,29,1,2024-04-29,B6,9240,MSP,LAS,"Minneapolis, MN",Minnesota,"Las Vegas, NV",Nevada,1890,1321,1,10,1891,1331,8,4,1899,1327,1927,245,265,257,0,,0,0.0,0.0,0.0,0.0,0.0
2024,2,28,3,2024-02-28,F9,1866,PDX,DCA,"Portland, OR",Oregon,"Washington, DC",District of Columbia,1355,2125,-1,0,1354,2125,14,14,1368,2111,2577,331,351,359,0,,0,0.0,0.0,0.0,0.0,0.0
2024,8,2,5,2024-08-02,9E,8319,SAN,SLC,"San Diego, CA",California,"Salt Lake City, UT",Utah,803,1698,0,5,803,1703,26,6,829,1697,2603,332,352,364,0,,0,0.0,0.0,0.0,0.0,0.0
2024,5,7,2,2024-05-07,HA,7263,MSP,LGA,"Minneapolis, MN",Minnesota,"New York, NY",New York,1116,1039,20,20,1136,1059,9,14,1145,1045,675,85,105,108,0,,0,5.0,1.0,1.0,0.0,13.0
2024,8,11,7,2024-08-11,F9,2570,LAS,TPA,"Las Vegas, NV",Nevada,"Tampa, FL",Florida,1690,2269,-1,-10,1689,2259,24,3,1713,2256,2078,263,283,290,0,,0,0.0,0.0,0.0,0.0,0.0
2024,7,27,6,2024-07-27,UA,259,MDW,SEA,"Chicago, IL",Illinois,"Seattle, WA",Washington,1053,1888,-1,0,1052,1888,7,12,1059,1876,731,82,102,101,0,,1,0.0,0.0,0.0,0.0,0.0
2024,4,24,3,2024-04-24,DL,2992,HNL,MIA,"Honolulu, HI",Hawaii,"Miami, FL",Florida,1265,2029,11,5,1276,2034,26,6,1302,2028,734,93,113,125,0,,0,0.0,0.0,0.0,0.0,0.0
2024,7,27,6,2024-07-27,G4,5426,EWR,CLT,"Newark, NJ",New Jersey,"Charlotte, NC",North Carolina,1824,2309,-8,-5,1816,2304,11,4,1827,2300,2690,337,357,352,0,,0,0.0,0.0,0.0,0.0,0.0
2024,1,14,7,2024-01-14,DL,4213,LAX,SFO,"Los Angeles, CA",California,"San Francisco, CA",California,1397,842,-20,-15,1377,827,6,15,1383,812,1578,201,221,222,0,,0,0.0,0.0,0.0,0.0,0.0
2024,1,9,2,2024-01-09,G4,7849,HNL,MCO,"Honolulu, HI",Hawaii,"Orlando, FL",Florida,1471,1200,-10,-15,1461,1185,10,10,1471,1175,2618,319,339,339,0,,0,0.0,0.0,0.0,0.0,0.0
2024,2,9,5,2024-02-09,WN,7898,ATL,DTW,"Atlanta, GA",Georgia,"Detroit, MI",Michigan,1728,1361,-1,0,1727,1361,23,4,1750,1357,245,36,56,63,0,,0,0.0,0.0,0.0,0.0,0.0
2024,8,24,6,2024-08-24,YX,5099,LAX,SLC,"Los Angeles, CA",California,"Salt Lake City, UT",Utah,694,1142,-2,-10,692,1132,14,5,706,1127,221,22,42,41,0,,0,0.0,0.0,0.0,0.0,0.0
2024,10,7,1,2024-10-07,MQ,1670,SLC,DCA,"Salt Lake City, UT",Utah,"Washington, DC",District of Columbia,1694,876,-22,-15,1672,861,12,17,1684,844,1257,157,177,186,0,,0,0.0,0.0,0.0,0.0,0.0
2024,12,24,2,2024-12-24,DL,9128,SFO,JFK,"San Francisco, CA",California,"New York, NY",New York,2285,1149,-14,-5,2271,1144,20,9,2291,1135,1259,166,186,195,0,,0,0.0,0.0,0.0,0.0,0.0
2024,7,19,5,2024-07-19,9E,3505,MIA,LAX,"Miami, FL",Florida,"Los Angeles, CA",California,2139,1931,-1,-10,2138,1921,6,12,2144,1909,2348,286,306,304,0,,0,0.0,0.0,0.0,0.0,0.0
2024,9,2,1,2024-09-02,AA,5627,ORD,LAS,"Chicago, IL",Illinois,"Las Vegas, NV",Nevada,1925,1002,-29,-20,1896,982,20,13,1916,969,685,84,104,117,0,,0,0.0,0.0,0.0,0.0,0.0
2024,10,4,5,2024-10-04,WN,5948,IAD,CLT,"Washington, DC",District of Columbia,"Charlotte, NC",North Carolina,1562,1249,-9,-10,1553,1239,25,16,1578,1223,556,77,97,118,0,,0,0.0,0.0,0.0,0.0,0.0
2024,8,22,4,2024-08-22,G4,6917,STL,MIA,"St. Louis, MO",Missouri,"Miami, FL",Florida,2271,2053,3,10,2274,2063,18,16,2292,2047,1849,229,249,263,0,,0,0.0,0.0,0.0,0.0,0.0
2024,1,4,4,2024-01-04,YX,1727,JFK,ORD,"New York, NY",New York,"Chicago, IL",Illinois,1145,1596,-15,-20,1130,1576,28,3,1158,1573,590,81,101,112,0,,0,0.0,0.0,0.0,0.0,0.0
2024,6,2,7,2024-06-02,G4,6243,BOS,LAS,"Boston, MA",Massachusetts,"Las Vegas, NV",Nevada,751,675,-4,5,747,680,29,9,776,671,2289,290,310,328,0,,0,0.0,0.0,0.0,0.0,0.0
2024,1,29,1,2024-01-29,WN,8496,SFO,BOS,"San Francisco, CA",California,"Boston, MA",Massachusetts,2205,938,10,5,2215,943,17,7,2232,936,1688,209,229,233,0,,0,0.0,0.0,0.0,0.0,0.0
2024,4,18,4,2024-04-18,G4,6658,MDW,DEN,"Chicago, IL",Illinois,"Denver, CO",Colorado,1806,1364,4,0,1810,1364,27,9,1837,1355,271,35,55,71,0,,0,0.0,0.0,0.0,0.0,0.0
2024,4,7,7,2024-04-07,HA,5372,HNL,LAX,"Honolulu, HI",Hawaii,"Los Angeles, CA",California,706,2073,-7,-10,699,2063,13,15,712,2048,1333,157,177,185,0,,0,0.0,0.0,0.0,0.0,0.0
2024,8,2,5,2024-08-02,YX,7981,EWR,BWI,"Newark, NJ",New Jersey,"Baltimore, MD",Maryland,999,1702,10,10,1009,1712,13,9,1022,1703,1842,227,247,249,0,,0,0.0,0.0,0.0,0.0,0.0
2024,10,19,6,2024-10-19,AS,9083,ORD,SLC,"Chicago, IL",Illinois,"Salt Lake City, UT",Utah,1666,637,4,0,1670,637,12,15,1682,622,964,121,141,148,0,,0,0.0,0.0,0.0,0.0,0.0
2024,3,15,5,2024-03-15,AA,3847,LGA,STL,"New York, NY",New York,"St. Louis, MO",Missouri,518,917,-15,-10,503,907,11,18,514,889,2319,287,307,316,0,,0,0.0,0.0,0.0,0.0,0.0
2024,11,21,4,2024-11-21,9E,9397,IAH,PHL,"Houston, TX",Texas,"Philadelphia, PA",Pennsylvania,2225,1951,0,-5,2225,1946,20,17,2245,1929,1960,239,259,276,0,,0,0.0,0.0,0.0,0.0,0.0
2024,5,25,6,2024-05-25,MQ,9382,TPA,STL,"Tampa, FL",Florida,"St. Louis, MO",Missouri,2099,2053,-20,-10,2079,2043,10,9,2089,2034,2893,354,374,373,0,,0,0.0,0.0,0.0,0.0,0.0
2024,5,7,2,2024-05-07,OH,1707,SLC,CLT,"Salt Lake City, UT",Utah,"Charlotte, NC",North Carolina,2265,1786,-5,-5,2260,1781,15,7,2275,1774,245,32,52,54,0,,0,0.0,0.0,0.0,0.0,0.0
2024,12,6,5,2024-12-06,AS,5174,DTW,PHX,"Detroit, MI",Michigan,"Phoenix, AZ",Arizona,1318,1981,3,0,1321,1981,23,16,1344,1965,1612,205,225,244,0,,0,0.0,0.0,0.0,0.0,0.0
2024,2,11,7,2024-02-11,G4,7253,BOS,ORD,"Boston, MA",Massachusetts,"Chicago, IL",Illinois,1186,1239,-14,-5,1172,1234,12,18,1184,1216,1815,217,237,247,0,,0,0.0,0.0,0.0,0.0,0.0
2024,12,21,6,2024-12-21,MQ,6833,BWI,DFW,"Baltimore, MD",Maryland,"Dallas/Fort Worth, TX",Texas,519,1269,10,5,529,1274,23,13,552,1261,2359,284,304,320,0,,0,0.0,0.0,0.0,0.0,0.0
2024,2,10,6,2024-02-10,DL,166,PHL,STL,"Philadelphia, PA",Pennsylvania,"St. Louis, MO",Missouri,947,928,8,15,955,943,19,13,974,930,233,22,42,54,0,,0,0.0,0.0,0.0,0.0,0.0
2024,2,3,6,2024-02-03,AS,8100,SFO,MSP,"San Francisco, CA",California,"Minneapolis, MN",Minnesota,1749,2037,-2,-5,1747,2032,15,14,1762,2018,1793,223,243,252,0,,0,0.0,0.0,0.0,0.0,0.0
2024,1,17,3,2024-01-17,DL,7745,TPA,CLT,"Tampa, FL",Florida,"Charlotte, NC",North Carolina,2266,2218,0,-5,2266,2213,13,15,2279,2198,2217,267,287,295,0,,0,0.0,0.0,0.0,0.0,0.0
2024,6,13,4,2024-06-13,WN,9570,DFW,JFK,"Dallas/Fort Worth, TX",Texas,"New York, NY",New York,1624,1075,9,5,1633,1080,20,10,1653,1070,2464,299,319,329,0,,0,0.0,0.0,0.0,0.0,0.0
2024,6,1,6,2024-06-01,HA,4258,DTW,LAS,"Detroit, MI",Michigan,"Las Vegas, NV",Nevada,1238,2079,-9,0,1229,2079,29,8,1258,2071,2864,359,379,396,0,,0,0.0,0.0,0.0,0.0,0.0
2024,3,16,6,2024-03-16,F9,9105,DFW,SAN,"Dallas/Fort Worth, TX",Texas,"San Diego, CA",California,793,2352,-3,-5,790,2347,17,4,807,2343,2118,269,289,290,0,,0,0.0,0.0,0.0,0.0,0.0
2024,3,27,3,2024-03-27,MQ,502,EWR,ORD,"Newark, NJ",New Jersey,"Chicago, IL",Illinois,2073,2337,16,10,2089,2347,14,12,2103,2335,1663,199,219,225,0,,0,0.0,0.0,0.0,0.0,0.0
2024,4,26,5,2024-04-26,NK,8025,MDW,LAS,"Chicago, IL",Illinois,"Las Vegas, NV",Nevada,564,1775,19,10,583,1785,14,4,597,1781,603,73,93,91,0,,0,0.0,0.0,0.0,0.0,0.0
2024,12,27,5,2024-12-27,OO,4266,JFK,BOS,"New York, NY",New York,"Boston, MA",Massachusetts,998,1137,-1,0,997,1137,29,13,1026,1124,468,50,70,92,0,,0,0.0,0.0,0.0,0.0,0.0
2024,12,7,6,2024-12-07,YX,3025,ATL,DEN,"Atlanta, GA",Georgia,"Denver, CO",Colorado,575,2038,-6,-10,569,2028,24,7,593,2021,2373,305,325,336,0,,0,0.0,0.0,0.0,0.0,0.0
2024,1,27,6,2024-01-27,MQ,3093,LAS,LAX,"Las Vegas, NV",Nevada,"Los Angeles, CA",California,1400,942,6,0,1406,942,13,8,1419,934,2481,315,335,336,0,,0,0.0,0.0,0.0,0.0,0.0
2024,11,8,5,2024-11-08,G4,9378,STL,SLC,"St. Louis, MO",Missouri,"Salt Lake City, UT",Utah,2227,2009,-3,0,2224,2009,6,18,2230,1991,400,47,67,71,0,,0,0.0,0.0,0.0,0.0,0.0
2024,10,13,7,2024-10-13,NK,871,DCA,IAH,"Washington, DC",District of Columbia,"Houston, TX",Texas,1134,1790,-14,-5,1120,1785,5,12,1125,1773,2863,365,385,382,0,,0,0.0,0.0,0.0,0.0,0.0
2024,5,13,1,2024-05-13,AA,7471,LAX,DEN,"Los Angeles, CA",California,"Denver, CO",Colorado,1648,2095,-20,-10,1628,2085,12,16,1640,2069,2077,259,279,287,0,,0,0.0,0.0,0.0,0.0,0.0
2024,8,6,2,2024-08-06,DL,9961,ORD,LGA,"Chicago, IL",Illinois,"New York, NY",New York,526,739,-6,0,520,739,20,8,540,731,422,47,67,75,0,,0,0.0,0.0,0.0,0.0,0.0
2024,6,16,7,2024-06-16,AS,5813,HNL,LGA,"Honolulu, HI",Hawaii,"New York, NY",New York,2138,1852,-13,-5,2125,1847,26,7,2151,1840,1268,161,181,194,0,,0,0.0,0.0,0.0,0.0,0.0
2024,4,7,7,2024-04-07,NK,8267,DTW,IAH,"Detroit, MI",Michigan,"Houston, TX",Texas,1799,672,-10,-10,1789,662,15,12,1804,650,1894,226,246,253,1,,0,0.0,0.0,0.0,0.0,0.0
2024,9,24,2,2024-09-24,UA,1656,STL,DCA,"St. Louis, MO",Missouri,"Washington, DC",District of Columbia,2095,1027,20,15,2115,1042,13,14,2128,1028,1677,210,230,237,0,,0,0.0,0.0,0.0,0.0,0.0
2024,8,24,6,2024-08-24,G4,1251,PHL,PHX,"Philadelphia, PA",Pennsylvania,"Phoenix, AZ",Arizona,1179,1922,8,10,1187,1932,29,19,1216,1913,1904,242,262,290,0,,0,0.0,0.0,0.0,0.0,0.0
2024,11,4,1,2024-11-04,MQ,5414,CLT,LAX,"Charlotte, NC",North Carolina,"Los Angeles, CA",California,582,1859,-2,5,580,1864,23,18,603,1846,757,99,119,140,0,,0,0.0,0.0,0.0,0.0,0.0
2024,6,21,5,2024-06-21,HA,1317,DEN,PDX,"Denver, CO",Colorado,"Portland, OR",Oregon,985,2330,-7,-5,978,2325,22,12,1000,2313,2505,306,326,340,0,,0,0.0,0.0,0.0,0.0,0.0
2024,7,8,1,2024-07-08,NK,4044,MCO,LAX,"Orlando, FL",Florida,"Los Angeles, CA",California,1986,1582,-2,-5,1984,1577,11,19,1995,1558,2883,357,377,387,0,,0,0.0,0.0,0.0,0.0,0.0
2024,5,1,3,2024-05-01,OH,8139,PHL,DTW,"Philadelphia, PA",Pennsylvania,"Detroit, MI",Michigan,505,1199,4,5,509,1204,25,4,534,1200,1102,143,163,172,0,,0,0.0,0.0,0.0,0.0,0.0
2024,2,15,4,2024-02-15,AS,2142,MIA,PHX,"Miami, FL",Florida,"Phoenix, AZ",Arizona,1468,696,5,0,1473,696,14,4,1487,692,1363,162,182,180,0,,0,0.0,0.0,0.0,0.0,0.0
2024,3,4,1,2024-03-04,MQ,6403,SAN,EWR,"San Diego, CA",California,"Newark, NJ",New Jersey,2199,1077,-2,0,2197,1077,10,16,2207,1061,2567,312,332,338,0,,0,0.0,0.0,0.0,0.0,0.0
2024,5,9,4,2024-05-09,AS,8997,SEA,MCO,"Seattle, WA",Washington,"Orlando, FL",Florida,867,2301,-23,-15,844,2286,25,6,869,2280,2290,290,310,321,1,,0,0.0,0.0,0.0,0.0,0.0
2024,11,5,2,2024-11-05,AA,2769,SEA,MDW,"Seattle, WA",Washington,"Chicago, IL",Illinois,970,1621,-10,0,960,1621,8,14,968,1607,1274,163,183,185,0,,0,0.0,0.0,0.0,0.0,0.0
2024,12,28,6,2024-12-28,MQ,2213,JFK,SEA,"New York, NY",New York,"Seattle, WA",Washington,2237,1090,24,15,2261,1105,5,4,2266,1101,1050,128,148,137,0,,0,0.0,0.0,0.0,0.0,0.0
2024,7,11,4,2024-07-11,B6,3077,DEN,MIA,"Denver, CO",Colorado,"Miami, FL",Florida,1972,1919,-15,-15,1957,1904,8,16,1965,1888,1590,202,222,226,0,,0,0.0,0.0,0.0,0.0,0.0
2024,11,2,6,2024-11-02,9E,4478,STL,ATL,"St. Louis, MO",Missouri,"Atlanta, GA",Georgia,1188,1005,4,-5,1192,1000,7,11,1199,989,2476,306,326,324,0,,0,0.0,0.0,0.0,0.0,0.0
2024,6,29,6,2024-06-29,UA,7327,PDX,MIA,"Portland, OR",Oregon,"Miami, FL",Florida,869,1314,9,0,878,1314,7,10,885,1304,1633,212,232,229,0,,0,0.0,0.0,0.0,0.0,0.0
2024,10,18,5,2024-10-18,NK,6361,MCO,HNL,"Orlando, FL",Florida,"Honolulu, HI",Hawaii,1863,1046,-5,5,1858,1051,18,9,1876,1042,1448,174,194,201,0,,0,0.0,0.0,0.0,0.0,0.0
2024,10,8,2,2024-10-08,9E,522,IAH,PHX,"Houston, TX",Texas,"Phoenix, AZ",Arizona,2191,1298,-21,-15,2170,1283,9,15,2179,1268,2049,246,266,270,0,,0,0.0,0.0,0.0,0.0,0.0
2024,1,29,1,2024-01-29,UA,8822,LGA,DFW,"New York, NY",New York,"Dallas/Fort Worth, TX",Texas,777,1898,8,10,785,1908,5,4,790,1904,1207,142,162,151,0,,0,0.0,0.0,0.0,0.0,0.0
2024,5,28,2,2024-05-28,B6,190,IAD,PHX,"Washington, DC",District of Columbia,"Phoenix, AZ",Arizona,839,1643,-28,-20,811,1623,15,4,826,1619,605,72,92,91,0,,0,0.0,0.0,0.0,0.0,0.0
2024,9,23,1,2024-09-23,NK,3472,EWR,MCO,"Newark, NJ",New Jersey,"Orlando, FL",Florida,1314,1184,11,10,1325,1194,10,18,1335,1176,1426,184,204,212,0,,0,0.0,0.0,0.0,0.0,0.0
2024,10,22,2,2024-10-22,OH,6136,ORD,DCA,"Chicago, IL",Illinois,"Washington, DC",District of Columbia,1113,1026,-13,-20,1100,1006,6,18,1106,988,2932,372,392,396,0,,0,0.0,0.0,0.0,0.0,0.0
2024,1,11,4,2024-01-11,UA,2042,LGA,IAH,"New York, NY",New York,"Houston, TX",Texas,1603,1553,-19,-10,1584,1543,17,4,1601,1539,1526,185,205,206,0,,0,0.0,0.0,0.0,0.0,0.0
2024,6,12,3,2024-06-12,MQ,3905,SFO,MSP,"San Francisco, CA",California,"Minneapolis, MN",Minnesota,2229,1449,9,10,2238,1459,5,9,2243,1450,1254,156,176,170,0,,0,0.0,0.0,0.0,0.0,0.0
2024,4,22,1,2024-04-22,MQ,9532,LAX,DCA,"Los Angeles, CA",California,"Washington, DC",District of Columbia,1292,1984,6,10,1298,1994,12,9,1310,1985,1078,129,149,150,0,,0,0.0,0.0,0.0,0.0,0.0
2024,7,5,5,2024-07-05,9E,197,TPA,PHX,"Tampa, FL",Florida,"Phoenix, AZ",Arizona,1102,1933,37,30,1139,1963,14,19,1153,1944,2601,315,335,348,0,,0,8.0,3.0,1.0,0.0,18.0
2024,10,21,1,2024-10-21,DL,1579,PDX,DCA,"Portland, OR",Oregon,"Washington, DC",District of Columbia,566,1193,-10,-15,556,1178,19,14,575,1164,1636,196,216,229,0,,0,0.0,0.0,0.0,0.0,0.0
2024,8,19,1,2024-08-19,AS,4726,HNL,MIA,"Honolulu, HI",Hawaii,"Miami, FL",Florida,714,955,2,0,716,955,7,15,723,940,1264,167,187,189,0,,0,0.0,0.0,0.0,0.0,0.0
2024,8,14,3,2024-08-14,F9,5247,SAN,HNL,"San Diego, CA",California,"Honolulu, HI",Hawaii,915,626,-25,-15,890,611,10,7,900,604,408,49,69,66,0,,0,0.0,0.0,0.0,0.0,0.0
2024,11,5,2,2024-11-05,WN,3747,CLT,MIA,"Charlotte, NC",North Carolina,"Miami, FL",Florida,1668,2276,-14,-10,1654,2266,6,17,1660,2249,473,63,83,86,0,,0,0.0,0.0,0.0,0.0,0.0
2024,4,7,7,2024-04-07,G4,5543,IAD,MIA,"Washington, DC",District of Columbia,"Miami, FL",Florida,1051,1670,-10,-10,1041,1660,25,4,1066,1656,295,33,53,62,0,,0,0.0,0.0,0.0,0.0,0.0
2024,2,24,6,2024-02-24,YX,179,DTW,DEN,"Detroit, MI",Michigan,"Denver, CO",Colorado,2247,1055,-20,-15,2227,1040,29,8,2256,1032,209,35,55,72,0,,0,0.0,0.0,0.0,0.0,0.0
2024,4,20,6,2024-04-20,YX,5677,BWI,HNL,"Baltimore, MD",Maryland,"Honolulu, HI",Hawaii,1809,711,4,10,1813,721,27,6,1840,715,976,127,147,160,0,,0,0.0,0.0,0.0,0.0,0.0
2024,5,31,5,2024-05-31,HA,2323,MSP,EWR,"Minneapolis, MN",Minnesota,"Newark, NJ",New Jersey,1070,1346,-16,-15,1054,1331,24,15,1078,1316,1595,198,218,237,0,,0,0.0,0.0,0.0,0.0,0.0
2024,9,2,1,2024-09-02,F9,2669,DTW,IAH,"Detroit, MI",Michigan,"Houston, TX",Texas,1039,2286,-8,0,1031,2286,7,4,1038,2282,866,111,131,122,0,,0,0.0,0.0,0.0,0.0,0.0
2024,3,9,6,2024-03-09,NK,4618,ATL,PHL,"Atlanta, GA",Georgia,"Philadelphia, PA",Pennsylvania,1570,974,4,0,1574,974,13,7,1587,967,2017,257,277,277,0,,0,0.0,0.0,0.0,0.0,0.0
2024,11,7,4,2024-11-07,OH,1223,PDX,BOS,"Portland, OR",Oregon,"Boston, MA",Massachusetts,1760,1938,-9,-10,1751,1928,24,10,1775,1918,1820,231,251,265,0,,0,0.0,0.0,0.0,0.0,0.0
2024,10,15,2,2024-10-15,NK,2723,PHL,LAS,"Philadelphia, PA",Pennsylvania,"Las Vegas, NV",Nevada,616,1444,84,90,700,1534,9,18,709,1516,1252,154,174,181,0,,0,22.0,14.0,8.0,3.0,43.0
2024,9,6,5,2024-09-06,UA,1503,SLC,ATL,"Salt Lake City, UT",Utah,"Atlanta, GA",Georgia,650,725,-2,-5,648,720,10,9,658,711,2576,321,341,340,0,,0,0.0,0.0,0.0,0.0,0.0
2024,2,5,1,2024-02-05,OH,2678,BOS,STL,"Boston, MA",Massachusetts,"St. Louis, MO",Missouri,1606,1630,16,15,1622,1645,14,5,1636,1640,2699,334,354,353,0,,0,0.0,0.0,0.0,0.0,0.0
2024,8,26,1,2024-08-26,AS,431,DTW,SAN,"Detroit, MI",Michigan,"San Diego, CA",California,1580,1161,15,15,1595,1176,25,11,1620,1165,2427,304,324,340,0,,0,0.0,0.0,0.0,0.0,0.0
2024,5,27,1,2024-05-27,MQ,7585,MIA,TPA,"Miami, FL",Florida,"Tampa, FL",Florida,2252,1983,17,15,2269,1998,13,15,2282,1983,2462,301,321,329,0,,0,0.0,0.0,0.0,0.0,0.0
2024,8,14,3,2024-08-14,MQ,839,SLC,MCO,"Salt Lake City, UT",Utah,"Orlando, FL",Florida,1483,1177,4,5,1487,1182,5,4,1492,1178,1841,233,253,242,0,,0,0.0,0.0,0.0,0.0,0.0
2024,8,31,6,2024-08-31,B6,8333,LAX,IAD,"Los Angeles, CA",California,"Washington, DC",District of Columbia,1908,961,-11,-10,1897,951,20,13,1917,938,561,62,82,95,0,,0,0.0,0.0,0.0,0.0,0.0
2024,12,2,1,2024-12-02,AA,5080,DEN,MCO,"Denver, CO",Colorado,"Orlando, FL",Florida,1743,1278,-12,-15,1731,1263,10,12,1741,1251,2583,326,346,348,0,,0,0.0,0.0,0.0,0.0,0.0
2024,12,30,1,2024-12-30,OO,3978,SAN,ORD,"San Diego, CA",California,"Chicago, IL",Illinois,1808,1582,9,0,1817,1582,20,13,1837,1569,2376,292,312,325,0,,0,0.0,0.0,0.0,0.0,0.0
2024,7,19,5,2024-07-19,UA,2049,PHL,TPA,"Philadelphia, PA",Pennsylvania,"Tampa, FL",Florida,1503,1363,0,-5,1503,1358,24,19,1527,1339,609,84,104,127,0,,0,0.0,0.0,0.0,0.0,0.0
2024,6,2,7,2024-06-02,MQ,3560,IAD,SFO,"Washington, DC",District of Columbia,"San Francisco, CA",California,2277,1374,11,10,2288,1384,24,19,2312,1365,1538,199,219,242,0,,0,0.0,0.0,0.0,0.0,0.0
2024,3,13,3,2024-03-13,YX,2228,MCO,EWR,"Orlando, FL",Florida,"Newark, NJ",New Jersey,933,2331,12,5,945,2336,7,5,952,2331,2467,304,324,316,0,,0,0.0,0.0,0.0,0.0,0.0
2024,7,19,5,2024-07-19,AA,4597,TPA,SAN,"Tampa, FL",Florida,"San Diego, CA",California,819,2318,-17,-10,802,2308,18,14,820,2294,1199,141,161,173,0,,0,0.0,0.0,0.0,0.0,0.0
2024,10,22,2,2024-10-22,WN,2254,MSP,IAD,"Minneapolis, MN",Minnesota,"Washington, DC",District of Columbia,2134,1887,-21,-20,2113,1867,25,5,2138,1862,1920,234,254,264,0,,0,0.0,0.0,0.0,0.0,0.0
2024,1,17,3,2024-01-17,9E,5330,HNL,DTW,"Honolulu, HI",Hawaii,"Detroit, MI",Michigan,741,1399,-20,-10,721,1389,12,7,733,1382,696,92,112,111,0,,0,0.0,0.0,0.0,0.0,0.0
2024,5,8,3,2024-05-08,UA,7544,SEA,BWI,"Seattle, WA",Washington,"Baltimore, MD",Maryland,964,874,7,0,971,874,24,8,995,866,2435,308,328,340,0,,0,0.0,0.0,0.0,0.0,0.0
2024,8,4,7,2024-08-04,OO,1337,JFK,PHX,"New York, NY",New York,"Phoenix, AZ",Arizona,702,2253,-11,-15,691,2238,27,12,718,2226,2922,374,394,413,0,,0,0.0,0.0,0.0,0.0,0.0
2024,3,1,5,2024-03-01,WN,8797,SLC,PHL,"Salt Lake City, UT",Utah,"Philadelphia, PA",Pennsylvania,1048,995,11,5,1059,1000,18,13,1077,987,1587,196,216,227,0,,0,0.0,0.0,0.0,0.0,0.0
2024,4,13,6,2024-04-13,G4,5340,DFW,PHX,"Dallas/Fort Worth, TX",Texas,"Phoenix, AZ",Arizona,1257,1936,-5,5,1252,1941,28,13,1280,1928,2671,325,345,366,0,,0,0.0,0.0,0.0,0.0,0.0
2024,2,11,7,2024-02-11,UA,4915,BOS,SAN,"Boston, MA",Massachusetts,"San Diego, CA",California,1968,1505,-7,-10,1961,1495,19,10,1980,1485,812,102,122,131,0,,0,0.0,0.0,0.0,0.0,0.0
2024,1,25,4,2024-01-25,YX,9686,JFK,PHX,"New York, NY",New York,"Phoenix, AZ",Arizona,2163,1091,1,0,2164,1091,25,11,2189,1080,1378,162,182,198,0,,0,0.0,0.0,0.0,0.0,0.0
2024,2,8,4,2024-02-08,AS,356,SEA,DFW,"Seattle, WA",Washington,"Dallas/Fort Worth, TX",Texas,1658,2027,0,0,1658,2027,14,5,1672,2022,1398,183,203,202,0,,0,0.0,0.0,0.0,0.0,0.0
2024,10,17,4,2024-10-17,AS,1820,HNL,MSP,"Honolulu, HI",Hawaii,"Minneapolis, MN",Minnesota,1357,976,9,0,1366,976,21,3,1387,973,1071,128,148,152,0,,0,0.0,0.0,0.0,0.0,0.0
2024,5,10,5,2024-05-10,NK,7447,EWR,LGA,"Newark, NJ",New Jersey,"New York, NY",New York,2099,2267,28,20,2127,2287,12,4,2139,2283,980,113,133,129,0,,0,7.0,2.0,2.0,0.0,9.0
2024,8,16,5,2024-08-16,G4,7176,ATL,BOS,"Atlanta, GA",Georgia,"Boston, MA",Massachusetts,1285,1258,-22,-15,1263,1243,23,4,1286,1239,2557,321,341,348,0,,0,0.0,0.0,0.0,0.0,0.0
2024,4,17,3,2024-04-17,YX,1171,DEN,SAN,"Denver, CO",Colorado,"San Diego, CA",California,1040,1140,1,-5,1041,1135,8,5,1049,1130,461,66,86,79,0,,0,0.0,0.0,0.0,0.0,0.0
2024,6,20,4,2024-06-20,NK,1722,IAH,MSP,"Houston, TX",Texas,"Minneapolis, MN",Minnesota,986,1438,17,10,1003,1448,14,19,1017,1429,2150,265,285,298,0,,0,0.0,0.0,0.0,0.0,0.0
2024,4,11,4,2024-04-11,OH,2166,LGA,TPA,"New York, NY",New York,"Tampa, FL",Florida,2261,919,-12,-5,2249,914,27,14,2276,900,798,106,126,147,0,,0,0.0,0.0,0.0,0.0,0.0
2024,12,19,4,2024-12-19,AA,9361,PHL,DEN,"Philadelphia, PA",Pennsylvania,"Denver, CO",Colorado,1071,824,-15,-5,1056,819,29,8,1085,811,2225,283,303,320,0,,0,0.0,0.0,0.0,0.0,0.0
2024,1,12,5,2024-01-12,HA,8742,HNL,MIA,"Honolulu, HI",Hawaii,"Miami, FL",Florida,2009,1055,0,5,2009,1060,8,9,2017,1051,2433,295,315,312,0,,0,0.0,0.0,0.0,0.0,0.0
2024,10,1,2,2024-10-01,F9,997,SAN,LAX,"San Diego, CA",California,"Los Angeles, CA",California,2089,1250,1,5,2090,1255,24,19,2114,1236,2740,347,367,390,0,,0,0.0,0.0,0.0,0.0,0.0
2024,4,10,3,2024-04-10,B6,5275,PHL,MCO,"Philadelphia, PA",Pennsylvania,"Orlando, FL",Florida,1339,1912,-30,-20,1309,1892,26,11,1335,1881,1261,149,169,186,0,,0,0.0,0.0,0.0,0.0,0.0
2024,2,13,2,2024-02-13,G4,8373,LAX,PHX,"Los Angeles, CA",California,"Phoenix, AZ",Arizona,1160,1904,-5,0,1155,1904,29,14,1184,1890,951,123,143,166,0,,0,0.0,0.0,0.0,0.0,0.0
2024,10,31,4,2024-10-31,9E,9028,MIA,LAS,"Miami, FL",Florida,"Las Vegas, NV",Nevada,904,1016,-13,-5,891,1011,8,16,899,995,1213,156,176,180,0,,0,0.0,0.0,0.0,0.0,0.0
2024,1,17,3,2024-01-17,MQ,4274,MDW,JFK,"Chicago, IL",Illinois,"New York, NY",New York,2093,2107,5,0,2098,2107,14,13,2112,2094,1767,218,238,245,0,,0,0.0,0.0,0.0,0.0,0.0
2024,11,25,1,2024-11-25,HA,5881,IAD,JFK,"Washington, DC",District of Columbia,"New York, NY",New York,1956,2161,-9,0,1947,2161,28,6,1975,2155,2985,381,401,415,0,,0,0.0,0.0,0.0,0.0,0.0
2024,2,26,1,2024-02-26,YX,4044,IAD,BWI,"Washington, DC",District of Columbia,"Baltimore, MD",Maryland,2071,1403,-4,5,2067,1408,7,8,2074,1400,1841,230,250,245,0,,0,0.0,0.0,0.0,0.0,0.0
2024,11,6,3,2024-11-06,B6,6526,STL,IAD,"St. Louis, MO",Missouri,"Washington, DC",District of Columbia,1156,1378,5,5,1161,1383,22,18,1183,1365,1107,129,149,169,0,,0,0.0,0.0,0.0,0.0,0.0
2024,10,29,2,2024-10-29,B6,5535,STL,ORD,"St. Louis, MO",Missouri,"Chicago, IL",Illinois,1773,1397,-1,-10,1772,1387,18,18,1790,1369,2859,362,382,398,0,,0,0.0,0.0,0.0,0.0,0.0
2024,1,12,5,2024-01-12,HA,9983,DTW,TPA,"Detroit, MI",Michigan,"Tampa, FL",Florida,1603,1936,-10,-10,1593,1926,24,6,1617,1920,2151,273,293,303,0,,0,0.0,0.0,0.0,0.0,0.0
2024,11,13,3,2024-11-13,YX,9471,DTW,IAD,"Detroit, MI",Michigan,"Washington, DC",District of Columbia,1448,1208,-8,-5,1440,1203,18,7,1458,1196,852,110,130,135,0,,0,0.0,0.0,0.0,0.0,0.0
2024,3,20,3,2024-03-20,YX,3035,ORD,SFO,"Chicago, IL",Illinois,"San Francisco, CA",California,514,2273,-2,-10,512,2263,24,12,536,2251,546,77,97,113,0,,0,0.0,0.0,0.0,0.0,0.0
2024,8,3,6,2024-08-03,OH,5933,HNL,EWR,"Honolulu, HI",Hawaii,"Newark, NJ",New Jersey,1474,1392,9,5,1483,1397,27,7,1510,1390,1292,157,177,191,0,,0,0.0,0.0,0.0,0.0,0.0
2024,12,4,3,2024-12-04,DL,8188,IAD,DTW,"Washington, DC",District of Columbia,"Detroit, MI",Michigan,1563,2231,9,0,1572,2231,18,11,1590,2220,689,87,107,116,0,,0,0.0,0.0,0.0,0.0,0.0
2024,9,20,5,2024-09-20,YX,561,SAN,MDW,"San Diego, CA",California,"Chicago, IL",Illinois,1604,1614,-7,-10,1597,1604,11,8,1608,1596,1713,218,238,237,0,,0,0.0,0.0,0.0,0.0,0.0
2024,5,28,2,2024-05-28,OO,216,ATL,TPA,"Atlanta, GA",Georgia,"Tampa, FL",Florida,2033,1680,17,10,2050,1690,13,16,2063,1674,775,87,107,116,0,,0,0.0,0.0,0.0,0.0,0.0
2024,3,21,4,2024-03-21,UA,5885,DEN,DCA,"Denver, CO",Colorado,"Washington, DC",District of Columbia,806,1746,9,0,815,1746,6,18,821,1728,1377,168,188,192,0,,0,0.0,0.0,0.0,0.0,0.0
2024,8,2,5,2024-08-02,9E,6607,MCO,PDX,"Orlando, FL",Florida,"Portland, OR",Oregon,1204,1913,-21,-15,1183,1898,24,5,1207,1893,2808,360,380,389,0,,0,0.0,0.0,0.0,0.0,0.0
2024,7,16,2,2024-07-16,G4,9946,ORD,JFK,"Chicago, IL",Illinois,"New York, NY",New York,896,1197,-19,-10,877,1187,7,3,884,1184,701,88,108,98,0,,0,0.0,0.0,0.0,0.0,0.0
2024,7,18,4,2024-07-18,NK,5930,DFW,TPA,"Dallas/Fort Worth, TX",Texas,"Tampa, FL",Florida,1177,1572,-9,0,1168,1572,16,8,1184,1564,435,63,83,87,0,,0,0.0,0.0,0.0,0.0,0.0
2024,1,25,4,2024-01-25,AA,4661,TPA,PHX,"Tampa, FL",Florida,"Phoenix, AZ",Arizona,1469,1933,-14,-5,1455,1928,23,3,1478,1925,1443,188,208,214,0,,0,0.0,0.0,0.0,0.0,0.0
2024,3,29,5,2024-03-29,UA,8227,PHX,BOS,"Phoenix, AZ",Arizona,"Boston, MA",Massachusetts,1364,2186,1,10,1365,2196,20,8,1385,2188,2441,308,328,336,0,,0,0.0,0.0,0.0,0.0,0.0
2024,9,24,2,2024-09-24,YX,759,EWR,SLC,"Newark, NJ",New Jersey,"Salt Lake City, UT",Utah,1727,1851,-2,0,1725,1851,11,7,1736,1844,2506,304,324,322,0,,0,0.0,0.0,0.0,0.0,0.0
2024,5,22,3,2024-05-22,DL,2222,BOS,SFO,"Boston, MA",Massachusetts,"San Francisco, CA",California,710,605,16,15,726,620,16,14,742,606,694,89,109,119,0,,0,0.0,0.0,0.0,0.0,0.0
2024,2,28,3,2024-02-28,AA,1686,MIA,EWR,"Miami, FL",Florida,"Newark, NJ",New Jersey,898,2066,-6,-15,892,2051,14,8,906,2043,683,94,114,116,0,,0,0.0,0.0,0.0,0.0,0.0
2024,12,30,1,2024-12-30,G4,4782,CLT,LAX,"Charlotte, NC",North Carolina,"Los Angeles, CA",California,1896,909,12,5,1908,914,26,10,1934,904,1372,174,194,210,0,,0,0.0,0.0,0.0,0.0,0.0
2024,1,26,5,2024-01-26,F9,6899,DFW,PHX,"Dallas/Fort Worth, TX",Texas,"Phoenix, AZ",Arizona,1912,1384,2,10,1914,1394,7,7,1921,1387,629,85,105,99,0,,0,0.0,0.0,0.0,0.0,0.0
2024,2,16,5,2024-02-16,HA,8926,BWI,DEN,"Baltimore, MD",Maryland,"Denver, CO",Colorado,757,1455,-2,-10,755,1445,12,17,767,1428,1588,190,210,219,0,,0,0.0,0.0,0.0,0.0,0.0
2024,10,14,1,2024-10-14,B6,7087,MCO,IAD,"Orlando, FL",Florida,"Washington, DC",District of Columbia,614,1504,-10,-15,604,1489,28,16,632,1473,1390,179,199,223,0,,0,0.0,0.0,0.0,0.0,0.0
2024,9,22,7,2024-09-22,OO,8075,MDW,HNL,"Chicago, IL",Illinois,"Honolulu, HI",Hawaii,833,1625,0,0,833,1625,11,18,844,1607,1045,135,155,164,0,,0,0.0,0.0,0.0,0.0,0.0
2024,1,16,2,2024-01-16,YX,2982,CLT,SAN,"Charlotte, NC",North Carolina,"San Diego, CA",California,848,2226,24,20,872,2246,13,8,885,2238,749,95,115,116,0,,0,5.0,2.0,3.0,0.0,10.0
2024,7,17,3,2024-07-17,DL,5349,PHL,EWR,"Philadelphia, PA",Pennsylvania,"Newark, NJ",New Jersey,732,1373,0,0,732,1373,23,19,755,1354,2275,290,310,332,0,,0,0.0,0.0,0.0,0.0,0.0
2024,10,8,2,2024-10-08,AA,2911,DCA,DEN,"Washington, DC",District of Columbia,"Denver, CO",Colorado,2032,1353,-1,0,2031,1353,9,19,2040,1334,2700,332,352,360,0,,0,0.0,0.0,0.0,0.0,0.0
2024,3,26,2,2024-03-26,NK,5627,MDW,JFK,"Chicago, IL",Illinois,"New York, NY",New York,948,1998,13,5,961,2003,26,18,987,1985,1012,120,140,164,0,,0,0.0,0.0,0.0,0.0,0.0
2024,9,6,5,2024-09-06,MQ,1984,IAD,MSP,"Washington, DC",District of Columbia,"Minneapolis, MN",Minnesota,1600,1869,-26,-20,1574,1849,13,3,1587,1846,1837,235,255,251,0,,0,0.0,0.0,0.0,0.0,0.0
2024,9,26,4,2024-09-26,OO,9810,TPA,JFK,"Tampa, FL",Florida,"New York, NY",New York,1327,2095,-2,-5,1325,2090,20,6,1345,2084,261,36,56,62,0,,0,0.0,0.0,0.0,0.0,0.0
2024,11,30,6,2024-11-30,OO,8913,DCA,ORD,"Washington, DC",District of Columbia,"Chicago, IL",Illinois,1107,2214,-17,-15,1090,2199,24,5,1114,2194,2756,335,355,364,0,,0,0.0,0.0,0.0,0.0,0.0
2024,4,26,5,2024-04-26,HA,5173,SEA,IAD,"Seattle, WA",Washington,"Washington, DC",District of Columbia,597,1422,-10,-5,587,1417,25,5,612,1412,367,41,61,71,0,,0,0.0,0.0,0.0,0.0,0.0
2024,1,7,7,2024-01-07,DL,9829,IAH,DEN,"Houston, TX",Texas,"Denver, CO",Colorado,1067,1927,0,10,1067,1937,13,15,1080,1922,430,46,66,74,1,,0,0.0,0.0,0.0,0.0,0.0
2024,5,16,4,2024-05-16,AA,5516,PHL,BWI,"Philadelphia, PA",Pennsylvania,"Baltimore, MD",Maryland,2153,657,6,5,2159,662,16,6,2175,656,2869,366,386,388,0,,0,0.0,0.0,0.0,0.0,0.0
2024,6,24,1,2024-06-24,DL,5900,PHL,DTW,"Philadelphia, PA",Pennsylvania,"Detroit, MI",Michigan,961,1848,63,60,1024,1908,24,13,1048,1895,1258,159,179,196,0,,0,16.0,12.0,6.0,1.0,25.0
2024,11,23,6,2024-11-23,NK,6995,PHL,BWI,"Philadelphia, PA",Pennsylvania,"Baltimore, MD",Maryland,999,2049,-17,-10,982,2039,19,7,1001,2032,921,107,127,133,0,,0,0.0,0.0,0.0,0.0,0.0
2024,11,10,7,2024-11-10,NK,6415,DTW,PHX,"Detroit, MI",Michigan,"Phoenix, AZ",Arizona,1130,1825,-1,-5,1129,1820,22,4,1151,1816,2944,366,386,392,0,,0,0.0,0.0,0.0,0.0,0.0
2024,8,2,5,2024-08-02,9E,5030,SLC,JFK,"Salt Lake City, UT",Utah,"New York, NY",New York,1561,1117,16,10,1577,1127,13,8,1590,1119,412,50,70,71,0,,0,0.0,0.0,0.0,0.0,0.0
2024,3,22,5,2024-03-22,AS,2465,LAX,PHL,"Los Angeles, CA",California,"Philadelphia, PA",Pennsylvania,2220,629,-1,-10,2219,619,7,7,2226,612,2528,323,343,337,0,,0,0.0,0.0,0.0,0.0,0.0
2024,8,10,6,2024-08-10,B6,954,IAD,PDX,"Washington, DC",District of Columbia,"Portland, OR",Oregon,1881,750,-9,-10,1872,740,15,3,1887,737,2758,349,369,367,0,,0,0.0,0.0,0.0,0.0,0.0
2024,4,12,5,2024-04-12,UA,2828,IAH,LAS,"Houston, TX",Texas,"Las Vegas, NV",Nevada,1765,1147,-15,-5,1750,1142,10,13,1760,1129,1702,205,225,228,0,,0,0.0,0.0,0.0,0.0,0.0
2024,9,29,7,2024-09-29,OH,1015,JFK,EWR,"New York, NY",New York,"Newark, NJ",New Jersey,1574,709,-3,-5,1571,704,13,8,1584,696,2518,320,340,341,0,,0,0.0,0.0,0.0,0.0,0.0
2024,1,14,7,2024-01-14,YX,7273,MIA,MCO,"Miami, FL",Florida,"Orlando, FL",Florida,1948,1744,29,30,1977,1774,7,19,1984,1755,2102,267,287,293,0,,0,11.0,8.0,4.0,0.0,7.0
2024,6,7,5,2024-06-07,UA,5038,SLC,ORD,"Salt Lake City, UT",Utah,"Chicago, IL",Illinois,626,840,-7,0,619,840,28,13,647,827,1984,238,258,279,0,,0,0.0,0.0,0.0,0.0,0.0
2024,5,31,5,2024-05-31,OO,231,PDX,IAH,"Portland, OR",Oregon,"Houston, TX",Texas,1626,2225,5,10,1631,2235,13,9,1644,2226,858,101,121,123,0,,0,0.0,0.0,0.0,0.0,0.0
2024,4,17,3,2024-04-17,MQ,9408,TPA,SFO,"Tampa, FL",Florida,"San Francisco, CA",California,976,1653,8,10,984,1663,7,18,991,1645,2426,294,314,319,0,,0,0.0,0.0,0.0,0.0,0.0
2024,7,6,6,2024-07-06,YX,3693,CLT,DCA,"Charlotte, NC",North Carolina,"Washington, DC",District of Columbia,1752,1065,-3,-10,1749,1055,23,7,1772,1048,1364,167,187,197,0,,0,0.0,0.0,0.0,0.0,0.0
2024,10,27,7,2024-10-27,G4,9152,SAN,IAD,"San Diego, CA",California,"Washington, DC",District of Columbia,1222,1064,-4,5,1218,1069,8,9,1226,1060,550,73,93,90,0,,0,0.0,0.0,0.0,0.0,0.0
2024,4,7,7,2024-04-07,WN,393,BOS,LGA,"Boston, MA",Massachusetts,"New York, NY",New York,935,836,-15,-10,920,826,17,5,937,821,1941,237,257,259,0,,0,0.0,0.0,0.0,0.0,0.0
2024,5,10,5,2024-05-10,G4,9291,PHX,PDX,"Phoenix, AZ",Arizona,"Portland, OR",Oregon,1908,1994,-15,-15,1893,1979,21,4,1914,1975,1248,159,179,184,0,,0,0.0,0.0,0.0,0.0,0.0
2024,10,19,6,2024-10-19,WN,3785,LGA,ATL,"New York, NY",New York,"Atlanta, GA",Georgia,584,2305,12,10,596,2315,6,3,602,2312,967,113,133,122,0,,0,0.0,0.0,0.0,0.0,0.0
2024,6,19,3,2024-06-19,DL,8116,DTW,IAD,"Detroit, MI",Michigan,"Washington, DC",District of Columbia,1882,1772,-15,-10,1867,1762,20,10,1887,1752,922,112,132,142,0,,0,0.0,0.0,0.0,0.0,0.0
2024,7,1,1,2024-07-01,HA,7862,DCA,HNL,"Washington, DC",District of Columbia,"Honolulu, HI",Hawaii,1285,973,-4,-5,1281,968,5,9,1286,959,2398,308,328,322,0,,0,0.0,0.0,0.0,0.0,0.0
2024,12,29,7,2024-12-29,WN,6946,CLT,MCO,"Charlotte, NC",North Carolina,"Orlando, FL",Florida,526,1199,3,-5,529,1194,7,12,536,1182,922,118,138,137,0,,0,0.0,0.0,0.0,0.0,0.0
2024,2,8,4,2024-02-08,AS,7684,LAX,CLT,"Los Angeles, CA",California,"Charlotte, NC",North Carolina,1359,1115,-3,-10,1356,1105,20,16,1376,1089,1304,156,176,192,1,,0,0.0,0.0,0.0,0.0,0.0
2024,1,15,1,2024-01-15,AS,7410,PDX,ORD,"Portland, OR",Oregon,"Chicago, IL",Illinois,571,2056,3,-5,574,2051,10,11,584,2040,1026,131,151,152,0,,0,0.0,0.0,0.0,0.0,0.0
2024,1,4,4,2024-01-04,B6,5456,MSP,DTW,"Minneapolis, MN",Minnesota,"Detroit, MI",Michigan,1618,851,-4,-5,1614,846,12,13,1626,833,1111,135,155,160,0,,0,0.0,0.0,0.0,0.0,0.0
2024,12,14,6,2024-12-14,HA,386,SEA,DEN,"Seattle, WA",Washington,"Denver, CO",Colorado,1087,2096,4,-5,1091,2091,9,3,1100,2088,1702,220,240,232,0,,0,0.0,0.0,0.0,0.0,0.0
2024,7,28,7,2024-07-28,HA,8741,SAN,EWR,"San Diego, CA",California,"Newark, NJ",New Jersey,1949,1162,17,15,1966,1177,12,16,1978,1161,506,57,77,85,0,,0,0.0,0.0,0.0,0.0,0.0
2024,6,9,7,2024-06-09,AA,6686,PHL,DTW,"Philadelphia, PA",Pennsylvania,"Detroit, MI",Michigan,1529,1135,4,-5,1533,1130,26,14,1559,1116,2620,328,348,368,0,,0,0.0,0.0,0.0,0.0,0.0
2024,1,16,2,2024-01-16,UA,5403,TPA,MIA,"Tampa, FL",Florida,"Miami, FL",Florida,1613,1669,-27,-20,1586,1649,5,12,1591,1637,2868,350,370,367,0,,0,0.0,0.0,0.0,0.0,0.0
2024,4,17,3,2024-04-17,B6,3216,IAD,DCA,"Washington, DC",District of Columbia,"Washington, DC",District of Columbia,2115,1227,-15,-10,2100,1217,23,5,2123,1212,1361,176,196,204,0,,0,0.0,0.0,0.0,0.0,0.0
2024,11,6,3,2024-11-06,AS,5974,PDX,ORD,"Portland, OR",Oregon,"Chicago, IL",Illinois,1745,2162,7,5,1752,2167,6,6,1758,2161,655,89,109,101,0,,0,0.0,0.0,0.0,0.0,0.0
2024,8,14,3,2024-08-14,OH,7070,LAX,DEN,"Los Angeles, CA",California,"Denver, CO",Colorado,2118,1206,-1,0,2117,1206,10,11,2127,1195,638,74,94,95,0,,0,0.0,0.0,0.0,0.0,0.0
2024,6,18,2,2024-06-18,AA,8248,PHL,SEA,"Philadelphia, PA",Pennsylvania,"Seattle, WA",Washington,2117,1034,12,20,2129,1054,28,14,2157,1040,2625,336,356,378,0,,0,3.0,1.0,1.0,0.0,15.0
2024,2,3,6,2024-02-03,OH,8544,ATL,DFW,"Atlanta, GA",Georgia,"Dallas/Fort Worth, TX",Texas,651,1210,3,5,654,1215,10,11,664,1204,1157,146,166,167,0,,0,0.0,0.0,0.0,0.0,0.0
2024,9,7,6,2024-09-07,OH,9711,ORD,ATL,"Chicago, IL",Illinois,"Atlanta, GA",Georgia,2080,2251,-6,-10,2074,2241,24,11,2098,2230,2036,252,272,287,0,,0,0.0,0.0,0.0,0.0,0.0
2024,9,3,2,2024-09-03,G4,1335,LAX,IAD,"Los Angeles, CA",California,"Washington, DC",District of Columbia,1735,875,-21,-15,1714,860,24,18,1738,842,480,67,87,109,0,,0,0.0,0.0,0.0,0.0,0.0
2024,9,25,3,2024-09-25,OH,1099,DCA,PHX,"Washington, DC",District of Columbia,"Phoenix, AZ",Arizona,1082,1447,-2,0,1080,1447,13,7,1093,1440,1409,179,199,199,0,,0,0.0,0.0,0.0,0.0,0.0
2024,5,20,1,2024-05-20,UA,3860,LGA,MSP,"New York, NY",New York,"Minneapolis, MN",Minnesota,1786,2131,9,5,1795,2136,5,7,1800,2129,2850,353,373,365,0,,0,0.0,0.0,0.0,0.0,0.0
2024,9,30,1,2024-09-30,9E,4216,PDX,ORD,"Portland, OR",Oregon,"Chicago, IL",Illinois,1905,1718,-8,-10,1897,1708,6,16,1903,1692,2311,288,308,310,0,,0,0.0,0.0,0.0,0.0,0.0
2024,4,5,5,2024-04-05,MQ,4511,BOS,SFO,"Boston, MA",Massachusetts,"San Francisco, CA",California,2093,2334,-8,0,2085,2334,24,16,2109,2318,2931,373,393,413,0,,0,0.0,0.0,0.0,0.0,0.0
2024,8,14,3,2024-08-14,UA,5657,ATL,PHL,"Atlanta, GA",Georgia,"Philadelphia, PA",Pennsylvania,556,1769,18,10,574,1779,23,17,597,1762,1887,242,262,282,0,,0,0.0,0.0,0.0,0.0,0.0
2024,2,8,4,2024-02-08,OO,9738,MIA,EWR,"Miami, FL",Florida,"Newark, NJ",New Jersey,925,1503,-4,5,921,1508,20,18,941,1490,1018,131,151,169,0,,0,0.0,0.0,0.0,0.0,0.0
2024,10,28,1,2024-10-28,DL,5452,PDX,TPA,"Portland, OR",Oregon,"Tampa, FL",Florida,2146,1266,12,5,2158,1271,13,9,2171,1262,863,102,122,124,0,,0,0.0,0.0,0.0,0.0,0.0
2024,1,29,1,2024-01-29,F9,3783,JFK,BWI,"New York, NY",New York,"Baltimore, MD",Maryland,641,1381,8,5,649,1386,9,13,658,1373,743,98,118,120,0,,0,0.0,0.0,0.0,0.0,0.0
2024,11,13,3,2024-11-13,HA,2361,DFW,STL,"Dallas/Fort Worth, TX",Texas,"St. Louis, MO",Missouri,1067,2025,-13,-15,1054,2010,28,6,1082,2004,1897,234,254,268,0,,0,0.0,0.0,0.0,0.0,0.0
2024,9,1,7,2024-09-01,MQ,1953,PDX,DFW,"Portland, OR",Oregon,"Dallas/Fort Worth, TX",Texas,2047,1432,-13,-10,2034,1422,24,7,2058,1415,1275,168,188,199,0,,0,0.0,0.0,0.0,0.0,0.0
2024,8,23,5,2024-08-23,UA,8891,MCO,BWI,"Orlando, FL",Florida,"Baltimore, MD",Maryland,1538,1103,-21,-20,1517,1083,15,16,1532,1067,2502,317,337,348,0,,0,0.0,0.0,0.0,0.0,0.0
2024,7,3,3,2024-07-03,AS,6995,IAD,MIA,"Washington, DC",District of Columbia,"Miami, FL",Florida,1531,2038,-24,-15,1507,2023,24,11,1531,2012,2285,276,296,311,0,,0,0.0,0.0,0.0,0.0,0.0
2024,9,28,6,2024-09-28,DL,3090,DEN,LAX,"Denver, CO",Colorado,"Los Angeles, CA",California,1754,875,14,15,1768,890,18,11,1786,879,2730,331,351,360,0,,0,0.0,0.0,0.0,0.0,0.0
2024,8,23,5,2024-08-23,NK,962,IAD,DTW,"Washington, DC",District of Columbia,"Detroit, MI",Michigan,1709,925,-19,-10,1690,915,17,13,1707,902,1084,137,157,167,0,,0,0.0,0.0,0.0,0.0,0.0
2024,8,26,1,2024-08-26,MQ,4627,EWR,JFK,"Newark, NJ",New Jersey,"New York, NY",New York,1576,1879,-2,5,1574,1884,7,14,1581,1870,2447,301,321,322,0,,0,0.0,0.0,0.0,0.0,0.0
2024,9,22,7,2024-09-22,WN,1319,MCO,LAS,"Orlando, FL",Florida,"Las Vegas, NV",Nevada,636,1156,3,5,639,1161,29,17,668,1144,463,65,85,111,0,,0,0.0,0.0,0.0,0.0,0.0
2024,12,24,2,2024-12-24,G4,3895,DFW,PHX,"Dallas/Fort Worth, TX",Texas,"Phoenix, AZ",Arizona,673,1112,-1,0,672,1112,6,4,678,1108,945,110,130,120,0,,0,0.0,0.0,0.0,0.0,0.0
2024,12,5,4,2024-12-05,OH,627,MSP,BWI,"Minneapolis, MN",Minnesota,"Baltimore, MD",Maryland,1359,1770,-7,0,1352,1770,20,14,1372,1756,1170,147,167,181,0,,0,0.0,0.0,0.0,0.0,0.0
2024,3,5,2,2024-03-05,9E,7469,SLC,SAN,"Salt Lake City, UT",Utah,"San Diego, CA",California,718,894,-8,0,710,894,15,5,725,889,2418,303,323,323,0,,0,0.0,0.0,0.0,0.0,0.0
2024,6,25,2,2024-06-25,G4,3022,IAH,SLC,"Houston, TX",Texas,"Salt Lake City, UT",Utah,1786,974,-9,-5,1777,969,7,17,1784,952,698,93,113,117,0,,0,0.0,0.0,0.0,0.0,0.0
2024,1,3,3,2024-01-03,NK,5949,SAN,TPA,"San Diego, CA",California,"Tampa, FL",Florida,754,2290,20,15,774,2305,19,16,793,2289,660,88,108,123,0,,0,0.0,0.0,0.0,0.0,0.0
2024,5,21,2,2024-05-21,HA,1262,LAS,BWI,"Las Vegas, NV",Nevada,"Baltimore, MD",Maryland,1311,655,-26,-20,1285,635,7,5,1292,630,2658,339,359,351,0,,0,0.0,0.0,0.0,0.0,0.0
2024,6,6,4,2024-06-06,YX,946,MDW,MCO,"Chicago, IL",Illinois,"Orlando, FL",Florida,769,1511,-13,-15,756,1496,23,17,779,1479,778,89,109,129,0,,0,0.0,0.0,0.0,0.0,0.0
2024,11,19,2,2024-11-19,F9,7059,DCA,DTW,"Washington, DC",District of Columbia,"Detroit, MI",Michigan,2110,1849,-1,0,2109,1849,8,13,2117,1836,1801,234,254,255,0,,0,0.0,0.0,0.0,0.0,0.0
2024,5,25,6,2024-05-25,UA,3186,DTW,MCO,"Detroit, MI",Michigan,"Orlando, FL",Florida,723,2142,-14,-5,709,2137,25,11,734,2126,1367,174,194,210,0,,0,0.0,0.0,0.0,0.0,0.0
2024,10,19,6,2024-10-19,OO,3383,MDW,SFO,"Chicago, IL",Illinois,"San Francisco, CA",California,1382,619,0,-5,1382,614,26,9,1408,605,2688,327,347,362,0,,0,0.0,0.0,0.0,0.0,0.0
2024,6,1,6,2024-06-01,B6,3423,PDX,LAX,"Portland, OR",Oregon,"Los Angeles, CA",California,1103,1782,69,60,1172,1842,9,9,1181,1833,2309,284,304,302,0,,0,14.0,0.0,5.0,0.0,41.0
2024,7,11,4,2024-07-11,DL,545,MSP,DCA,"Minneapolis, MN",Minnesota,"Washington, DC",District of Columbia,1657,2093,-5,5,1652,2098,13,9,1665,2089,2210,278,298,300,0,,0,0.0,0.0,0.0,0.0,0.0
2024,3,13,3,2024-03-13,9E,1125,PHL,ORD,"Philadelphia, PA",Pennsylvania,"Chicago, IL",Illinois,1686,1451,5,10,1691,1461,11,19,1702,1442,1968,248,268,278,0,,0,0.0,0.0,0.0,0.0,0.0
2024,10,31,4,2024-10-31,NK,1459,SLC,MDW,"Salt Lake City, UT",Utah,"Chicago, IL",Illinois,2233,1190,3,-5,2236,1185,27,6,2263,1179,924,123,143,156,0,,0,0.0,0.0,0.0,0.0,0.0
2024,12,9,1,2024-12-09,MQ,8310,JFK,BOS,"New York, NY",New York,"Boston, MA",Massachusetts,1200,1520,-20,-10,1180,1510,27,6,1207,1504,1672,204,224,237,0,,0,0.0,0.0,0.0,0.0,0.0
2024,5,19,7,2024-05-19,F9,6213,MSP,DTW,"Minneapolis, MN",Minnesota,"Detroit, MI",Michigan,1419,965,-1,5,1418,970,17,9,1435,961,1369,170,190,196,0,,0,0.0,0.0,0.0,0.0,0.0
2024,7,5,5,2024-07-05,G4,8852,BOS,BWI,"Boston, MA",Massachusetts,"Baltimore, MD",Maryland,572,600,11,10,583,610,27,4,610,606,2498,309,329,340,0,,0,0.0,0.0,0.0,0.0,0.0
2024,10,19,6,2024-10-19,OO,571,ORD,ATL,"Chicago, IL",Illinois,"Atlanta, GA",Georgia,1397,1512,6,0,1403,1512,22,7,1425,1505,2839,353,373,382,0,,0,0.0,0.0,0.0,0.0,0.0
2024,3,1,5,2024-03-01,OO,127,STL,DCA,"St. Louis, MO",Missouri,"Washington, DC",District of Columbia,2241,1447,18,10,2259,1457,28,12,2287,1445,1645,200,220,240,0,,0,0.0,0.0,0.0,0.0,0.0
2024,7,16,2,2024-07-16,NK,8851,BWI,SEA,"Baltimore, MD",Maryland,"Seattle, WA",Washington,1446,1852,17,20,1463,1872,19,16,1482,1856,857,108,128,143,0,,0,0.0,4.0,2.0,0.0,14.0
2024,10,21,1,2024-10-21,9E,3336,DEN,BWI,"Denver, CO",Colorado,"Baltimore, MD",Maryland,1042,1324,-1,0,1041,1324,16,5,1057,1319,981,112,132,133,0,,0,0.0,0.0,0.0,0.0,0.0
2024,11,14,4,2024-11-14,HA,9236,LAX,PHL,"Los Angeles, CA",California,"Philadelphia, PA",Pennsylvania,1130,1906,-18,-10,1112,1896,14,5,1126,1891,2744,334,354,353,0,,0,0.0,0.0,0.0,0.0,0.0
2024,10,28,1,2024-10-28,9E,4048,LAS,MSP,"Las Vegas, NV",Nevada,"Minneapolis, MN",Minnesota,1294,1359,-2,0,1292,1359,21,15,1313,1344,2913,364,384,400,0,,0,0.0,0.0,0.0,0.0,0.0
2024,12,9,1,2024-12-09,MQ,6272,STL,LAX,"St. Louis, MO",Missouri,"Los Angeles, CA",California,2007,1742,26,30,2033,1772,10,9,2043,1763,1805,217,237,236,0,,0,9.0,1.0,0.0,0.0,20.0
2024,1,11,4,2024-01-11,F9,2079,TPA,ATL,"Tampa, FL",Florida,"Atlanta, GA",Georgia,1377,826,-15,-10,1362,816,15,8,1377,808,978,112,132,135,0,,0,0.0,0.0,0.0,0.0,0.0
2024,3,2,6,2024-03-02,YX,5021,PDX,MIA,"Portland, OR",Oregon,"Miami, FL",Florida,2194,1647,4,0,2198,1647,7,15,2205,1632,480,53,73,75,0,,0,0.0,0.0,0.0,0.0,0.0
2024,11,28,4,2024-11-28,G4,9107,BOS,PDX,"Boston, MA",Massachusetts,"Portland, OR",Oregon,1778,1301,7,5,1785,1306,10,7,1795,1299,650,73,93,90,0,,0,0.0,0.0,0.0,0.0,0.0
2024,8,13,2,2024-08-13,AS,2426,DTW,MCO,"Detroit, MI",Michigan,"Orlando, FL",Florida,1256,907,-7,-10,1249,897,26,8,1275,889,1473,190,210,224,0,,0,0.0,0.0,0.0,0.0,0.0
2024,6,1,6,2024-06-01,YX,2430,CLT,LAS,"Charlotte, NC",North Carolina,"Las Vegas, NV",Nevada,1117,1930,-6,0,1111,1930,28,14,1139,1916,1668,217,237,259,0,,0,0.0,0.0,0.0,0.0,0.0
2024,7,17,3,2024-07-17,YX,7746,BWI,ORD,"Baltimore, MD",Maryland,"Chicago, IL",Illinois,697,1561,-14,-5,683,1556,24,10,707,1546,1903,233,253,267,0,,0,0.0,0.0,0.0,0.0,0.0
2024,2,21,3,2024-02-21,9E,1102,STL,HNL,"St. Louis, MO",Missouri,"Honolulu, HI",Hawaii,1950,1168,6,10,1956,1178,16,17,1972,1161,1232,155,175,188,0,,0,0.0,0.0,0.0,0.0,0.0
2024,9,16,1,2024-09-16,DL,9834,MCO,JFK,"Orlando, FL",Florida,"New York, NY",New York,992,2117,-5,5,987,2122,7,10,994,2112,613,84,104,101,0,,0,0.0,0.0,0.0,0.0,0.0
2024,2,28,3,2024-02-28,DL,6548,MSP,DTW,"Minneapolis, MN",Minnesota,"Detroit, MI",Michigan,2155,2131,15,10,2170,2141,6,15,2176,2126,689,81,101,102,0,,0,0.0,0.0,0.0,0.0,0.0
2024,3,12,2,2024-03-12,WN,6937,IAD,MSP,"Washington, DC",District of Columbia,"Minneapolis, MN",Minnesota,581,1934,-14,-10,567,1924,26,9,593,1915,1628,199,219,234,0,,0,0.0,0.0,0.0,0.0,0.0
2024,5,27,1,2024-05-27,HA,6567,DFW,BOS,"Dallas/Fort Worth, TX",Texas,"Boston, MA",Massachusetts,1831,1712,-16,-20,1815,1692,7,18,1822,1674,1053,125,145,150,0,,0,0.0,0.0,0.0,0.0,0.0
2024,12,14,6,2024-12-14,G4,9521,SLC,PDX,"Salt Lake City, UT",Utah,"Portland, OR",Oregon,2222,1898,5,10,2227,1908,17,7,2244,1901,2387,291,311,315,0,,0,0.0,0.0,0.0,0.0,0.0
2024,3,3,7,2024-03-03,NK,7454,TPA,ORD,"Tampa, FL",Florida,"Chicago, IL",Illinois,873,1220,4,-5,877,1215,24,17,901,1198,753,94,114,135,0,,0,0.0,0.0,0.0,0.0,0.0
2024,11,5,2,2024-11-05,DL,2629,MCO,BWI,"Orlando, FL",Florida,"Baltimore, MD",Maryland,2087,1252,-2,-10,2085,1242,13,17,2098,1225,323,39,59,69,0,,0,0.0,0.0,0.0,0.0,0.0
2024,8,30,5,2024-08-30,F9,1530,IAH,STL,"Houston, TX",Texas,"St. Louis, MO",Missouri,1982,1396,-17,-15,1965,1381,27,3,1992,1378,892,103,123,133,0,,0,0.0,0.0,0.0,0.0,0.0
2024,11,25,1,2024-11-25,OO,4012,DCA,DFW,"Washington, DC",District of Columbia,"Dallas/Fort Worth, TX",Texas,1000,1079,-5,0,995,1079,21,6,1016,1073,1525,197,217,224,0,,0,0.0,0.0,0.0,0.0,0.0
2024,4,16,2,2024-04-16,NK,1632,LAS,MCO,"Las Vegas, NV",Nevada,"Orlando, FL",Florida,856,1501,-4,-10,852,1491,18,6,870,1485,2829,357,377,381,0,,0,0.0,0.0,0.0,0.0,0.0
2024,8,13,2,2024-08-13,G4,1992,DTW,SLC,"Detroit, MI",Michigan,"Salt Lake City, UT",Utah,1819,2080,-6,0,1813,2080,24,17,1837,2063,2594,325,345,366,0,,0,0.0,0.0,0.0,0.0,0.0
2024,11,8,5,2024-11-08,F9,1521,LAX,SAN,"Los Angeles, CA",California,"San Diego, CA",California,1079,1496,9,5,1088,1501,12,5,1100,1496,2985,378,398,395,0,,0,0.0,0.0,0.0,0.0,0.0
2024,8,5,1,2024-08-05,UA,8682,LAS,BWI,"Las Vegas, NV",Nevada,"Baltimore, MD",Maryland,799,1519,-4,0,795,1519,8,8,803,1511,2198,268,288,284,0,,0,0.0,0.0,0.0,0.0,0.0
2024,8,28,3,2024-08-28,AA,5868,HNL,MSP,"Honolulu, HI",Hawaii,"Minneapolis, MN",Minnesota,1145,1185,18,15,1163,1200,5,16,1168,1184,1283,159,179,180,0,,0,0.0,0.0,0.0,0.0,0.0
2024,9,15,7,2024-09-15,DL,2918,EWR,DCA,"Newark, NJ",New Jersey,"Washington, DC",District of Columbia,1866,1978,-1,-10,1865,1968,14,4,1879,1964,2814,351,371,369,0,,0,0.0,0.0,0.0,0.0,0.0
2024,9,18,3,2024-09-18,HA,5717,JFK,DEN,"New York, NY",New York,"Denver, CO",Colorado,619,861,7,0,626,861,17,18,643,843,2070,248,268,283,0,,0,0.0,0.0,0.0,0.0,0.0
2024,1,5,5,2024-01-05,OH,1295,SLC,IAH,"Salt Lake City, UT",Utah,"Houston, TX",Texas,2092,1799,-4,-10,2088,1789,6,5,2094,1784,2502,317,337,328,0,,0,0.0,0.0,0.0,0.0,0.0
2024,9,17,2,2024-09-17,MQ,6329,SFO,STL,"San Francisco, CA",California,"St. Louis, MO",Missouri,685,1003,17,10,702,1013,9,8,711,1005,2795,350,370,367,0,,0,0.0,0.0,0.0,0.0,0.0
2024,2,23,5,2024-02-23,DL,9149,JFK,ATL,"New York, NY",New York,"Atlanta, GA",Georgia,1083,1853,6,15,1089,1868,10,5,1099,1863,257,23,43,38,0,,0,0.0,0.0,0.0,0.0,0.0
2024,2,16,5,2024-02-16,WN,5405,DFW,LAX,"Dallas/Fort Worth, TX",Texas,"Los Angeles, CA",California,1681,2211,2,-5,1683,2206,5,17,1688,2189,2354,295,315,317,0,,0,0.0,0.0,0.0,0.0,0.0
2024,8,2,5,2024-08-02,AS,9808,DTW,LAS,"Detroit, MI",Michigan,"Las Vegas, NV",Nevada,1751,1946,-2,-5,1749,1941,9,7,1758,1934,804,91,111,107,0,,0,0.0,0.0,0.0,0.0,0.0
2024,6,25,2,2024-06-25,WN,8177,LGA,SAN,"New York, NY",New York,"San Diego, CA",California,807,1294,-17,-10,790,1284,28,3,818,1281,2043,255,275,286,0,,0,0.0,0.0,0.0,0.0,0.0
2024,1,9,2,2024-01-09,G4,9445,LAS,HNL,"Las Vegas, NV",Nevada,"Honolulu, HI",Hawaii,733,1385,6,10,739,1395,19,19,758,1376,1828,220,240,258,0,,0,0.0,0.0,0.0,0.0,0.0
2024,4,8,1,2024-04-08,WN,942,PHL,ATL,"Philadelphia, PA",Pennsylvania,"Atlanta, GA",Georgia,1534,876,1,5,1535,881,12,14,1547,867,2773,340,360,366,0,,0,0.0,0.0,0.0,0.0,0.0
2024,1,20,6,2024-01-20,AS,5300,DEN,MDW,"Denver, CO",Colorado,"Chicago, IL",Illinois,674,1276,0,10,674,1286,22,12,696,1274,2961,374,394,408,0,,0,0.0,0.0,0.0,0.0,0.0
2024,8,28,3,2024-08-28,AS,6021,BOS,LGA,"Boston, MA",Massachusetts,"New York, NY",New York,1272,1898,-18,-15,1254,1883,29,4,1283,1879,1133,135,155,168,0,,0,0.0,0.0,0.0,0.0,0.0
2024,3,1,5,2024-03-01,9E,9974,STL,DEN,"St. Louis, MO",Missouri,"Denver, CO",Colorado,1142,816,9,0,1151,816,22,10,1173,806,1481,193,213,225,0,,0,0.0,0.0,0.0,0.0,0.0
2024,6,26,3,2024-06-26,OO,394,PDX,BWI,"Portland, OR",Oregon,"Baltimore, MD",Maryland,1410,789,4,5,1414,794,8,18,1422,776,2620,328,348,354,0,,0,0.0,0.0,0.0,0.0,0.0
2024,12,3,2,2024-12-03,9E,6197,IAD,SFO,"Washington, DC",District of Columbia,"San Francisco, CA",California,1525,1641,8,10,1533,1651,24,11,1557,1640,490,58,78,93,0,,0,0.0,0.0,0.0,0.0,0.0
2024,3,2,6,2024-03-02,AA,6512,IAH,MCO,"Houston, TX",Texas,"Orlando, FL",Florida,1260,1343,-9,-5,1251,1338,24,10,1275,1328,931,108,128,142,0,,0,0.0,0.0,0.0,0.0,0.0
2024,5,24,5,2024-05-24,F9,8936,MSP,PDX,"Minneapolis, MN",Minnesota,"Portland, OR",Oregon,2235,2037,-13,-5,2222,2032,11,19,2233,2013,2401,302,322,332,0,,0,0.0,0.0,0.0,0.0,0.0
2024,8,3,6,2024-08-03,YX,6778,ATL,LGA,"Atlanta, GA",Georgia,"New York, NY",New York,681,1807,16,15,697,1822,12,17,709,1805,2599,324,344,353,0,,0,0.0,0.0,0.0,0.0,0.0
2024,1,3,3,2024-01-03,UA,5120,MDW,LAS,"Chicago, IL",Illinois,"Las Vegas, NV",Nevada,1441,2241,-28,-20,1413,2221,28,4,1441,2217,1366,170,190,202,0,,0,0.0,0.0,0.0,0.0,0.0
2024,6,8,6,2024-06-08,HA,5843,MSP,DFW,"Minneapolis, MN",Minnesota,"Dallas/Fort Worth, TX",Texas,849,842,-6,0,843,842,24,6,867,836,2610,322,342,352,0,,0,0.0,0.0,0.0,0.0,0.0
2024,8,14,3,2024-08-14,MQ,210,HNL,MDW,"Honolulu, HI",Hawaii,"Chicago, IL",Illinois,1138,2049,-4,0,1134,2049,17,8,1151,2041,2974,366,386,391,0,,0,0.0,0.0,0.0,0.0,0.0
2024,9,25,3,2024-09-25,AS,8875,MDW,PHL,"Chicago, IL",Illinois,"Philadelphia, PA",Pennsylvania,1905,652,-14,-15,1891,637,8,17,1899,620,2488,311,331,336,0,,0,0.0,0.0,0.0,0.0,0.0
2024,4,29,1,2024-04-29,UA,9778,ORD,BOS,"Chicago, IL",Illinois,"Boston, MA",Massachusetts,1820,1849,1,-5,1821,1844,26,15,1847,1829,609,74,94,115,0,,0,0.0,0.0,0.0,0.0,0.0
2024,3,29,5,2024-03-29,HA,4964,ORD,EWR,"Chicago, IL",Illinois,"Newark, NJ",New Jersey,1720,2337,8,5,1728,2342,29,5,1757,2337,2393,303,323,337,0,,0,0.0,0.0,0.0,0.0,0.0
2024,11,24,7,2024-11-24,OO,1748,IAH,MSP,"Houston, TX",Texas,"Minneapolis, MN",Minnesota,1809,2221,-13,-5,1796,2216,25,18,1821,2198,2239,284,304,327,0,,0,0.0,0.0,0.0,0.0,0.0
2024,3,8,5,2024-03-08,DL,6481,SEA,IAH,"Seattle, WA",Washington,"Houston, TX",Texas,2079,1161,-15,-5,2064,1156,22,16,2086,1140,999,115,135,153,0,,0,0.0,0.0,0.0,0.0,0.0
2024,12,22,7,2024-12-22,HA,2481,MIA,LAX,"Miami, FL",Florida,"Los Angeles, CA",California,2045,1371,12,5,2057,1376,17,6,2074,1370,1964,245,265,268,0,,0,0.0,0.0,0.0,0.0,0.0
2024,4,7,7,2024-04-07,B6,205,PHX,JFK,"Phoenix, AZ",Arizona,"New York, NY",New York,724,918,33,30,757,948,18,12,775,936,2865,353,373,383,0,,0,4.0,7.0,3.0,0.0,16.0
2024,9,23,1,2024-09-23,OH,5918,LGA,SAN,"New York, NY",New York,"San Diego, CA",California,2251,1306,7,5,2258,1311,13,6,2271,1305,2999,375,395,394,0,,0,0.0,0.0,0.0,0.0,0.0
2024,4,14,7,2024-04-14,AA,9986,PDX,CLT,"Portland, OR",Oregon,"Charlotte, NC",North Carolina,2246,1992,11,10,2257,2002,16,14,2273,1988,2818,346,366,376,0,,0,0.0,0.0,0.0,0.0,0.0
2024,11,18,1,2024-11-18,G4,481,JFK,MIA,"New York, NY",New York,"Miami, FL",Florida,785,847,9,15,794,862,13,7,807,855,1542,199,219,219,0,,0,0.0,0.0,0.0,0.0,0.0
2024,5,2,4,2024-05-02,OO,4456,LAX,STL,"Los Angeles, CA",California,"St. Louis, MO",Missouri,2252,2191,2,10,2254,2201,5,6,2259,2195,1060,133,153,144,0,,0,0.0,0.0,0.0,0.0,0.0
2024,1,29,1,2024-01-29,NK,6018,BOS,IAD,"Boston, MA",Massachusetts,"Washington, DC",District of Columbia,1854,776,33,30,1887,806,13,11,1900,795,2434,301,321,325,0,,0,4.0,8.0,0.0,0.0,18.0
2024,5,16,4,2024-05-16,UA,1416,IAH,DTW,"Houston, TX",Texas,"Detroit, MI",Michigan,2084,2099,1,5,2085,2104,11,3,2096,2101,586,63,83,77,0,,0,0.0,0.0,0.0,0.0,0.0
2024,7,13,6,2024-07-13,WN,5554,PHX,DTW,"Phoenix, AZ",Arizona,"Detroit, MI",Michigan,1686,2285,1,5,1687,2290,5,18,1692,2272,964,112,132,135,0,,0,0.0,0.0,0.0,0.0,0.0
2024,8,13,2,2024-08-13,MQ,4174,SEA,DEN,"Seattle, WA",Washington,"Denver, CO",Colorado,692,612,11,5,703,617,6,10,709,607,1237,147,167,163,0,,0,0.0,0.0,0.0,0.0,0.0
2024,11,27,3,2024-11-27,AS,4904,LGA,IAD,"New York, NY",New York,"Washington, DC",District of Columbia,1668,1984,10,15,1678,1999,22,15,1700,1984,378,44,64,81,0,,0,0.0,0.0,0.0,0.0,0.0
2024,6,18,2,2024-06-18,UA,1006,SEA,LAX,"Seattle, WA",Washington,"Los Angeles, CA",California,1170,888,9,5,1179,893,12,3,1191,890,1836,236,256,251,0,,0,0.0,0.0,0.0,0.0,0.0
2024,1,9,2,2024-01-09,YX,7721,SEA,CLT,"Seattle, WA",Washington,"Charlotte, NC",North Carolina,1191,1030,13,5,1204,1035,5,9,1209,1026,2162,267,287,281,0,,0,0.0,0.0,0.0,0.0,0.0
2024,2,9,5,2024-02-09,NK,762,MCO,BOS,"Orlando, FL",Florida,"Boston, MA",Massachusetts,1037,1175,-6,-10,1031,1165,7,16,1038,1149,2360,286,306,309,0,,0,0.0,0.0,0.0,0.0,0.0
2024,1,25,4,2024-01-25,MQ,6818,IAD,MCO,"Washington, DC",District of Columbia,"Orlando, FL",Florida,1111,1962,11,15,1122,1977,5,10,1127,1967,1675,210,230,225,0,,0,0.0,0.0,0.0,0.0,0.0
2024,9,17,2,2024-09-17,AS,8754,CLT,LGA,"Charlotte, NC",North Carolina,"New York, NY",New York,1400,2240,-11,-5,1389,2235,25,18,1414,2217,1718,222,242,265,0,,0,0.0,0.0,0.0,0.0,0.0
2024,8,13,2,2024-08-13,G4,1042,SLC,BWI,"Salt Lake City, UT",Utah,"Baltimore, MD",Maryland,2146,633,-6,-10,2140,623,24,16,2164,607,1029,125,145,165,0,,0,0.0,0.0,0.0,0.0,0.0
2024,5,3,5,2024-05-03,YX,8449,DTW,PHX,"Detroit, MI",Michigan,"Phoenix, AZ",Arizona,1793,1947,14,5,1807,1952,7,12,1814,1940,1599,197,217,216,0,,0,0.0,0.0,0.0,0.0,0.0
2024,2,7,3,2024-02-07,HA,6515,JFK,MIA,"New York, NY",New York,"Miami, FL",Florida,550,2174,-3,-5,547,2169,12,11,559,2158,2347,302,322,325,0,,0,0.0,0.0,0.0,0.0,0.0
2024,11,23,6,2024-11-23,B6,3409,MSP,SLC,"Minneapolis, MN",Minnesota,"Salt Lake City, UT",Utah,2050,2079,-14,-10,2036,2069,16,9,2052,2060,2565,324,344,349,0,,0,0.0,0.0,0.0,0.0,0.0
2024,9,7,6,2024-09-07,WN,1426,DEN,JFK,"Denver, CO",Colorado,"New York, NY",New York,627,1848,-8,-10,619,1838,11,7,630,1831,2919,372,392,390,0,,0,0.0,0.0,0.0,0.0,0.0
2024,6,24,1,2024-06-24,UA,2206,JFK,MCO,"New York, NY",New York,"Orlando, FL",Florida,2175,1240,-18,-20,2157,1220,24,16,2181,1204,2850,360,380,400,0,,0,0.0,0.0,0.0,0.0,0.0
2024,3,30,6,2024-03-30,9E,4899,DFW,SAN,"Dallas/Fort Worth, TX",Texas,"San Diego, CA",California,2277,732,-13,-15,2264,717,5,10,2269,707,990,131,151,146,0,,0,0.0,0.0,0.0,0.0,0.0
2024,2,6,2,2024-02-06,AA,8939,MSP,DFW,"Minneapolis, MN",Minnesota,"Dallas/Fort Worth, TX",Texas,1569,2103,-3,0,1566,2103,27,12,1593,2091,1769,219,239,258,0,,0,0.0,0.0,0.0,0.0,0.0
2024,11,11,1,2024-11-11,UA,3038,SFO,DTW,"San Francisco, CA",California,"Detroit, MI",Michigan,733,2175,4,10,737,2185,7,13,744,2172,914,123,143,143,0,,0,0.0,0.0,0.0,0.0,0.0
2024,6,24,1,2024-06-24,UA,2583,IAD,BWI,"Washington, DC",District of Columbia,"Baltimore, MD",Maryland,947,1496,-12,-5,935,1491,25,7,960,1484,1502,194,214,226,0,,0,0.0,0.0,0.0,0.0,0.0
2024,10,10,4,2024-10-10,NK,1475,MCO,DEN,"Orlando, FL",Florida,"Denver, CO",Colorado,1083,1581,6,0,1089,1581,16,17,1105,1564,1658,212,232,245,0,,0,0.0,0.0,0.0,0.0,0.0
2024,3,21,4,2024-03-21,NK,7956,PHX,TPA,"Phoenix, AZ",Arizona,"Tampa, FL",Florida,1966,1844,19,10,1985,1854,12,5,1997,1849,1329,168,188,185,0,,0,0.0,0.0,0.0,0.0,0.0
2024,4,23,2,2024-04-23,MQ,344,DEN,MDW,"Denver, CO",Colorado,"Chicago, IL",Illinois,1002,1000,-2,-5,1000,995,13,9,1013,986,879,113,133,135,0,,0,0.0,0.0,0.0,0.0,0.0
2024,2,9,5,2024-02-09,HA,2448,TPA,SLC,"Tampa, FL",Florida,"Salt Lake City, UT",Utah,1106,1205,5,5,1111,1210,19,9,1130,1201,2744,352,372,380,0,,0,0.0,0.0,0.0,0.0,0.0
2024,10,27,7,2024-10-27,YX,9159,ORD,MSP,"Chicago, IL",Illinois,"Minneapolis, MN",Minnesota,1421,1210,-6,-5,1415,1205,15,8,1430,1197,1086,143,163,166,0,,0,0.0,0.0,0.0,0.0,0.0
2024,8,11,7,2024-08-11,AA,579,DCA,ORD,"Washington, DC",District of Columbia,"Chicago, IL",Illinois,784,1683,-10,0,774,1683,27,8,801,1675,1423,181,201,216,0,,0,0.0,0.0,0.0,0.0,0.0
2024,11,13,3,2024-11-13,UA,2035,CLT,PHL,"Charlotte, NC",North Carolina,"Philadelphia, PA",Pennsylvania,1655,1240,-14,-10,1641,1230,10,12,1651,1218,1616,196,216,218,0,,0,0.0,0.0,0.0,0.0,0.0
2024,12,14,6,2024-12-14,MQ,5857,MIA,JFK,"Miami, FL",Florida,"New York, NY",New York,1999,731,15,20,2014,751,9,14,2023,737,1599,192,212,215,0,,0,3.0,2.0,1.0,0.0,14.0
2024,4,24,3,2024-04-24,F9,187,LAS,BWI,"Las Vegas, NV",Nevada,"Baltimore, MD",Maryland,1435,992,-19,-15,1416,977,9,6,1425,971,2261,289,309,304,0,,0,0.0,0.0,0.0,0.0,0.0
2024,7,4,4,2024-07-04,G4,9532,SAN,BWI,"San Diego, CA",California,"Baltimore, MD",Maryland,1043,1412,4,0,1047,1412,20,7,1067,1405,1975,249,269,276,0,,0,0.0,0.0,0.0,0.0,0.0
2024,11,18,1,2024-11-18,NK,8864,MDW,MSP,"Chicago, IL",Illinois,"Minneapolis, MN",Minnesota,855,1527,-15,-10,840,1517,19,18,859,1499,1025,127,147,164,0,,0,0.0,0.0,0.0,0.0,0.0
2024,2,25,7,2024-02-25,NK,9105,LAX,MDW,"Los Angeles, CA",California,"Chicago, IL",Illinois,1560,1180,7,0,1567,1180,15,15,1582,1165,262,22,42,52,0,,0,0.0,0.0,0.0,0.0,0.0
2024,2,9,5,2024-02-09,YX,278,SAN,LGA,"San Diego, CA",California,"New York, NY",New York,2161,613,-14,-5,2147,608,24,3,2171,605,2025,259,279,286,0,,0,0.0,0.0,0.0,0.0,0.0
2024,12,19,4,2024-12-19,HA,262,DEN,SLC,"Denver, CO",Colorado,"Salt Lake City, UT",Utah,637,1034,-7,-5,630,1029,27,3,657,1026,1672,199,219,229,0,,0,0.0,0.0,0.0,0.0,0.0
2024,2,9,5,2024-02-09,OO,2740,SAN,DTW,"San Diego, CA",California,"Detroit, MI",Michigan,1945,1073,-15,-10,1930,1063,21,18,1951,1045,2919,372,392,411,0,,0,0.0,0.0,0.0,0.0,0.0
2024,12,12,4,2024-12-12,F9,9297,PHX,HNL,"Phoenix, AZ",Arizona,"Honolulu, HI",Hawaii,1968,750,-4,-10,1964,740,23,7,1987,733,1871,237,257,267,0,,0,0.0,0.0,0.0,0.0,0.0
2024,8,24,6,2024-08-24,AS,2448,PDX,DEN,"Portland, OR",Oregon,"Denver, CO",Colorado,1111,2309,5,5,1116,2314,26,19,1142,2295,615,67,87,112,0,,0,0.0,0.0,0.0,0.0,0.0
2024,10,15,2,2024-10-15,OO,2521,ORD,LGA,"Chicago, IL",Illinois,"New York, NY",New York,1765,1069,-17,-10,1748,1059,21,9,1769,1050,2627,321,341,351,0,,0,0.0,0.0,0.0,0.0,0.0
2024,9,18,3,2024-09-18,UA,4398,ORD,LAX,"Chicago, IL",Illinois,"Los Angeles, CA",California,1768,1010,1,5,1769,1015,19,6,1788,1009,2482,302,322,327,0,,0,0.0,0.0,0.0,0.0,0.0
2024,8,3,6,2024-08-03,HA,4242,MSP,SLC,"Minneapolis, MN",Minnesota,"Salt Lake City, UT",Utah,2062,944,4,0,2066,944,17,4,2083,940,2781,344,364,365,0,,0,0.0,0.0,0.0,0.0,0.0
2024,5,26,7,2024-05-26,AA,4603,PDX,DFW,"Portland, OR",Oregon,"Dallas/Fort Worth, TX",Texas,1732,1403,-9,-15,1723,1388,27,4,1750,1384,1068,133,153,164,0,,0,0.0,0.0,0.0,0.0,0.0
2024,12,1,7,2024-12-01,NK,1317,MDW,SLC,"Chicago, IL",Illinois,"Salt Lake City, UT",Utah,956,1819,-9,-10,947,1809,22,6,969,1803,2460,302,322,330,0,,0,0.0,0.0,0.0,0.0,0.0
2024,6,16,7,2024-06-16,AA,2574,DCA,STL,"Washington, DC",District of Columbia,"St. Louis, MO",Missouri,598,1143,12,10,610,1153,27,4,637,1149,1156,142,162,173,0,,0,0.0,0.0,0.0,0.0,0.0
2024,4,1,1,2024-04-01,AA,1029,DCA,JFK,"Washington, DC",District of Columbia,"New York, NY",New York,2025,1696,2,0,2027,1696,20,3,2047,1693,1380,178,198,201,0,,0,0.0,0.0,0.0,0.0,0.0
2024,12,18,3,2024-12-18,G4,8058,EWR,SLC,"Newark, NJ",New Jersey,"Salt Lake City, UT",Utah,1660,793,-13,-10,1647,783,24,19,1671,764,2620,331,351,374,0,,0,0.0,0.0,0.0,0.0,0.0
2024,2,28,3,2024-02-28,MQ,8608,PHL,BWI,"Philadelphia, PA",Pennsylvania,"Baltimore, MD",Maryland,1710,1537,1,5,1711,1542,29,10,1740,1532,2476,311,331,350,0,,0,0.0,0.0,0.0,0.0,0.0
2024,2,28,3,2024-02-28,9E,1602,LAS,LAX,"Las Vegas, NV",Nevada,"Los Angeles, CA",California,535,2185,3,10,538,2195,25,11,563,2184,620,81,101,117,0,,0,0.0,0.0,0.0,0.0,0.0
2024,10,30,3,2024-10-30,NK,520,MDW,HNL,"Chicago, IL",Illinois,"Honolulu, HI",Hawaii,1129,2192,-13,-5,1116,2187,5,4,1121,2183,2929,373,393,382,0,,0,0.0,0.0,0.0,0.0,0.0
2024,6,17,1,2024-06-17,MQ,5930,SAN,MCO,"San Diego, CA",California,"Orlando, FL",Florida,1169,1228,6,0,1175,1228,24,6,1199,1222,628,84,104,114,0,,0,0.0,0.0,0.0,0.0,0.0
2024,9,25,3,2024-09-25,OO,4458,LAX,DCA,"Los Angeles, CA",California,"Washington, DC",District of Columbia,2002,1815,-5,-10,1997,1805,17,9,2014,1796,325,38,58,64,0,,0,0.0,0.0,0.0,0.0,0.0
2024,12,28,6,2024-12-28,MQ,1549,MDW,DCA,"Chicago, IL",Illinois,"Washington, DC",District of Columbia,1286,1029,-7,-15,1279,1014,8,13,1287,1001,241,21,41,42,0,,0,0.0,0.0,0.0,0.0,0.0
2024,2,14,3,2024-02-14,WN,5911,DTW,PDX,"Detroit, MI",Michigan,"Portland, OR",Oregon,1180,2124,-14,-5,1166,2119,16,10,1182,2109,1327,172,192,198,0,,0,0.0,0.0,0.0,0.0,0.0
2024,12,10,2,2024-12-10,AS,8719,EWR,MDW,"Newark, NJ",New Jersey,"Chicago, IL",Illinois,554,816,8,5,562,821,19,5,581,816,1385,171,191,195,0,,0,0.0,0.0,0.0,0.0,0.0
2024,6,29,6,2024-06-29,AA,7971,BOS,MSP,"Boston, MA",Massachusetts,"Minneapolis, MN",Minnesota,1994,1620,5,0,1999,1620,24,19,2023,1601,2621,335,355,378,0,,1,0.0,0.0,0.0,0.0,0.0
2024,6,18,2,2024-06-18,NK,8688,PDX,MCO,"Portland, OR",Oregon,"Orlando, FL",Florida,1607,2246,1,-5,1608,2241,16,6,1624,2235,1466,182,202,204,0,,0,0.0,0.0,0.0,0.0,0.0
2024,12,21,6,2024-12-21,YX,9087,DFW,BOS,"Dallas/Fort Worth, TX",Texas,"Boston, MA",Massachusetts,1529,1569,-12,-5,1517,1564,23,18,1540,1546,2321,293,313,334,0,,0,0.0,0.0,0.0,0.0,0.0
2024,7,9,2,2024-07-09,HA,206,DCA,PHL,"Washington, DC",District of Columbia,"Philadelphia, PA",Pennsylvania,1390,1084,-3,0,1387,1084,23,5,1410,1079,2198,264,284,292,0,,0,0.0,0.0,0.0,0.0,0.0
2024,6,3,1,2024-06-03,AS,4149,DEN,MDW,"Denver, CO",Colorado,"Chicago, IL",Illinois,1886,1200,-7,-5,1879,1195,19,18,1898,1177,2914,371,391,408,0,,0,0.0,0.0,0.0,0.0,0.0
2024,7,6,6,2024-07-06,WN,8389,BOS,ORD,"Boston, MA",Massachusetts,"Chicago, IL",Illinois,1506,959,5,0,1511,959,25,3,1536,956,279,24,44,52,0,,0,0.0,0.0,0.0,0.0,0.0
2024,1,7,7,2024-01-07,NK,2003,JFK,TPA,"New York, NY",New York,"Tampa, FL",Florida,1267,1932,-10,-15,1257,1917,9,15,1266,1902,2609,324,344,348,0,,0,0.0,0.0,0.0,0.0,0.0
2024,5,12,7,2024-05-12,UA,7749,PDX,MDW,"Portland, OR",Oregon,"Chicago, IL",Illinois,1417,1268,16,10,1433,1278,15,19,1448,1259,1905,247,267,281,0,,0,0.0,0.0,0.0,0.0,0.0
2024,8,22,4,2024-08-22,AA,3670,HNL,JFK,"Honolulu, HI",Hawaii,"New York, NY",New York,2233,1020,-18,-10,2215,1010,22,14,2237,996,993,129,149,165,0,,0,0.0,0.0,0.0,0.0,0.0
2024,2,14,3,2024-02-14,WN,5476,DFW,SFO,"Dallas/Fort Worth, TX",Texas,"San Francisco, CA",California,1163,1180,6,0,1169,1180,14,18,1183,1162,2555,327,347,359,0,,0,0.0,0.0,0.0,0.0,0.0
2024,11,9,6,2024-11-09,UA,142,LAS,STL,"Las Vegas, NV",Nevada,"St. Louis, MO",Missouri,1329,1381,2,-5,1331,1376,17,4,1348,1372,2170,263,283,284,0,,0,0.0,0.0,0.0,0.0,0.0
2024,9,5,4,2024-09-05,AA,6485,IAH,SLC,"Houston, TX",Texas,"Salt Lake City, UT",Utah,669,2034,12,5,681,2039,29,12,710,2027,1540,182,202,223,0,,0,0.0,0.0,0.0,0.0,0.0
2024,1,31,3,2024-01-31,DL,1677,MIA,DTW,"Miami, FL",Florida,"Detroit, MI",Michigan,2283,1116,5,10,2288,1126,23,5,2311,1121,617,74,94,102,0,,0,0.0,0.0,0.0,0.0,0.0
2024,1,23,2,2024-01-23,OO,6165,MDW,PHX,"Chicago, IL",Illinois,"Phoenix, AZ",Arizona,748,842,-15,-10,733,832,24,14,757,818,2352,303,323,341,0,,0,0.0,0.0,0.0,0.0,0.0
2024,6,8,6,2024-06-08,B6,5985,SLC,MSP,"Salt Lake City, UT",Utah,"Minneapolis, MN",Minnesota,1161,1229,-5,5,1156,1234,19,8,1175,1226,658,88,108,115,0,,0,0.0,0.0,0.0,0.0,0.0
2024,12,28,6,2024-12-28,HA,8676,SAN,DEN,"San Diego, CA",California,"Denver, CO",Colorado,709,1616,-5,-10,704,1606,22,7,726,1599,2250,275,295,304,0,,0,0.0,0.0,0.0,0.0,0.0
2024,6,6,4,2024-06-06,F9,3677,MCO,MDW,"Orlando, FL",Florida,"Chicago, IL",Illinois,1411,771,-9,-15,1402,756,12,3,1414,753,686,84,104,99,0,,0,0.0,0.0,0.0,0.0,0.0
2024,2,8,4,2024-02-08,AA,3338,BWI,CLT,"Baltimore, MD",Maryland,"Charlotte, NC",North Carolina,1239,1254,8,15,1247,1269,27,18,1274,1251,2912,361,381,406,0,,0,0.0,0.0,0.0,0.0,0.0
2024,3,22,5,2024-03-22,WN,5344,SEA,BWI,"Seattle, WA",Washington,"Baltimore, MD",Maryland,1767,1368,-5,-10,1762,1358,7,10,1769,1348,904,114,134,131,0,,0,0.0,0.0,0.0,0.0,0.0
2024,12,21,6,2024-12-21,OH,9988,LAX,SEA,"Los Angeles, CA",California,"Seattle, WA",Washington,640,1059,-1,-10,639,1049,15,15,654,1034,2503,317,337,347,0,,0,0.0,0.0,0.0,0.0,0.0
2024,9,14,6,2024-09-14,WN,2234,ATL,HNL,"Atlanta, GA",Georgia,"Honolulu, HI",Hawaii,1131,1988,-24,-15,1107,1973,9,16,1116,1957,2707,346,366,371,0,,0,0.0,0.0,0.0,0.0,0.0
2024,7,24,3,2024-07-24,B6,3992,SFO,LAX,"San Francisco, CA",California,"Los Angeles, CA",California,1304,1701,1,0,1305,1701,16,13,1321,1688,432,47,67,76,0,,0,0.0,0.0,0.0,0.0,0.0
2024,3,17,7,2024-03-17,NK,4421,MDW,JFK,"Chicago, IL",Illinois,"New York, NY",New York,679,2192,20,15,699,2207,5,14,704,2193,1516,188,208,207,0,,0,0.0,0.0,0.0,0.0,0.0
2024,1,12,5,2024-01-12,MQ,5876,MDW,DFW,"Chicago, IL",Illinois,"Dallas/Fort Worth, TX",Texas,1419,2113,-15,-10,1404,2103,10,15,1414,2088,1601,193,213,218,0,,0,0.0,0.0,0.0,0.0,0.0
2024,10,21,1,2024-10-21,YX,5928,MDW,IAH,"Chicago, IL",Illinois,"Houston, TX",Texas,1136,1131,5,0,1141,1131,10,10,1151,1121,1817,232,252,252,0,,0,0.0,0.0,0.0,0.0,0.0
2024,8,11,7,2024-08-11,F9,3915,DFW,SEA,"Dallas/Fort Worth, TX",Texas,"Seattle, WA",Washington,1253,2149,-9,-5,1244,2144,16,12,1260,2132,2902,354,374,382,0,,0,0.0,0.0,0.0,0.0,0.0
2024,1,13,6,2024-01-13,HA,395,STL,PHL,"St. Louis, MO",Missouri,"Philadelphia, PA",Pennsylvania,2247,1829,-2,-5,2245,1824,25,5,2270,1819,2381,305,325,335,0,,0,0.0,0.0,0.0,0.0,0.0
2024,2,15,4,2024-02-15,AS,513,BOS,BWI,"Boston, MA",Massachusetts,"Baltimore, MD",Maryland,1486,2316,-8,0,1478,2316,29,8,1507,2308,2900,353,373,390,0,,0,0.0,0.0,0.0,0.0,0.0
2024,6,3,1,2024-06-03,AA,6056,CLT,SLC,"Charlotte, NC",North Carolina,"Salt Lake City, UT",Utah,1540,890,-10,0,1530,890,19,18,1549,872,1811,223,243,260,0,,0,0.0,0.0,0.0,0.0,0.0
2024,4,22,1,2024-04-22,NK,6378,SAN,MDW,"San Diego, CA",California,"Chicago, IL",Illinois,1539,2324,1,-5,1540,2319,8,15,1548,2304,1297,162,182,185,0,,0,0.0,0.0,0.0,0.0,0.0
2024,8,20,2,2024-08-20,UA,6768,CLT,DFW,"Charlotte, NC",North Carolina,"Dallas/Fort Worth, TX",Texas,884,2127,19,10,903,2137,22,13,925,2124,1346,164,184,199,0,,0,0.0,0.0,0.0,0.0,0.0
2024,1,17,3,2024-01-17,HA,8295,IAD,SEA,"Washington, DC",District of Columbia,"Seattle, WA",Washington,1864,1258,-22,-15,1842,1243,16,18,1858,1225,2401,295,315,329,0,,0,0.0,0.0,0.0,0.0,0.0
2024,12,25,3,2024-12-25,MQ,277,DFW,MSP,"Dallas/Fort Worth, TX",Texas,"Minneapolis, MN",Minnesota,1392,1451,-19,-15,1373,1436,11,16,1384,1420,2658,330,350,357,0,,0,0.0,0.0,0.0,0.0,0.0
2024,8,10,6,2024-08-10,MQ,9037,STL,SAN,"St. Louis, MO",Missouri,"San Diego, CA",California,1486,1153,41,45,1527,1198,9,9,1536,1189,1757,212,232,230,0,,0,1.0,2.0,0.0,0.0,42.0
2024,12,19,4,2024-12-19,MQ,4454,PHX,IAD,"Phoenix, AZ",Arizona,"Washington, DC",District of Columbia,1268,1027,-2,5,1266,1032,27,8,1293,1024,808,104,124,139,0,,0,0.0,0.0,0.0,0.0,0.0
2024,7,6,6,2024-07-06,AS,8943,LAX,MDW,"Los Angeles, CA",California,"Chicago, IL",Illinois,1291,1070,6,10,1297,1080,27,19,1324,1061,1842,234,254,280,0,,0,0.0,0.0,0.0,0.0,0.0
2024,12,9,1,2024-12-09,HA,6014,IAD,MSP,"Washington, DC",District of Columbia,"Minneapolis, MN",Minnesota,545,1465,-3,0,542,1465,27,17,569,1448,279,42,62,86,0,,0,0.0,0.0,0.0,0.0,0.0
2024,12,30,1,2024-12-30,F9,5582,LGA,LAX,"New York, NY",New York,"Los Angeles, CA",California,1003,1112,-7,-5,996,1107,7,12,1003,1095,1928,249,269,268,0,,0,0.0,0.0,0.0,0.0,0.0
2024,6,11,2,2024-06-11,NK,3371,SFO,BWI,"San Francisco, CA",California,"Baltimore, MD",Maryland,2293,923,4,0,2297,923,9,19,2306,904,2802,355,375,383,0,,0,0.0,0.0,0.0,0.0,0.0
2024,11,21,4,2024-11-21,9E,6787,DTW,PDX,"Detroit, MI",Michigan,"Portland, OR",Oregon,1666,2239,-22,-15,1644,2224,21,4,1665,2220,2480,311,331,336,0,,0,0.0,0.0,0.0,0.0,0.0
2024,3,14,4,2024-03-14,AS,5492,SEA,PHX,"Seattle, WA",Washington,"Phoenix, AZ",Arizona,1808,854,12,5,1820,859,10,19,1830,840,2485,309,329,338,0,,0,0.0,0.0,0.0,0.0,0.0
2024,8,20,2,2024-08-20,G4,389,MCO,HNL,"Orlando, FL",Florida,"Honolulu, HI",Hawaii,1878,1320,1,0,1879,1320,24,15,1903,1305,2312,284,304,323,0,,0,0.0,0.0,0.0,0.0,0.0
2024,8,11,7,2024-08-11,G4,9094,SAN,SEA,"San Diego, CA",California,"Seattle, WA",Washington,1329,2353,15,20,1344,2373,6,4,1350,2369,978,129,149,139,0,,0,5.0,5.0,0.0,0.0,10.0
2024,11,14,4,2024-11-14,AA,8525,MDW,LGA,"Chicago, IL",Illinois,"New York, NY",New York,1024,1189,-7,0,1017,1189,23,4,1040,1185,2885,368,388,395,0,,0,0.0,0.0,0.0,0.0,0.0
2024,2,29,4,2024-02-29,AA,507,DFW,CLT,"Dallas/Fort Worth, TX",Texas,"Charlotte, NC",North Carolina,1478,650,-17,-10,1461,640,19,9,1480,631,2225,275,295,303,0,,0,0.0,0.0,0.0,0.0,0.0
2024,11,30,6,2024-11-30,AA,793,JFK,LGA,"New York, NY",New York,"New York, NY",New York,1056,1399,7,0,1063,1399,7,12,1070,1387,1802,229,249,248,0,,0,0.0,0.0,0.0,0.0,0.0
2024,8,9,5,2024-08-09,F9,1269,DEN,HNL,"Denver, CO",Colorado,"Honolulu, HI",Hawaii,546,699,-25,-15,521,684,5,6,526,678,2470,302,322,313,0,,0,0.0,0.0,0.0,0.0,0.0
2024,2,6,2,2024-02-06,YX,8723,SFO,DFW,"San Francisco, CA",California,"Dallas/Fort Worth, TX",Texas,1027,2347,0,5,1027,2352,27,6,1054,2346,960,122,142,155,0,,0,0.0,0.0,0.0,0.0,0.0
2024,10,4,5,2024-10-04,MQ,7882,IAD,DCA,"Washington, DC",District of Columbia,"Washington, DC",District of Columbia,606,1063,-2,0,604,1063,23,3,627,1060,1025,131,151,157,0,,0,0.0,0.0,0.0,0.0,0.0
2024,7,14,7,2024-07-14,OH,9274,PHX,BOS,"Phoenix, AZ",Arizona,"Boston, MA",Massachusetts,1526,1098,1,-5,1527,1093,11,4,1538,1089,761,99,119,114,0,,0,0.0,0.0,0.0,0.0,0.0
2024,12,17,2,2024-12-17,YX,3144,SAN,TPA,"San Diego, CA",California,"Tampa, FL",Florida,1115,1514,20,20,1135,1534,14,12,1149,1522,2869,349,369,375,0,,0,0.0,1.0,1.0,0.0,18.0
2024,8,29,4,2024-08-29,OH,5630,BOS,MDW,"Boston, MA",Massachusetts,"Chicago, IL",Illinois,1465,836,13,15,1478,851,13,17,1491,834,399,57,77,87,0,,0,0.0,0.0,0.0,0.0,0.0
2024,11,19,2,2024-11-19,9E,5092,DTW,SLC,"Detroit, MI",Michigan,"Salt Lake City, UT",Utah,1618,1071,20,20,1638,1091,20,14,1658,1077,1686,201,221,235,0,,0,0.0,2.0,0.0,0.0,18.0
2024,8,6,2,2024-08-06,NK,4024,IAD,LAX,"Washington, DC",District of Columbia,"Los Angeles, CA",California,1656,2021,-17,-10,1639,2011,19,5,1658,2006,1213,145,165,169,0,,0,0.0,0.0,0.0,0.0,0.0
2024,7,10,3,2024-07-10,UA,7070,LAX,PHX,"Los Angeles, CA",California,"Phoenix, AZ",Arizona,1359,756,7,5,1366,761,17,6,1383,755,229,22,42,45,0,,0,0.0,0.0,0.0,0.0,0.0
2024,1,17,3,2024-01-17,MQ,3412,STL,DEN,"St. Louis, MO",Missouri,"Denver, CO",Colorado,700,897,23,15,723,912,26,11,749,901,1318,155,175,192,0,,0,0.0,0.0,0.0,0.0,0.0
2024,1,12,5,2024-01-12,DL,4418,PHX,SAN,"Phoenix, AZ",Arizona,"San Diego, CA",California,753,1637,-8,0,745,1637,12,16,757,1621,560,76,96,104,0,,0,0.0,0.0,0.0,0.0,0.0
2024,7,11,4,2024-07-11,WN,1788,PHL,DCA,"Philadelphia, PA",Pennsylvania,"Washington, DC",District of Columbia,682,715,-20,-10,662,705,15,12,677,693,602,71,91,98,0,,0,0.0,0.0,0.0,0.0,0.0
2024,1,22,1,2024-01-22,UA,567,SAN,HNL,"San Diego, CA",California,"Honolulu, HI",Hawaii,1673,738,16,10,1689,748,5,12,1694,736,1784,222,242,239,0,,0,0.0,0.0,0.0,0.0,0.0
2024,4,29,1,2024-04-29,NK,9637,LAX,STL,"Los Angeles, CA",California,"St. Louis, MO",Missouri,2072,674,16,10,2088,684,28,7,2116,677,1449,185,205,220,0,,0,0.0,0.0,0.0,0.0,0.0
2024,7,28,7,2024-07-28,9E,2522,LGA,MSP,"New York, NY",New York,"Minneapolis, MN",Minnesota,1480,1414,1,5,1481,1419,12,13,1493,1406,788,105,125,130,0,,0,0.0,0.0,0.0,0.0,0.0
2024,11,1,5,2024-11-01,HA,7379,SFO,EWR,"San Francisco, CA",California,"Newark, NJ",New Jersey,989,1983,-7,-10,982,1973,16,16,998,1957,312,36,56,68,0,,0,0.0,0.0,0.0,0.0,0.0
2024,9,26,4,2024-09-26,HA,4607,DEN,MCO,"Denver, CO",Colorado,"Orlando, FL",Florida,1004,1647,-16,-10,988,1637,23,8,1011,1629,2497,305,325,336,0,,0,0.0,0.0,0.0,0.0,0.0
2024,7,10,3,2024-07-10,F9,4821,LAX,MDW,"Los Angeles, CA",California,"Chicago, IL",Illinois,912,1005,3,0,915,1005,10,13,925,992,1668,208,228,231,0,,0,0.0,0.0,0.0,0.0,0.0
2024,6,23,7,2024-06-23,AS,5471,MIA,SLC,"Miami, FL",Florida,"Salt Lake City, UT",Utah,2031,2312,0,0,2031,2312,20,13,2051,2299,661,78,98,111,0,,0,0.0,0.0,0.0,0.0,0.0
2024,10,11,5,2024-10-11,UA,9303,TPA,MSP,"Tampa, FL",Florida,"Minneapolis, MN",Minnesota,2174,1550,-3,5,2171,1555,18,5,2189,1550,2789,353,373,376,0,,0,0.0,0.0,0.0,0.0,0.0
2024,7,22,1,2024-07-22,AS,7641,ORD,STL,"Chicago, IL",Illinois,"St. Louis, MO",Missouri,2135,1166,-20,-15,2115,1151,26,15,2141,1136,270,25,45,66,0,,0,0.0,0.0,0.0,0.0,0.0
2024,6,12,3,2024-06-12,HA,9969,SLC,SAN,"Salt Lake City, UT",Utah,"San Diego, CA",California,903,2348,-19,-15,884,2333,11,8,895,2325,1473,193,213,212,0,,0,0.0,0.0,0.0,0.0,0.0
2024,9,7,6,2024-09-07,DL,1586,ORD,DFW,"Chicago, IL",Illinois,"Dallas/Fort Worth, TX",Texas,735,925,3,-5,738,920,7,15,745,905,1417,181,201,203,0,,0,0.0,0.0,0.0,0.0,0.0
2024,8,14,3,2024-08-14,HA,9708,BWI,IAH,"Baltimore, MD",Maryland,"Houston, TX",Texas,2119,1957,-12,-10,2107,1947,14,8,2121,1939,1514,187,207,209,0,,0,0.0,0.0,0.0,0.0,0.0
2024,1,7,7,2024-01-07,YX,9649,SEA,DFW,"Seattle, WA",Washington,"Dallas/Fort Worth, TX",Texas,1358,928,-9,0,1349,928,5,14,1354,914,634,87,107,106,0,,0,0.0,0.0,0.0,0.0,0.0
2024,1,29,1,2024-01-29,NK,9683,MSP,IAD,"Minneapolis, MN",Minnesota,"Washington, DC",District of Columbia,1465,2298,-4,-5,1461,2293,29,9,1490,2284,1781,225,245,263,0,,0,0.0,0.0,0.0,0.0,0.0
2024,2,2,5,2024-02-02,OH,9870,DTW,HNL,"Detroit, MI",Michigan,"Honolulu, HI",Hawaii,2068,1923,1,5,2069,1928,10,16,2079,1912,2437,295,315,321,0,,0,0.0,0.0,0.0,0.0,0.0
2024,5,13,1,2024-05-13,OO,3849,DEN,CLT,"Denver, CO",Colorado,"Charlotte, NC",North Carolina,1132,2299,4,5,1136,2304,9,11,1145,2293,1987,257,277,277,0,,0,0.0,0.0,0.0,0.0,0.0
2024,3,19,2,2024-03-19,9E,8159,SFO,MIA,"San Francisco, CA",California,"Miami, FL",Florida,2065,688,-1,-10,2064,678,19,5,2083,673,1669,215,235,239,0,,0,0.0,0.0,0.0,0.0,0.0
2024,2,27,2,2024-02-27,OH,2603,LAS,SLC,"Las Vegas, NV",Nevada,"Salt Lake City, UT",Utah,1957,614,19,15,1976,629,22,17,1998,612,1255,156,176,195,0,,0,0.0,0.0,0.0,0.0,0.0
2024,1,26,5,2024-01-26,NK,7955,BOS,PDX,"Boston, MA",Massachusetts,"Portland, OR",Oregon,2069,1924,13,5,2082,1929,8,9,2090,1920,600,75,95,92,0,,0,0.0,0.0,0.0,0.0,0.0
2024,8,13,2,2024-08-13,WN,7155,HNL,IAD,"Honolulu, HI",Hawaii,"Washington, DC",District of Columbia,2168,1233,-5,0,2163,1233,9,9,2172,1224,1722,222,242,240,0,,0,0.0,0.0,0.0,0.0,0.0
2024,10,11,5,2024-10-11,MQ,499,MSP,PHL,"Minneapolis, MN",Minnesota,"Philadelphia, PA",Pennsylvania,707,1941,24,15,731,1956,14,4,745,1952,2915,354,374,372,0,,0,0.0,0.0,0.0,0.0,0.0
2024,1,4,4,2024-01-04,F9,4482,IAH,ATL,"Houston, TX",Texas,"Atlanta, GA",Georgia,639,777,-8,-10,631,767,8,16,639,751,796,96,116,120,0,,0,0.0,0.0,0.0,0.0,0.0
2024,4,8,1,2024-04-08,WN,1639,ORD,ATL,"Chicago, IL",Illinois,"Atlanta, GA",Georgia,1087,2085,4,-5,1091,2080,14,7,1105,2073,1018,117,137,138,0,,0,0.0,0.0,0.0,0.0,0.0
2024,2,8,4,2024-02-08,NK,8528,LGA,DCA,"New York, NY",New York,"Washington, DC",District of Columbia,1086,868,-14,-15,1072,853,24,3,1096,850,2241,278,298,305,0,,0,0.0,0.0,0.0,0.0,0.0
2024,9,27,5,2024-09-27,WN,7285,ATL,MCO,"Atlanta, GA",Georgia,"Orlando, FL",Florida,1830,1728,7,0,1837,1728,26,14,1863,1714,1242,151,171,191,0,,0,0.0,0.0,0.0,0.0,0.0
2024,10,11,5,2024-10-11,MQ,5010,DCA,MSP,"Washington, DC",District of Columbia,"Minneapolis, MN",Minnesota,1416,2294,5,0,1421,2294,8,14,1429,2280,1576,203,223,225,0,,0,0.0,0.0,0.0,0.0,0.0
2024,6,5,3,2024-06-05,YX,9219,DEN,MIA,"Denver, CO",Colorado,"Miami, FL",Florida,1466,2140,0,0,1466,2140,16,4,1482,2136,1408,182,202,202,0,,0,0.0,0.0,0.0,0.0,0.0
2024,3,15,5,2024-03-15,B6,4609,TPA,ORD,"Tampa, FL",Florida,"Chicago, IL",Illinois,1069,938,-15,-15,1054,923,13,15,1067,908,711,89,109,117,0,,0,0.0,0.0,0.0,0.0,0.0
2024,10,14,1,2024-10-14,NK,6151,SAN,MSP,"San Diego, CA",California,"Minneapolis, MN",Minnesota,1621,991,-30,-20,1591,971,6,14,1597,957,1448,171,191,191,0,,0,0.0,0.0,0.0,0.0,0.0
2024,5,9,4,2024-05-09,MQ,6252,IAD,PDX,"Washington, DC",District of Columbia,"Portland, OR",Oregon,624,740,-15,-5,609,735,9,9,618,726,1182,139,159,157,0,,0,0.0,0.0,0.0,0.0,0.0
2024,6,23,7,2024-06-23,OH,8711,PHL,DEN,"Philadelphia, PA",Pennsylvania,"Denver, CO",Colorado,1872,768,-14,-10,1858,758,20,4,1878,754,2894,365,385,389,0,,0,0.0,0.0,0.0,0.0,0.0
2024,3,24,7,2024-03-24,OH,4224,MDW,LGA,"Chicago, IL",Illinois,"New York, NY",New York,633,1640,1,5,634,1645,23,10,657,1635,2639,326,346,359,0,,0,0.0,0.0,0.0,0.0,0.0
2024,1,22,1,2024-01-22,MQ,2495,SLC,HNL,"Salt Lake City, UT",Utah,"Honolulu, HI",Hawaii,1495,2167,-2,5,1493,2172,28,4,1521,2168,1974,247,267,279,0,,0,0.0,0.0,0.0,0.0,0.0
2024,1,27,6,2024-01-27,9E,8952,MIA,MCO,"Miami, FL",Florida,"Orlando, FL",Florida,1749,604,-2,-5,1747,599,18,4,1765,595,769,102,122,124,0,,0,0.0,0.0,0.0,0.0,0.0
2024,7,13,6,2024-07-13,UA,4050,CLT,DFW,"Charlotte, NC",North Carolina,"Dallas/Fort Worth, TX",Texas,2235,1760,-26,-20,2209,1740,19,15,2228,1725,2845,350,370,384,0,,0,0.0,0.0,0.0,0.0,0.0
2024,12,2,1,2024-12-02,9E,549,JFK,MIA,"New York, NY",New York,"Miami, FL",Florida,2072,1218,-9,-10,2063,1208,23,8,2086,1200,1250,157,177,188,0,,0,0.0,0.0,0.0,0.0,0.0
2024,8,23,5,2024-08-23,B6,479,ATL,MCO,"Atlanta, GA",Georgia,"Orlando, FL",Florida,1149,1785,-2,5,1147,1790,28,10,1175,1780,751,93,113,131,0,,0,0.0,0.0,0.0,0.0,0.0
2024,4,1,1,2024-04-01,OO,9542,DTW,LAS,"Detroit, MI",Michigan,"Las Vegas, NV",Nevada,2243,1368,37,45,2280,1413,28,8,2308,1405,2603,316,336,352,0,,0,7.0,7.0,0.0,0.0,31.0
2024,1,21,7,2024-01-21,OH,7385,MSP,ATL,"Minneapolis, MN",Minnesota,"Atlanta, GA",Georgia,1205,1279,2,-5,1207,1274,22,11,1229,1263,2356,303,323,336,0,,0,0.0,0.0,0.0,0.0,0.0
2024,10,29,2,2024-10-29,UA,2401,SEA,IAH,"Seattle, WA",Washington,"Houston, TX",Texas,1067,1062,4,10,1071,1072,15,17,1086,1055,2266,288,308,320,0,,0,0.0,0.0,0.0,0.0,0.0
2024,12,22,7,2024-12-22,B6,7810,PDX,MDW,"Portland, OR",Oregon,"Chicago, IL",Illinois,838,2061,5,10,843,2071,17,19,860,2052,324,49,69,85,0,,0,0.0,0.0,0.0,0.0,0.0
2024,3,24,7,2024-03-24,OH,5892,HNL,IAD,"Honolulu, HI",Hawaii,"Washington, DC",District of Columbia,1338,2005,-17,-20,1321,1985,14,10,1335,1975,2583,315,335,339,0,,0,0.0,0.0,0.0,0.0,0.0
2024,9,18,3,2024-09-18,UA,9018,HNL,SAN,"Honolulu, HI",Hawaii,"San Diego, CA",California,821,981,10,15,831,996,11,11,842,985,735,89,109,111,0,,0,0.0,0.0,0.0,0.0,0.0
2024,5,26,7,2024-05-26,OO,9759,MSP,TPA,"Minneapolis, MN",Minnesota,"Tampa, FL",Florida,1610,1081,9,0,1619,1081,26,7,1645,1074,965,126,146,159,0,,0,0.0,0.0,0.0,0.0,0.0
2024,9,13,5,2024-09-13,9E,7316,MCO,JFK,"Orlando, FL",Florida,"New York, NY",New York,594,1978,21,20,615,1998,5,8,620,1990,1375,177,197,190,0,,0,3.0,3.0,3.0,0.0,11.0
2024,2,27,2,2024-02-27,OO,5005,DTW,PDX,"Detroit, MI",Michigan,"Portland, OR",Oregon,695,1868,1,0,696,1868,22,13,718,1855,357,35,55,70,0,,0,0.0,0.0,0.0,0.0,0.0
2024,1,15,1,2024-01-15,NK,6099,DFW,HNL,"Dallas/Fort Worth, TX",Texas,"Honolulu, HI",Hawaii,691,1224,-13,-10,678,1214,8,9,686,1205,884,110,130,127,0,,0,0.0,0.0,0.0,0.0,0.0
2024,6,10,1,2024-06-10,MQ,8707,PDX,MIA,"Portland, OR",Oregon,"Miami, FL",Florida,1155,2313,29,20,1184,2333,20,17,1204,2316,810,96,116,133,0,,0,3.0,3.0,2.0,0.0,12.0
2024,6,11,2,2024-06-11,AA,7222,JFK,LAS,"New York, NY",New York,"Las Vegas, NV",Nevada,1021,1075,-19,-10,1002,1065,22,15,1024,1050,1465,191,211,228,0,,0,0.0,0.0,0.0,0.0,0.0
2024,11,15,5,2024-11-15,G4,699,BOS,HNL,"Boston, MA",Massachusetts,"Honolulu, HI",Hawaii,1252,1064,4,10,1256,1074,25,17,1281,1057,1400,181,201,223,0,,0,0.0,0.0,0.0,0.0,0.0
2024,10,7,1,2024-10-07,G4,7388,BOS,MCO,"Boston, MA",Massachusetts,"Orlando, FL",Florida,2184,1813,-3,-10,2181,1803,23,16,2204,1787,1386,178,198,217,0,,0,0.0,0.0,0.0,0.0,0.0
2024,10,6,7,2024-10-06,B6,8021,MSP,SFO,"Minneapolis, MN",Minnesota,"San Francisco, CA",California,1487,1093,-3,5,1484,1098,19,8,1503,1090,2395,305,325,332,0,,0,0.0,0.0,0.0,0.0,0.0
2024,1,12,5,2024-01-12,G4,1667,PDX,LAX,"Portland, OR",Oregon,"Los Angeles, CA",California,1505,2146,0,-5,1505,2141,26,6,1531,2135,1515,193,213,225,0,,0,0.0,0.0,0.0,0.0,0.0
2024,9,30,1,2024-09-30,9E,1194,BWI,JFK,"Baltimore, MD",Maryland,"New York, NY",New York,2175,1134,14,20,2189,1154,29,6,2218,1148,2617,329,349,364,0,,0,2.0,2.0,3.0,0.0,13.0
2024,9,27,5,2024-09-27,MQ,9739,ATL,MDW,"Atlanta, GA",Georgia,"Chicago, IL",Illinois,512,1230,-12,-10,500,1220,14,3,514,1217,2927,371,391,388,0,,0,0.0,0.0,0.0,0.0,0.0
2024,7,26,5,2024-07-26,HA,9784,ATL,SAN,"Atlanta, GA",Georgia,"San Diego, CA",California,753,881,-10,-5,743,876,11,5,754,871,308,35,55,51,0,,0,0.0,0.0,0.0,0.0,0.0
2024,1,27,6,2024-01-27,AS,6291,DEN,IAD,"Denver, CO",Colorado,"Washington, DC",District of Columbia,580,1430,8,0,588,1430,25,7,613,1423,544,66,86,98,0,,0,0.0,0.0,0.0,0.0,0.0
2024,3,12,2,2024-03-12,HA,1558,STL,PDX,"St. Louis, MO",Missouri,"Portland, OR",Oregon,2245,1029,25,20,2270,1049,5,8,2275,1041,1593,196,216,209,0,,0,5.0,2.0,0.0,0.0,13.0
2024,2,29,4,2024-02-29,B6,9500,EWR,SFO,"Newark, NJ",New Jersey,"San Francisco, CA",California,872,1180,-9,-5,863,1175,5,6,868,1169,221,33,53,44,0,,0,0.0,0.0,0.0,0.0,0.0
2024,5,24,5,2024-05-24,MQ,8146,HNL,LAX,"Honolulu, HI",Hawaii,"Los Angeles, CA",California,893,1457,-12,-5,881,1452,5,7,886,1445,1416,186,206,198,0,,0,0.0,0.0,0.0,0.0,0.0
2024,4,2,2,2024-04-02,UA,5034,DEN,MCO,"Denver, CO",Colorado,"Orlando, FL",Florida,2255,2269,5,0,2260,2269,23,14,2283,2255,1990,251,271,288,0,,0,0.0,0.0,0.0,0.0,0.0
2024,11,4,1,2024-11-04,OO,1454,DCA,BOS,"Washington, DC",District of Columbia,"Boston, MA",Massachusetts,917,852,-1,-10,916,842,11,9,927,833,938,126,146,146,0,,0,0.0,0.0,0.0,0.0,0.0
2024,1,8,1,2024-01-08,OO,6573,IAH,DCA,"Houston, TX",Texas,"Washington, DC",District of Columbia,1582,1162,16,10,1598,1172,19,15,1617,1157,2398,300,320,334,0,,0,0.0,0.0,0.0,0.0,0.0
2024,3,19,2,2024-03-19,F9,8504,EWR,STL,"Newark, NJ",New Jersey,"St. Louis, MO",Missouri,627,1666,-7,-15,620,1651,17,10,637,1641,1887,225,245,252,0,,0,0.0,0.0,0.0,0.0,0.0
2024,1,27,6,2024-01-27,WN,3994,IAD,DEN,"Washington, DC",District of Columbia,"Denver, CO",Colorado,1316,2105,11,5,1327,2110,13,15,1340,2095,2334,293,313,321,0,,0,0.0,0.0,0.0,0.0,0.0
2024,6,22,6,2024-06-22,9E,8132,IAH,ATL,"Houston, TX",Texas,"Atlanta, GA",Georgia,1273,1764,2,0,1275,1764,18,14,1293,1750,1261,153,173,185,0,,0,0.0,0.0,0.0,0.0,0.0
2024,2,19,1,2024-02-19,MQ,3063,SFO,PHX,"San Francisco, CA",California,"Phoenix, AZ",Arizona,2064,2134,-19,-10,2045,2124,10,12,2055,2112,838,109,129,131,0,,0,0.0,0.0,0.0,0.0,0.0
2024,7,17,3,2024-07-17,HA,3142,HNL,IAD,"Honolulu, HI",Hawaii,"Washington, DC",District of Columbia,1856,1136,-9,0,1847,1136,11,12,1858,1124,590,65,85,88,0,,0,0.0,0.0,0.0,0.0,0.0
2024,12,14,6,2024-12-14,MQ,7073,PDX,LGA,"Portland, OR",Oregon,"New York, NY",New York,1391,1497,3,10,1394,1507,18,10,1412,1497,1326,165,185,193,0,,0,0.0,0.0,0.0,0.0,0.0
2024,6,29,6,2024-06-29,UA,7239,HNL,SEA,"Honolulu, HI",Hawaii,"Seattle, WA",Washington,781,869,0,-5,781,864,15,16,796,848,912,121,141,152,0,,0,0.0,0.0,0.0,0.0,0.0
2024,1,24,3,2024-01-24,MQ,7030,MDW,LAS,"Chicago, IL",Illinois,"Las Vegas, NV",Nevada,2103,1984,-22,-15,2081,1969,7,6,2088,1963,420,51,71,64,0,,0,0.0,0.0,0.0,0.0,0.0
2024,11,11,1,2024-11-11,AS,1832,ATL,SFO,"Atlanta, GA",Georgia,"San Francisco, CA",California,706,1215,-11,-20,695,1195,15,4,710,1191,1392,179,199,198,0,,0,0.0,0.0,0.0,0.0,0.0
2024,2,15,4,2024-02-15,F9,7970,MCO,STL,"Orlando, FL",Florida,"St. Louis, MO",Missouri,1795,1535,6,5,1801,1540,12,11,1813,1529,2866,366,386,389,0,,0,0.0,0.0,0.0,0.0,0.0
2024,1,15,1,2024-01-15,MQ,5440,SAN,LAS,"San Diego, CA",California,"Las Vegas, NV",Nevada,1832,894,4,-5,1836,889,10,8,1846,881,2833,351,371,369,0,,0,0.0,0.0,0.0,0.0,0.0
2024,6,1,6,2024-06-01,HA,5211,IAD,MCO,"Washington, DC",District of Columbia,"Orlando, FL",Florida,902,2288,18,15,920,2303,7,5,927,2298,1783,217,237,229,0,,0,0.0,0.0,0.0,0.0,0.0
2024,8,9,5,2024-08-09,G4,3181,ATL,ORD,"Atlanta, GA",Georgia,"Chicago, IL",Illinois,1698,2098,-10,0,1688,2098,16,15,1704,2083,577,64,84,95,0,,0,0.0,0.0,0.0,0.0,0.0
2024,7,24,3,2024-07-24,OH,7902,LAS,SLC,"Las Vegas, NV",Nevada,"Salt Lake City, UT",Utah,717,1482,1,-5,718,1477,22,13,740,1464,1712,205,225,240,0,,0,0.0,0.0,0.0,0.0,0.0
2024,9,29,7,2024-09-29,AS,9562,MDW,IAD,"Chicago, IL",Illinois,"Washington, DC",District of Columbia,2195,1071,7,0,2202,1071,29,16,2231,1055,2229,284,304,329,0,,0,0.0,0.0,0.0,0.0,0.0
2024,8,23,5,2024-08-23,B6,7627,BWI,EWR,"Baltimore, MD",Maryland,"Newark, NJ",New Jersey,825,1416,1,0,826,1416,15,19,841,1397,605,67,87,101,0,,0,0.0,0.0,0.0,0.0,0.0
2024,12,5,4,2024-12-05,YX,4968,EWR,HNL,"Newark, NJ",New Jersey,"Honolulu, HI",Hawaii,1255,1784,14,15,1269,1799,11,7,1280,1792,1414,168,188,186,0,,0,0.0,0.0,0.0,0.0,0.0
2024,8,15,4,2024-08-15,OO,1629,BOS,BWI,"Boston, MA",Massachusetts,"Baltimore, MD",Maryland,1776,644,4,0,1780,644,14,5,1794,639,2203,279,299,298,0,,0,0.0,0.0,0.0,0.0,0.0
2024,1,9,2,2024-01-09,DL,1181,STL,PHL,"St. Louis, MO",Missouri,"Philadelphia, PA",Pennsylvania,1977,1398,-9,-15,1968,1383,20,9,1988,1374,383,41,61,70,0,,0,0.0,0.0,0.0,0.0,0.0
2024,6,14,5,2024-06-14,DL,8094,MCO,ATL,"Orlando, FL",Florida,"Atlanta, GA",Georgia,1712,1479,0,0,1712,1479,20,8,1732,1471,1251,159,179,187,0,,0,0.0,0.0,0.0,0.0,0.0
2024,11,14,4,2024-11-14,G4,3631,MSP,SAN,"Minneapolis, MN",Minnesota,"San Diego, CA",California,2296,1277,9,0,2305,1277,19,5,2324,1272,2416,298,318,322,0,,0,0.0,0.0,0.0,0.0,0.0
2024,8,1,4,2024-08-01,DL,9443,DTW,PHL,"Detroit, MI",Michigan,"Philadelphia, PA",Pennsylvania,1966,806,1,5,1967,811,17,15,1984,796,306,32,52,64,0,,0,0.0,0.0,0.0,0.0,0.0
2024,4,26,5,2024-04-26,DL,816,MCO,SLC,"Orlando, FL",Florida,"Salt Lake City, UT",Utah,1511,1731,24,15,1535,1746,29,13,1564,1733,511,66,86,108,0,,0,0.0,0.0,0.0,0.0,0.0
2024,12,9,1,2024-12-09,UA,6329,PHX,BWI,"Phoenix, AZ",Arizona,"Baltimore, MD",Maryland,629,2127,3,-5,632,2122,8,4,640,2118,337,50,70,62,0,,0,0.0,0.0,0.0,0.0,0.0
2024,3,12,2,2024-03-12,UA,304,BWI,JFK,"Baltimore, MD",Maryland,"New York, NY",New York,2008,1535,-5,-5,2003,1530,8,10,2011,1520,1264,158,178,176,0,,0,0.0,0.0,0.0,0.0,0.0
2024,3,4,1,2024-03-04,WN,6884,SEA,STL,"Seattle, WA",Washington,"St. Louis, MO",Missouri,502,1041,-10,0,492,1041,10,14,502,1027,2956,365,385,389,0,,0,0.0,0.0,0.0,0.0,0.0
2024,7,23,2,2024-07-23,NK,4194,MSP,IAD,"Minneapolis, MN",Minnesota,"Washington, DC",District of Columbia,1874,1688,22,15,1896,1703,22,14,1918,1689,2035,251,271,287,0,,0,0.0,0.0,0.0,0.0,0.0
2024,7,27,6,2024-07-27,G4,5582,PDX,TPA,"Portland, OR",Oregon,"Tampa, FL",Florida,1054,866,24,20,1078,886,5,17,1083,869,1252,149,169,171,0,,0,7.0,3.0,3.0,0.0,7.0
2024,3,12,2,2024-03-12,DL,5840,PHL,LAX,"Philadelphia, PA",Pennsylvania,"Los Angeles, CA",California,1656,998,22,20,1678,1018,14,10,1692,1008,2875,354,374,378,0,,0,4.0,3.0,0.0,0.0,13.0
2024,10,3,4,2024-10-03,WN,9624,BOS,PDX,"Boston, MA",Massachusetts,"Portland, OR",Oregon,2213,2320,-5,-10,2208,2310,7,14,2215,2296,249,25,45,46,0,,0,0.0,0.0,0.0,0.0,0.0
2024,9,30,1,2024-09-30,G4,7319,LAS,TPA,"Las Vegas, NV",Nevada,"Tampa, FL",Florida,2017,823,8,0,2025,823,18,12,2043,811,696,86,106,116,0,,0,0.0,0.0,0.0,0.0,0.0
2024,11,15,5,2024-11-15,OH,6254,CLT,DFW,"Charlotte, NC",North Carolina,"Dallas/Fort Worth, TX",Texas,765,1264,-15,-10,750,1254,15,5,765,1249,1243,162,182,182,0,,0,0.0,0.0,0.0,0.0,0.0
2024,12,3,2,2024-12-03,DL,4942,STL,ORD,"St. Louis, MO",Missouri,"Chicago, IL",Illinois,1422,1534,0,-5,1422,1529,9,8,1431,1521,902,118,138,135,0,,0,0.0,0.0,0.0,0.0,0.0
2024,4,4,4,2024-04-04,9E,8203,DEN,TPA,"Denver, CO",Colorado,"Tampa, FL",Florida,523,1912,-13,-20,510,1892,6,17,516,1875,207,28,48,51,0,,0,0.0,0.0,0.0,0.0,0.0
2024,6,14,5,2024-06-14,OO,9529,IAD,SLC,"Washington, DC",District of Columbia,"Salt Lake City, UT",Utah,1033,1908,-20,-10,1013,1898,13,16,1026,1882,1952,246,266,275,0,,0,0.0,0.0,0.0,0.0,0.0
2024,2,1,4,2024-02-01,MQ,2118,DFW,MIA,"Dallas/Fort Worth, TX",Texas,"Miami, FL",Florida,502,1809,2,-5,504,1804,21,5,525,1799,904,108,128,134,0,,0,0.0,0.0,0.0,0.0,0.0
2024,1,11,4,2024-01-11,AA,5151,JFK,PHX,"New York, NY",New York,"Phoenix, AZ",Arizona,2193,825,-7,-5,2186,820,23,19,2209,801,1323,170,190,212,0,,0,0.0,0.0,0.0,0.0,0.0
2024,10,27,7,2024-10-27,9E,8809,ATL,BWI,"Atlanta, GA",Georgia,"Baltimore, MD",Maryland,1379,799,-8,-10,1371,789,25,16,1396,773,1523,189,209,230,0,,0,0.0,0.0,0.0,0.0,0.0
2024,8,4,7,2024-08-04,F9,7935,HNL,STL,"Honolulu, HI",Hawaii,"St. Louis, MO",Missouri,926,1103,-5,-10,921,1093,21,16,942,1077,983,118,138,155,0,,0,0.0,0.0,0.0,0.0,0.0
2024,10,15,2,2024-10-15,G4,1538,EWR,SAN,"Newark, NJ",New Jersey,"San Diego, CA",California,503,610,13,5,516,615,24,18,540,597,1292,151,171,193,0,,0,0.0,0.0,0.0,0.0,0.0
2024,4,11,4,2024-04-11,NK,4186,SLC,DTW,"Salt Lake City, UT",Utah,"Detroit, MI",Michigan,2142,1508,-20,-10,2122,1498,14,13,2136,1485,633,79,99,106,0,,0,0.0,0.0,0.0,0.0,0.0
2024,9,23,1,2024-09-23,F9,5227,JFK,BWI,"New York, NY",New York,"Baltimore, MD",Maryland,1307,1436,2,5,1309,1441,21,7,1330,1434,2233,274,294,302,0,,0,0.0,0.0,0.0,0.0,0.0
2024,8,1,4,2024-08-01,WN,2152,IAH,SFO,"Houston, TX",Texas,"San Francisco, CA",California,1283,2121,-6,-5,1277,2116,15,3,1292,2113,2362,288,308,306,0,,0,0.0,0.0,0.0,0.0,0.0
2024,6,27,4,2024-06-27,WN,7629,MIA,JFK,"Miami, FL",Florida,"New York, NY",New York,1002,1578,6,10,1008,1588,11,16,1019,1572,2900,362,382,389,0,,0,0.0,0.0,0.0,0.0,0.0
2024,3,28,4,2024-03-28,MQ,7247,CLT,IAD,"Charlotte, NC",North Carolina,"Washington, DC",District of Columbia,731,876,-18,-10,713,866,5,7,718,859,904,104,124,116,0,,0,0.0,0.0,0.0,0.0,0.0
2024,2,10,6,2024-02-10,DL,4468,STL,JFK,"St. Louis, MO",Missouri,"New York, NY",New York,1372,1626,-8,-10,1364,1616,20,7,1384,1609,2063,255,275,282,0,,0,0.0,0.0,0.0,0.0,0.0
2024,3,16,6,2024-03-16,F9,4617,DEN,SEA,"Denver, CO",Colorado,"Seattle, WA",Washington,1249,1528,14,5,1263,1533,7,7,1270,1526,2632,325,345,339,0,,0,0.0,0.0,0.0,0.0,0.0
2024,2,15,4,2024-02-15,HA,2412,MDW,PDX,"Chicago, IL",Illinois,"Portland, OR",Oregon,571,1389,15,15,586,1404,19,12,605,1392,2779,350,370,381,0,,0,0.0,0.0,0.0,0.0,0.0
2024,6,8,6,2024-06-08,OO,5677,DEN,STL,"Denver, CO",Colorado,"St. Louis, MO",Missouri,587,2197,-6,-15,581,2182,8,12,589,2170,864,102,122,122,0,,0,0.0,0.0,0.0,0.0,0.0
2024,3,20,3,2024-03-20,DL,9073,DEN,PHL,"Denver, CO",Colorado,"Philadelphia, PA",Pennsylvania,1027,604,-21,-15,1006,589,8,11,1014,578,484,67,87,86,0,,0,0.0,0.0,0.0,0.0,0.0
2024,11,5,2,2024-11-05,G4,1344,STL,BWI,"St. Louis, MO",Missouri,"Baltimore, MD",Maryland,1385,1120,17,15,1402,1135,27,16,1429,1119,700,93,113,136,0,,0,0.0,0.0,0.0,0.0,0.0
2024,3,26,2,2024-03-26,OH,2516,SEA,SFO,"Seattle, WA",Washington,"San Francisco, CA",California,1102,2193,-14,-15,1088,2178,9,3,1097,2175,2500,315,335,327,0,,0,0.0,0.0,0.0,0.0,0.0
2024,4,1,1,2024-04-01,WN,6590,IAH,MDW,"Houston, TX",Texas,"Chicago, IL",Illinois,949,879,-5,-10,944,869,19,8,963,861,473,64,84,91,0,,0,0.0,0.0,0.0,0.0,0.0
2024,5,27,1,2024-05-27,AA,6268,PDX,MIA,"Portland, OR",Oregon,"Miami, FL",Florida,938,2046,21,15,959,2061,15,9,974,2052,1596,207,227,231,0,,0,0.0,0.0,0.0,0.0,0.0
2024,6,9,7,2024-06-09,MQ,9267,EWR,PHL,"Newark, NJ",New Jersey,"Philadelphia, PA",Pennsylvania,2055,1571,13,10,2068,1581,28,14,2096,1567,2713,339,359,381,0,,0,0.0,0.0,0.0,0.0,0.0
2024,7,20,6,2024-07-20,WN,5939,IAH,BWI,"Houston, TX",Texas,"Baltimore, MD",Maryland,1958,1861,-6,-5,1952,1856,23,17,1975,1839,1664,198,218,238,0,,0,0.0,0.0,0.0,0.0,0.0
2024,8,29,4,2024-08-29,UA,8708,PHL,CLT,"Philadelphia, PA",Pennsylvania,"Charlotte, NC",North Carolina,2247,916,22,20,2269,936,12,18,2281,918,2829,347,367,377,0,,0,6.0,0.0,0.0,0.0,14.0
2024,12,18,3,2024-12-18,YX,8506,DFW,STL,"Dallas/Fort Worth, TX",Texas,"St. Louis, MO",Missouri,1607,726,1,0,1608,726,15,5,1623,721,1315,164,184,184,0,,0,0.0,0.0,0.0,0.0,0.0
2024,1,2,2,2024-01-02,AS,9427,SEA,DFW,"Seattle, WA",Washington,"Dallas/Fort Worth, TX",Texas,1862,903,-22,-15,1840,888,15,18,1855,870,2821,361,381,394,0,,0,0.0,0.0,0.0,0.0,0.0
2024,8,12,1,2024-08-12,NK,7197,JFK,SLC,"New York, NY",New York,"Salt Lake City, UT",Utah,625,1348,13,5,638,1353,13,10,651,1343,2837,356,376,379,0,,0,0.0,0.0,0.0,0.0,0.0
2024,10,15,2,2024-10-15,F9,5109,BOS,PHX,"Boston, MA",Massachusetts,"Phoenix, AZ",Arizona,1062,1330,1,0,1063,1330,18,16,1081,1314,2401,291,311,325,0,,0,0.0,0.0,0.0,0.0,0.0
2024,8,20,2,2024-08-20,DL,1682,MDW,LAS,"Chicago, IL",Illinois,"Las Vegas, NV",Nevada,1541,1801,-10,0,1531,1801,29,5,1560,1796,2514,304,324,338,0,,0,0.0,0.0,0.0,0.0,0.0
2024,3,17,7,2024-03-17,AS,9024,SFO,HNL,"San Francisco, CA",California,"Honolulu, HI",Hawaii,1348,1089,44,45,1392,1134,29,14,1421,1120,732,91,111,134,0,,0,6.0,2.0,5.0,0.0,32.0
2024,4,25,4,2024-04-25,HA,7976,MCO,SLC,"Orlando, FL",Florida,"Salt Lake City, UT",Utah,1364,1036,-19,-10,1345,1026,18,16,1363,1010,396,42,62,76,0,,0,0.0,0.0,0.0,0.0,0.0
2024,6,2,7,2024-06-02,AS,2527,LAX,IAD,"Los Angeles, CA",California,"Washington, DC",District of Columbia,2152,2284,-1,5,2151,2289,17,6,2168,2283,358,41,61,64,0,,0,0.0,0.0,0.0,0.0,0.0
2024,4,12,5,2024-04-12,9E,5821,HNL,BWI,"Honolulu, HI",Hawaii,"Baltimore, MD",Maryland,2159,1661,6,0,2165,1661,5,14,2170,1647,2809,358,378,377,0,,0,0.0,0.0,0.0,0.0,0.0
2024,7,12,5,2024-07-12,YX,8523,STL,LAX,"St. Louis, MO",Missouri,"Los Angeles, CA",California,2063,2253,-17,-10,2046,2243,13,5,2059,2238,582,72,92,90,0,,0,0.0,0.0,0.0,0.0,0.0
2024,6,14,5,2024-06-14,B6,5030,BOS,DCA,"Boston, MA",Massachusetts,"Washington, DC",District of Columbia,1423,1082,1,5,1424,1087,12,18,1436,1069,2657,323,343,353,0,,0,0.0,0.0,0.0,0.0,0.0
2024,12,24,2,2024-12-24,9E,4453,IAH,CLT,"Houston, TX",Texas,"Charlotte, NC",North Carolina,844,1591,9,5,853,1596,22,5,875,1591,1271,151,171,178,0,,0,0.0,0.0,0.0,0.0,0.0
2024,3,30,6,2024-03-30,9E,7932,DCA,SLC,"Washington, DC",District of Columbia,"Salt Lake City, UT",Utah,967,914,0,10,967,924,7,5,974,919,2118,263,283,275,0,,0,0.0,0.0,0.0,0.0,0.0
2024,6,22,6,2024-06-22,NK,5475,DFW,MIA,"Dallas/Fort Worth, TX",Texas,"Miami, FL",Florida,1480,2107,13,10,1493,2117,27,9,1520,2108,1194,158,178,194,0,,0,0.0,0.0,0.0,0.0,0.0
2024,5,1,3,2024-05-01,UA,502,SEA,BOS,"Seattle, WA",Washington,"Boston, MA",Massachusetts,640,1720,4,0,644,1720,7,12,651,1708,539,68,88,87,0,,0,0.0,0.0,0.0,0.0,0.0
2024,5,22,3,2024-05-22,WN,6667,LAX,SEA,"Los Angeles, CA",California,"Seattle, WA",Washington,1529,1538,-14,-5,1515,1533,6,18,1521,1515,595,81,101,105,0,,0,0.0,0.0,0.0,0.0,0.0
2024,4,15,1,2024-04-15,9E,4965,STL,DTW,"St. Louis, MO",Missouri,"Detroit, MI",Michigan,1168,616,9,0,1177,616,8,15,1185,601,724,94,114,117,0,,0,0.0,0.0,0.0,0.0,0.0
2024,10,31,4,2024-10-31,MQ,8246,MCO,STL,"Orlando, FL",Florida,"St. Louis, MO",Missouri,2141,1539,-14,-5,2127,1534,13,8,2140,1526,546,69,89,90,0,,0,0.0,0.0,0.0,0.0,0.0
2024,12,25,3,2024-12-25,G4,164,BWI,MIA,"Baltimore, MD",Maryland,"Miami, FL",Florida,1130,1579,-5,-10,1125,1569,19,11,1144,1558,2722,330,350,360,0,,0,0.0,0.0,0.0,0.0,0.0
2024,11,12,2,2024-11-12,WN,2337,DFW,IAH,"Dallas/Fort Worth, TX",Texas,"Houston, TX",Texas,2172,1046,-9,0,2163,1046,22,16,2185,1030,1751,213,233,251,0,,0,0.0,0.0,0.0,0.0,0.0
2024,5,2,4,2024-05-02,UA,7870,DCA,MIA,"Washington, DC",District of Columbia,"Miami, FL",Florida,2064,878,10,5,2074,883,21,19,2095,864,2173,271,291,311,0,,0,0.0,0.0,0.0,0.0,0.0
2024,1,9,2,2024-01-09,OH,9241,IAH,SFO,"Houston, TX",Texas,"San Francisco, CA",California,2201,1051,6,0,2207,1051,27,9,2234,1042,1035,119,139,155,0,,0,0.0,0.0,0.0,0.0,0.0
2024,9,18,3,2024-09-18,DL,272,PHL,PDX,"Philadelphia, PA",Pennsylvania,"Portland, OR",Oregon,1588,1265,27,20,1615,1285,15,10,1630,1275,2644,325,345,350,0,,0,5.0,5.0,3.0,0.0,7.0
2024,3,13,3,2024-03-13,B6,8035,EWR,BWI,"Newark, NJ",New Jersey,"Baltimore, MD",Maryland,1579,1205,-2,-10,1577,1195,5,7,1582,1188,948,115,135,127,0,,0,0.0,0.0,0.0,0.0,0.0
2024,12,24,2,2024-12-24,WN,2775,IAH,PHX,"Houston, TX",Texas,"Phoenix, AZ",Arizona,1297,2310,0,-5,1297,2305,10,14,1307,2291,1882,230,250,254,0,,0,0.0,0.0,0.0,0.0,0.0
2024,8,10,6,2024-08-10,MQ,9542,LAX,ORD,"Los Angeles, CA",California,"Chicago, IL",Illinois,1619,628,-2,5,1617,633,18,4,1635,629,1816,236,256,258,0,,0,0.0,0.0,0.0,0.0,0.0
2024,2,10,6,2024-02-10,MQ,4105,MDW,SFO,"Chicago, IL",Illinois,"San Francisco, CA",California,1454,2169,6,0,1460,2169,9,18,1469,2151,398,50,70,77,0,,0,0.0,0.0,0.0,0.0,0.0
2024,7,22,1,2024-07-22,F9,6644,LAS,STL,"Las Vegas, NV",Nevada,"St. Louis, MO",Missouri,714,1633,-30,-20,684,1613,28,5,712,1608,1116,146,166,179,0,,0,0.0,0.0,0.0,0.0,0.0
2024,9,20,5,2024-09-20,NK,8929,LAX,DTW,"Los Angeles, CA",California,"Detroit, MI",Michigan,1242,1401,-3,-5,1239,1396,7,17,1246,1379,2485,304,324,328,0,,0,0.0,0.0,0.0,0.0,0.0
2024,11,23,6,2024-11-23,AS,1048,STL,LAS,"St. Louis, MO",Missouri,"Las Vegas, NV",Nevada,557,700,-14,-10,543,690,23,19,566,671,380,41,61,83,0,,0,0.0,0.0,0.0,0.0,0.0
2024,6,26,3,2024-06-26,OO,1794,MCO,ATL,"Orlando, FL",Florida,"Atlanta, GA",Georgia,1405,1252,8,10,1413,1262,5,18,1418,1244,1877,231,251,254,0,,0,0.0,0.0,0.0,0.0,0.0
2024,12,13,5,2024-12-13,YX,4857,LAX,HNL,"Los Angeles, CA",California,"Honolulu, HI",Hawaii,2015,686,13,10,2028,696,8,5,2036,691,1575,204,224,217,1,,0,0.0,0.0,0.0,0.0,0.0
2024,11,13,3,2024-11-13,DL,6382,IAH,ORD,"Houston, TX",Texas,"Chicago, IL",Illinois,904,1069,-20,-10,884,1059,20,17,904,1042,1744,209,229,246,0,,0,0.0,0.0,0.0,0.0,0.0
2024,3,24,7,2024-03-24,UA,242,SEA,MCO,"Seattle, WA",Washington,"Orlando, FL",Florida,1707,1924,-18,-15,1689,1909,10,3,1699,1906,1490,189,209,202,0,,0,0.0,0.0,0.0,0.0,0.0
2024,11,13,3,2024-11-13,9E,6101,DEN,SAN,"Denver, CO",Colorado,"San Diego, CA",California,1805,1239,-11,-10,1794,1229,9,14,1803,1215,1630,209,229,232,0,,0,0.0,0.0,0.0,0.0,0.0
2024,4,20,6,2024-04-20,G4,6752,MCO,IAD,"Orlando, FL",Florida,"Washington, DC",District of Columbia,1220,1829,-17,-10,1203,1819,11,12,1214,1807,1893,243,263,266,0,,0,0.0,0.0,0.0,0.0,0.0
2024,9,7,6,2024-09-07,MQ,4681,PDX,JFK,"Portland, OR",Oregon,"New York, NY",New York,1686,2224,-8,-10,1678,2214,14,8,1692,2206,1142,149,169,171,0,,0,0.0,0.0,0.0,0.0,0.0
2024,1,7,7,2024-01-07,G4,5187,SLC,PHL,"Salt Lake City, UT",Utah,"Philadelphia, PA",Pennsylvania,1612,1705,-3,-10,1609,1695,5,10,1614,1685,1342,173,193,188,0,,0,0.0,0.0,0.0,0.0,0.0
2024,3,24,7,2024-03-24,HA,1560,SLC,BWI,"Salt Lake City, UT",Utah,"Baltimore, MD",Maryland,1282,1835,-2,0,1280,1835,23,8,1303,1827,460,54,74,85,0,,0,0.0,0.0,0.0,0.0,0.0
2024,7,26,5,2024-07-26,B6,3987,SFO,LGA,"San Francisco, CA",California,"New York, NY",New York,596,718,-8,-5,588,713,18,6,606,707,1765,219,239,243,0,,0,0.0,0.0,0.0,0.0,0.0
2024,11,9,6,2024-11-09,OH,8584,LGA,JFK,"New York, NY",New York,"New York, NY",New York,1086,1759,-5,0,1081,1759,8,18,1089,1741,2977,365,385,391,0,,0,0.0,0.0,0.0,0.0,0.0
2024,1,22,1,2024-01-22,UA,9935,EWR,CLT,"Newark, NJ",New Jersey,"Charlotte, NC",North Carolina,1611,1387,3,-5,1614,1382,19,7,1633,1375,2571,329,349,355,0,,0,0.0,0.0,0.0,0.0,0.0
2024,1,3,3,2024-01-03,DL,937,DFW,MCO,"Dallas/Fort Worth, TX",Texas,"Orlando, FL",Florida,1017,976,15,10,1032,986,10,18,1042,968,802,106,126,134,0,,0,0.0,0.0,0.0,0.0,0.0
2024,5,6,1,2024-05-06,F9,9329,DEN,SLC,"Denver, CO",Colorado,"Salt Lake City, UT",Utah,1167,1027,10,20,1177,1047,24,15,1201,1032,372,48,68,87,0,,0,7.0,0.0,3.0,0.0,10.0
2024,10,23,3,2024-10-23,HA,5946,ATL,MCO,"Atlanta, GA",Georgia,"Orlando, FL",Florida,1586,1319,-1,-5,1585,1314,27,15,1612,1299,557,66,86,108,0,,0,0.0,0.0,0.0,0.0,0.0
2024,7,6,6,2024-07-06,AS,8563,SLC,ORD,"Salt Lake City, UT",Utah,"Chicago, IL",Illinois,1040,913,-25,-20,1015,893,14,10,1029,883,2242,273,293,297,0,,0,0.0,0.0,0.0,0.0,0.0
2024,12,27,5,2024-12-27,9E,2469,ATL,LGA,"Atlanta, GA",Georgia,"New York, NY",New York,1315,2027,-11,-10,1304,2017,19,9,1323,2008,855,100,120,128,0,,0,0.0,0.0,0.0,0.0,0.0
2024,1,14,7,2024-01-14,OO,9097,MIA,SEA,"Miami, FL",Florida,"Seattle, WA",Washington,690,842,-21,-15,669,827,23,17,692,810,2848,365,385,405,0,,0,0.0,0.0,0.0,0.0,0.0
2024,1,12,5,2024-01-12,YX,3274,MSP,MIA,"Minneapolis, MN",Minnesota,"Miami, FL",Florida,1416,1584,-8,-5,1408,1579,12,4,1420,1575,1183,151,171,167,0,,0,0.0,0.0,0.0,0.0,0.0
2024,3,27,3,2024-03-27,NK,6085,DEN,BWI,"Denver, CO",Colorado,"Baltimore, MD",Maryland,1215,1968,-10,0,1205,1968,17,6,1222,1962,880,119,139,142,0,,0,0.0,0.0,0.0,0.0,0.0
2024,1,12,5,2024-01-12,AA,982,STL,MIA,"St. Louis, MO",Missouri,"Miami, FL",Florida,1801,2235,2,0,1803,2235,27,18,1830,2217,1415,174,194,219,0,,0,0.0,0.0,0.0,0.0,0.0
2024,1,25,4,2024-01-25,AA,9123,LAS,MIA,"Las Vegas, NV",Nevada,"Miami, FL",Florida,1038,1226,-5,-10,1033,1216,23,14,1056,1202,2938,357,377,394,0,,0,0.0,0.0,0.0,0.0,0.0
2024,10,27,7,2024-10-27,9E,3271,SEA,IAH,"Seattle, WA",Washington,"Houston, TX",Texas,584,2047,11,5,595,2052,20,18,615,2034,732,90,110,128,0,,0,0.0,0.0,0.0,0.0,0.0
2024,8,30,5,2024-08-30,DL,2140,PHX,MSP,"Phoenix, AZ",Arizona,"Minneapolis, MN",Minnesota,1858,615,-19,-15,1839,600,29,19,1868,581,1330,158,178,206,0,,0,0.0,0.0,0.0,0.0,0.0
2024,5,1,3,2024-05-01,9E,6832,IAD,IAH,"Washington, DC",District of Columbia,"Houston, TX",Texas,940,1115,-6,-10,934,1105,25,12,959,1093,2689,338,358,375,0,,0,0.0,0.0,0.0,0.0,0.0
2024,5,26,7,2024-05-26,HA,9886,BWI,LGA,"Baltimore, MD",Maryland,"New York, NY",New York,2245,865,8,5,2253,870,22,17,2275,853,2327,287,307,326,0,,0,0.0,0.0,0.0,0.0,0.0
2024,2,24,6,2024-02-24,UA,6472,MCO,ATL,"Orlando, FL",Florida,"Atlanta, GA",Georgia,2173,1159,-4,-10,2169,1149,13,16,2182,1133,944,121,141,150,0,,0,0.0,0.0,0.0,0.0,0.0
2024,8,25,7,2024-08-25,YX,9918,SAN,DCA,"San Diego, CA",California,"Washington, DC",District of Columbia,1289,1334,1,5,1290,1339,28,3,1318,1336,1142,143,163,174,0,,0,0.0,0.0,0.0,0.0,0.0
2024,12,21,6,2024-12-21,AA,6085,IAH,PHL,"Houston, TX",Texas,"Philadelphia, PA",Pennsylvania,1695,1315,23,20,1718,1335,19,6,1737,1329,1874,234,254,259,0,,0,3.0,2.0,3.0,0.0,12.0
2024,6,21,5,2024-06-21,OH,7662,SFO,DFW,"San Francisco, CA",California,"Dallas/Fort Worth, TX",Texas,838,619,7,10,845,629,12,4,857,625,911,117,137,133,0,,0,0.0,0.0,0.0,0.0,0.0
2024,8,8,4,2024-08-08,B6,6000,BOS,SLC,"Boston, MA",Massachusetts,"Salt Lake City, UT",Utah,2191,2329,-8,-10,2183,2319,21,10,2204,2309,2858,363,383,394,0,,0,0.0,0.0,0.0,0.0,0.0
2024,4,28,7,2024-04-28,HA,8065,PHL,SEA,"Philadelphia, PA",Pennsylvania,"Seattle, WA",Washington,1752,1427,-10,0,1742,1427,8,4,1750,1423,1869,224,244,236,0,,0,0.0,0.0,0.0,0.0,0.0
2024,11,4,1,2024-11-04,HA,5416,HNL,MSP,"Honolulu, HI",Hawaii,"Minneapolis, MN",Minnesota,1702,610,-12,-5,1690,605,27,13,1717,592,1452,171,191,211,0,,0,0.0,0.0,0.0,0.0,0.0
2024,7,1,1,2024-07-01,UA,8565,SLC,DCA,"Salt Lake City, UT",Utah,"Washington, DC",District of Columbia,1770,1643,45,45,1815,1688,26,12,1841,1676,1426,187,207,225,0,,0,14.0,9.0,4.0,0.0,18.0
2024,10,14,1,2024-10-14,AA,689,LAX,DTW,"Los Angeles, CA",California,"Detroit, MI",Michigan,1503,878,18,20,1521,898,13,13,1534,885,1905,240,260,266,0,,0,1.0,5.0,2.0,0.0,12.0
2024,11,2,6,2024-11-02,F9,8874,BOS,JFK,"Boston, MA",Massachusetts,"New York, NY",New York,1173,1494,-7,-15,1166,1479,12,11,1178,1468,2002,251,271,274,0,,0,0.0,0.0,0.0,0.0,0.0
2024,10,26,6,2024-10-26,YX,5163,PHX,STL,"Phoenix, AZ",Arizona,"St. Louis, MO",Missouri,2198,932,8,15,2206,947,13,6,2219,941,2957,366,386,385,0,,0,0.0,0.0,0.0,0.0,0.0
2024,3,22,5,2024-03-22,OO,3733,ATL,STL,"Atlanta, GA",Georgia,"St. Louis, MO",Missouri,1229,2170,-20,-10,1209,2160,8,6,1217,2154,895,119,139,133,0,,0,0.0,0.0,0.0,0.0,0.0
2024,7,29,1,2024-07-29,AS,2090,BWI,MSP,"Baltimore, MD",Maryland,"Minneapolis, MN",Minnesota,816,2024,3,-5,819,2019,12,3,831,2016,405,54,74,69,0,,0,0.0,0.0,0.0,0.0,0.0
2024,5,29,3,2024-05-29,G4,6615,MCO,CLT,"Orlando, FL",Florida,"Charlotte, NC",North Carolina,1809,1377,3,-5,1812,1372,26,6,1838,1366,1834,228,248,260,0,,0,0.0,0.0,0.0,0.0,0.0
2024,2,6,2,2024-02-06,UA,1358,DEN,DCA,"Denver, CO",Colorado,"Washington, DC",District of Columbia,575,1343,-2,-10,573,1333,29,3,602,1330,2756,353,373,385,0,,0,0.0,0.0,0.0,0.0,0.0
2024,12,17,2,2024-12-17,G4,2966,ORD,BWI,"Chicago, IL",Illinois,"Baltimore, MD",Maryland,1473,637,10,10,1483,647,21,6,1504,641,1101,128,148,155,0,,0,0.0,0.0,0.0,0.0,0.0
2024,11,7,4,2024-11-07,G4,3838,PHX,ATL,"Phoenix, AZ",Arizona,"Atlanta, GA",Georgia,1498,1573,-10,-5,1488,1568,10,6,1498,1562,967,111,131,127,0,,0,0.0,0.0,0.0,0.0,0.0
2024,12,26,4,2024-12-26,HA,671,ORD,HNL,"Chicago, IL",Illinois,"Honolulu, HI",Hawaii,1975,1706,6,10,1981,1716,14,3,1995,1713,2408,308,328,325,0,,0,0.0,0.0,0.0,0.0,0.0
2024,2,28,3,2024-02-28,YX,8836,DFW,SAN,"Dallas/Fort Worth, TX",Texas,"San Diego, CA",California,703,631,35,45,738,676,6,16,744,660,1362,160,180,182,0,,0,2.0,3.0,4.0,0.0,36.0
2024,5,10,5,2024-05-10,HA,4322,LAS,LGA,"Las Vegas, NV",Nevada,"New York, NY",New York,2251,1677,14,10,2265,1687,16,18,2281,1669,2146,267,287,301,0,,0,0.0,0.0,0.0,0.0,0.0
2024,7,20,6,2024-07-20,MQ,737,BWI,TPA,"Baltimore, MD",Maryland,"Tampa, FL",Florida,923,1336,-12,-5,911,1331,23,11,934,1320,1125,145,165,179,0,,0,0.0,0.0,0.0,0.0,0.0
2024,8,30,5,2024-08-30,YX,8332,DTW,PHX,"Detroit, MI",Michigan,"Phoenix, AZ",Arizona,2258,1218,7,5,2265,1223,29,9,2294,1214,704,91,111,129,0,,0,0.0,0.0,0.0,0.0,0.0
2024,2,4,7,2024-02-04,AA,4982,MCO,PHX,"Orlando, FL",Florida,"Phoenix, AZ",Arizona,692,1584,1,0,693,1584,9,16,702,1568,885,110,130,135,0,,0,0.0,0.0,0.0,0.0,0.0
2024,4,2,2,2024-04-02,UA,4492,SLC,SEA,"Salt Lake City, UT",Utah,"Seattle, WA",Washington,1816,2160,-5,5,1811,2165,20,7,1831,2158,867,110,130,137,0,,0,0.0,0.0,0.0,0.0,0.0
2024,7,25,4,2024-07-25,AS,9912,MCO,DFW,"Orlando, FL",Florida,"Dallas/Fort Worth, TX",Texas,2227,1509,-13,-10,2214,1499,9,16,2223,1483,2608,334,354,359,0,,0,0.0,0.0,0.0,0.0,0.0
2024,12,18,3,2024-12-18,F9,3772,LGA,MIA,"New York, NY",New York,"Miami, FL",Florida,1396,644,0,0,1396,644,5,15,1401,629,871,113,133,133,0,,1,0.0,0.0,0.0,0.0,0.0
2024,11,27,3,2024-11-27,WN,9591,LAX,LAS,"Los Angeles, CA",California,"Las Vegas, NV",Nevada,1280,1229,4,5,1284,1234,14,4,1298,1230,1235,162,182,180,0,,0,0.0,0.0,0.0,0.0,0.0
2024,10,31,4,2024-10-31,B6,7357,MDW,SFO,"Chicago, IL",Illinois,"San Francisco, CA",California,1936,893,-4,5,1932,898,6,14,1938,884,2492,304,324,324,0,,0,0.0,0.0,0.0,0.0,0.0
2024,12,15,7,2024-12-15,G4,4811,PHX,LGA,"Phoenix, AZ",Arizona,"New York, NY",New York,1962,1748,26,20,1988,1768,20,9,2008,1759,451,53,73,82,0,,0,3.0,0.0,3.0,0.0,14.0
2024,7,31,3,2024-07-31,AS,5743,JFK,MSP,"New York, NY",New York,"Minneapolis, MN",Minnesota,800,2171,-13,-15,787,2156,13,4,800,2152,574,70,90,87,0,,0,0.0,0.0,0.0,0.0,0.0
2024,6,7,5,2024-06-07,YX,259,ATL,MDW,"Atlanta, GA",Georgia,"Chicago, IL",Illinois,759,943,-7,-5,752,938,11,12,763,926,2731,341,361,364,0,,1,0.0,0.0,0.0,0.0,0.0
2024,1,24,3,2024-01-24,NK,6038,MDW,EWR,"Chicago, IL",Illinois,"Newark, NJ",New Jersey,1715,1600,5,0,1720,1600,17,8,1737,1592,1309,165,185,190,0,,0,0.0,0.0,0.0,0.0,0.0
2024,10,19,6,2024-10-19,NK,680,DTW,ATL,"Detroit, MI",Michigan,"Atlanta, GA",Georgia,1794,1491,1,-5,1795,1486,8,9,1803,1477,1879,236,256,253,0,,0,0.0,0.0,0.0,0.0,0.0
2024,1,4,4,2024-01-04,WN,8511,SFO,PHX,"San Francisco, CA",California,"Phoenix, AZ",Arizona,1503,1022,-6,-5,1497,1017,11,14,1508,1003,1990,250,270,275,0,,0,0.0,0.0,0.0,0.0,0.0
2024,8,7,3,2024-08-07,WN,7686,BOS,SFO,"Boston, MA",Massachusetts,"San Francisco, CA",California,1115,766,-4,-10,1111,756,14,18,1125,738,2201,275,295,307,0,,0,0.0,0.0,0.0,0.0,0.0
2024,12,29,7,2024-12-29,WN,4574,LAX,JFK,"Los Angeles, CA",California,"New York, NY",New York,931,868,19,10,950,878,16,16,966,862,782,102,122,134,0,,0,0.0,0.0,0.0,0.0,0.0
2024,1,20,6,2024-01-20,OH,7173,DTW,SAN,"Detroit, MI",Michigan,"San Diego, CA",California,1215,1817,14,15,1229,1832,6,17,1235,1815,891,115,135,138,0,,0,0.0,0.0,0.0,0.0,0.0
2024,5,31,5,2024-05-31,HA,9762,PHL,EWR,"Philadelphia, PA",Pennsylvania,"Newark, NJ",New Jersey,1195,1529,-12,-15,1183,1514,9,10,1192,1504,299,30,50,49,0,,0,0.0,0.0,0.0,0.0,0.0
2024,2,19,1,2024-02-19,OO,5159,PHL,EWR,"Philadelphia, PA",Pennsylvania,"Newark, NJ",New Jersey,1740,1747,-6,-10,1734,1737,29,17,1763,1720,1097,128,148,174,0,,0,0.0,0.0,0.0,0.0,0.0
2024,6,25,2,2024-06-25,B6,4428,DCA,MCO,"Washington, DC",District of Columbia,"Orlando, FL",Florida,1614,1894,-12,-10,1602,1884,19,14,1621,1870,1459,187,207,220,0,,0,0.0,0.0,0.0,0.0,0.0
2024,4,5,5,2024-04-05,B6,1494,DCA,PHX,"Washington, DC",District of Columbia,"Phoenix, AZ",Arizona,697,1681,-9,0,688,1681,15,12,703,1669,1379,172,192,199,0,,0,0.0,0.0,0.0,0.0,0.0
2024,4,14,7,2024-04-14,F9,1021,MIA,PHX,"Miami, FL",Florida,"Phoenix, AZ",Arizona,1482,1479,8,5,1490,1484,6,16,1496,1468,2437,310,330,332,0,,0,0.0,0.0,0.0,0.0,0.0
2024,9,6,5,2024-09-06,G4,2873,CLT,SAN,"Charlotte, NC",North Carolina,"San Diego, CA",California,1922,658,-19,-15,1903,643,19,18,1922,625,1892,233,253,270,0,,0,0.0,0.0,0.0,0.0,0.0
2024,4,26,5,2024-04-26,DL,4562,DTW,LAX,"Detroit, MI",Michigan,"Los Angeles, CA",California,538,1049,-7,0,531,1049,23,8,554,1041,2749,334,354,365,0,,0,0.0,0.0,0.0,0.0,0.0
2024,12,19,4,2024-12-19,OO,4676,MDW,SAN,"Chicago, IL",Illinois,"San Diego, CA",California,1208,816,-13,-15,1195,801,9,15,1204,786,577,69,89,93,0,,0,0.0,0.0,0.0,0.0,0.0
2024,8,15,4,2024-08-15,NK,3534,ATL,SLC,"Atlanta, GA",Georgia,"Salt Lake City, UT",Utah,970,2204,13,20,983,2224,20,13,1003,2211,736,101,121,134,0,,0,3.0,1.0,0.0,0.0,16.0
2024,3,6,3,2024-03-06,AA,6833,LAX,BOS,"Los Angeles, CA",California,"Boston, MA",Massachusetts,578,2105,3,10,581,2115,25,3,606,2112,670,89,109,117,0,,0,0.0,0.0,0.0,0.0,0.0
2024,11,30,6,2024-11-30,AA,9410,MSP,SFO,"Minneapolis, MN",Minnesota,"San Francisco, CA",California,1228,843,13,15,1241,858,12,11,1253,847,913,111,131,134,0,,0,0.0,0.0,0.0,0.0,0.0
2024,9,18,3,2024-09-18,WN,1965,LAS,DEN,"Las Vegas, NV",Nevada,"Denver, CO",Colorado,1617,702,-15,-15,1602,687,11,7,1613,680,1264,148,168,166,0,,0,0.0,0.0,0.0,0.0,0.0
2024,10,21,1,2024-10-21,9E,824,SEA,ORD,"Seattle, WA",Washington,"Chicago, IL",Illinois,1183,1116,-10,0,1173,1116,7,9,1180,1107,1868,236,256,252,0,,0,0.0,0.0,0.0,0.0,0.0
2024,8,30,5,2024-08-30,NK,811,IAH,ORD,"Houston, TX",Texas,"Chicago, IL",Illinois,542,863,-8,-10,534,853,25,4,559,849,958,113,133,142,0,,0,0.0,0.0,0.0,0.0,0.0
2024,7,4,4,2024-07-04,DL,7810,JFK,HNL,"New York, NY",New York,"Honolulu, HI",Hawaii,631,840,-2,0,629,840,12,17,641,823,2876,364,384,393,0,,0,0.0,0.0,0.0,0.0,0.0
2024,9,2,1,2024-09-02,OO,5180,HNL,DTW,"Honolulu, HI",Hawaii,"Detroit, MI",Michigan,576,1460,-3,-10,573,1450,9,8,582,1442,680,91,111,108,0,,0,0.0,0.0,0.0,0.0,0.0
2024,5,4,6,2024-05-04,DL,490,ATL,MIA,"Atlanta, GA",Georgia,"Miami, FL",Florida,1755,1333,1,5,1756,1338,18,3,1774,1335,2487,311,331,332,0,,0,0.0,0.0,0.0,0.0,0.0
2024,9,24,2,2024-09-24,AA,9362,BWI,SFO,"Baltimore, MD",Maryland,"San Francisco, CA",California,538,1852,3,0,541,1852,6,7,547,1845,1669,217,237,230,0,,0,0.0,0.0,0.0,0.0,0.0
2024,5,10,5,2024-05-10,9E,4587,SEA,BWI,"Seattle, WA",Washington,"Baltimore, MD",Maryland,2089,2075,6,0,2095,2075,14,4,2109,2071,560,67,87,85,0,,0,0.0,0.0,0.0,0.0,0.0
2024,8,24,6,2024-08-24,DL,8216,DEN,JFK,"Denver, CO",Colorado,"New York, NY",New York,650,1530,17,10,667,1540,22,16,689,1524,1868,230,250,268,0,,0,0.0,0.0,0.0,0.0,0.0
2024,1,18,4,2024-01-18,MQ,6847,SAN,HNL,"San Diego, CA",California,"Honolulu, HI",Hawaii,2223,1054,-10,0,2213,1054,21,19,2234,1035,267,24,44,64,0,,0,0.0,0.0,0.0,0.0,0.0
2024,2,9,5,2024-02-09,HA,6166,SEA,DCA,"Seattle, WA",Washington,"Washington, DC",District of Columbia,1475,1585,-12,-10,1463,1575,10,14,1473,1561,620,71,91,95,0,,0,0.0,0.0,0.0,0.0,0.0
2024,1,21,7,2024-01-21,NK,4594,SLC,MIA,"Salt Lake City, UT",Utah,"Miami, FL",Florida,1942,1143,-1,0,1941,1143,21,8,1962,1135,325,42,62,71,0,,0,0.0,0.0,0.0,0.0,0.0
2024,8,12,1,2024-08-12,G4,3672,ATL,HNL,"Atlanta, GA",Georgia,"Honolulu, HI",Hawaii,1709,1464,25,20,1734,1484,28,9,1762,1475,2976,378,398,415,0,,0,3.0,1.0,0.0,0.0,16.0
2024,12,20,5,2024-12-20,AS,7869,HNL,LAS,"Honolulu, HI",Hawaii,"Las Vegas, NV",Nevada,817,973,0,0,817,973,21,18,838,955,1255,148,168,187,0,,0,0.0,0.0,0.0,0.0,0.0
2024,10,8,2,2024-10-08,9E,2411,ATL,CLT,"Atlanta, GA",Georgia,"Charlotte, NC",North Carolina,1987,1647,-7,0,1980,1647,28,15,2008,1632,981,126,146,169,0,,0,0.0,0.0,0.0,0.0,0.0
2024,1,8,1,2024-01-08,DL,6873,DFW,BOS,"Dallas/Fort Worth, TX",Texas,"Boston, MA",Massachusetts,1955,1929,23,15,1978,1944,26,4,2004,1940,674,85,105,115,0,,0,0.0,0.0,0.0,0.0,0.0
2024,4,9,2,2024-04-09,YX,7005,PHL,IAD,"Philadelphia, PA",Pennsylvania,"Washington, DC",District of Columbia,1658,973,-3,0,1655,973,29,19,1684,954,2593,316,336,364,0,,0,0.0,0.0,0.0,0.0,0.0
2024,8,27,2,2024-08-27,HA,3742,SEA,DEN,"Seattle, WA",Washington,"Denver, CO",Colorado,2026,1810,52,60,2078,1870,23,7,2101,1863,1347,167,187,197,0,,0,16.0,16.0,7.0,1.0,20.0
2024,3,27,3,2024-03-27,9E,6438,SLC,SFO,"Salt Lake City, UT",Utah,"San Francisco, CA",California,2208,1560,-17,-10,2191,1550,20,4,2211,1546,2703,342,362,366,0,,0,0.0,0.0,0.0,0.0,0.0
2024,10,24,4,2024-10-24,HA,2709,PHL,BWI,"Philadelphia, PA",Pennsylvania,"Baltimore, MD",Maryland,1792,1239,-3,0,1789,1239,27,3,1816,1236,2533,324,344,354,0,,0,0.0,0.0,0.0,0.0,0.0
2024,1,14,7,2024-01-14,9E,9722,EWR,MDW,"Newark, NJ",New Jersey,"Chicago, IL",Illinois,936,711,-9,-10,927,701,6,3,933,698,2452,298,318,307,0,,0,0.0,0.0,0.0,0.0,0.0
2024,11,29,5,2024-11-29,MQ,6340,STL,BWI,"St. Louis, MO",Missouri,"Baltimore, MD",Maryland,1126,1092,-6,0,1120,1092,9,10,1129,1082,679,83,103,102,0,,0,0.0,0.0,0.0,0.0,0.0
2024,1,2,2,2024-01-02,G4,7906,EWR,JFK,"Newark, NJ",New Jersey,"New York, NY",New York,2021,893,-18,-10,2003,883,16,13,2019,870,444,46,66,75,0,,0,0.0,0.0,0.0,0.0,0.0
2024,10,19,6,2024-10-19,NK,857,PHL,SAN,"Philadelphia, PA",Pennsylvania,"San Diego, CA",California,2256,1021,-16,-10,2240,1011,5,14,2245,997,882,114,134,133,0,,0,0.0,0.0,0.0,0.0,0.0
2024,11,20,3,2024-11-20,OO,5186,MCO,BWI,"Orlando, FL",Florida,"Baltimore, MD",Maryland,1050,748,-17,-10,1033,738,9,6,1042,732,2428,299,319,314,0,,0,0.0,0.0,0.0,0.0,0.0
2024,2,10,6,2024-02-10,AA,6320,JFK,DTW,"New York, NY",New York,"Detroit, MI",Michigan,839,750,-5,-5,834,745,12,9,846,736,2627,337,357,358,0,,0,0.0,0.0,0.0,0.0,0.0
2024,11,13,3,2024-11-13,YX,5702,PDX,MDW,"Portland, OR",Oregon,"Chicago, IL",Illinois,1765,1797,-10,-15,1755,1782,14,15,1769,1767,1425,175,195,204,0,,0,0.0,0.0,0.0,0.0,0.0
2024,11,11,1,2024-11-11,G4,9426,PDX,TPA,"Portland, OR",Oregon,"Tampa, FL",Florida,1744,1820,17,10,1761,1830,7,9,1768,1821,1400,179,199,195,0,,0,0.0,0.0,0.0,0.0,0.0
2024,4,20,6,2024-04-20,DL,6221,ATL,PDX,"Atlanta, GA",Georgia,"Portland, OR",Oregon,1157,1878,-15,-10,1142,1868,10,6,1152,1862,703,84,104,100,0,,0,0.0,0.0,0.0,0.0,0.0
2024,1,14,7,2024-01-14,WN,9056,PHX,BOS,"Phoenix, AZ",Arizona,"Boston, MA",Massachusetts,1417,2037,0,-5,1417,2032,17,14,1434,2018,2501,314,334,345,0,,0,0.0,0.0,0.0,0.0,0.0
2024,8,18,7,2024-08-18,G4,2825,MDW,EWR,"Chicago, IL",Illinois,"Newark, NJ",New Jersey,2199,767,-30,-20,2169,747,24,15,2193,732,1858,241,261,280,0,,0,0.0,0.0,0.0,0.0,0.0
2024,3,24,7,2024-03-24,WN,3468,DCA,TPA,"Washington, DC",District of Columbia,"Tampa, FL",Florida,860,1705,-7,-15,853,1690,12,5,865,1685,1313,157,177,174,0,,0,0.0,0.0,0.0,0.0,0.0
2024,5,9,4,2024-05-09,UA,3597,IAD,SFO,"Washington, DC",District of Columbia,"San Francisco, CA",California,1495,669,19,10,1514,679,22,16,1536,663,2667,334,354,372,1,,0,0.0,0.0,0.0,0.0,0.0
2024,8,18,7,2024-08-18,AA,8274,LAX,TPA,"Los Angeles, CA",California,"Tampa, FL",Florida,1270,1025,15,10,1285,1035,9,18,1294,1017,1979,248,268,275,0,,0,0.0,0.0,0.0,0.0,0.0
2024,11,21,4,2024-11-21,NK,9964,SAN,MSP,"San Diego, CA",California,"Minneapolis, MN",Minnesota,689,2025,9,10,698,2035,10,4,708,2031,838,98,118,112,0,,0,0.0,0.0,0.0,0.0,0.0
2024,5,24,5,2024-05-24,HA,5742,DEN,SLC,"Denver, CO",Colorado,"Salt Lake City, UT",Utah,912,1124,-2,-5,910,1119,28,3,938,1116,2530,307,327,338,0,,0,0.0,0.0,0.0,0.0,0.0
2024,12,10,2,2024-12-10,AS,8874,PHX,STL,"Phoenix, AZ",Arizona,"St. Louis, MO",Missouri,828,2254,-8,-15,820,2239,6,16,826,2223,640,75,95,97,0,,0,0.0,0.0,0.0,0.0,0.0
2024,1,28,7,2024-01-28,9E,4866,DFW,MSP,"Dallas/Fort Worth, TX",Texas,"Minneapolis, MN",Minnesota,2299,811,-13,-15,2286,796,29,6,2315,790,1891,236,256,271,0,,0,0.0,0.0,0.0,0.0,0.0
2024,3,6,3,2024-03-06,WN,4733,DTW,SAN,"Detroit, MI",Michigan,"San Diego, CA",California,1745,701,2,0,1747,701,11,7,1758,694,309,38,58,56,0,,0,0.0,0.0,0.0,0.0,0.0
2024,6,11,2,2024-06-11,AS,1921,MIA,BWI,"Miami, FL",Florida,"Baltimore, MD",Maryland,2209,2331,14,10,2223,2341,20,9,2243,2332,702,79,99,108,0,,0,0.0,0.0,0.0,0.0,0.0
2024,8,16,5,2024-08-16,AS,1285,DEN,DCA,"Denver, CO",Colorado,"Washington, DC",District of Columbia,591,2212,8,15,599,2227,14,13,613,2214,2035,253,273,280,0,,0,0.0,0.0,0.0,0.0,0.0
2024,9,17,2,2024-09-17,MQ,1737,MDW,MIA,"Chicago, IL",Illinois,"Miami, FL",Florida,939,1961,-3,-10,936,1951,24,14,960,1937,2674,339,359,377,0,,0,0.0,0.0,0.0,0.0,0.0
2024,6,12,3,2024-06-12,WN,7336,BWI,SEA,"Baltimore, MD",Maryland,"Seattle, WA",Washington,1629,932,-1,-5,1628,927,14,10,1642,917,766,100,120,124,0,,0,0.0,0.0,0.0,0.0,0.0
2024,10,27,7,2024-10-27,OH,8480,ATL,SEA,"Atlanta, GA",Georgia,"Seattle, WA",Washington,744,804,-20,-15,724,789,6,9,730,780,1218,160,180,175,0,,0,0.0,0.0,0.0,0.0,0.0
2024,10,29,2,2024-10-29,MQ,1846,HNL,PDX,"Honolulu, HI",Hawaii,"Portland, OR",Oregon,1828,2110,4,5,1832,2115,12,5,1844,2110,1311,166,186,183,0,,0,0.0,0.0,0.0,0.0,0.0
2024,10,13,7,2024-10-13,AS,5897,DEN,IAD,"Denver, CO",Colorado,"Washington, DC",District of Columbia,2078,828,-6,-10,2072,818,6,4,2078,814,2184,270,290,280,0,,0,0.0,0.0,0.0,0.0,0.0
2024,1,10,3,2024-01-10,9E,8189,DCA,LAX,"Washington, DC",District of Columbia,"Los Angeles, CA",California,1408,1812,-10,0,1398,1812,6,12,1404,1800,304,43,63,61,1,,0,0.0,0.0,0.0,0.0,0.0
2024,7,13,6,2024-07-13,OO,2720,DFW,STL,"Dallas/Fort Worth, TX",Texas,"St. Louis, MO",Missouri,2293,1722,9,15,2302,1737,17,17,2319,1720,1122,145,165,179,0,,0,0.0,0.0,0.0,0.0,0.0
2024,4,27,6,2024-04-27,F9,7697,CLT,IAH,"Charlotte, NC",North Carolina,"Houston, TX",Texas,1332,2034,3,5,1335,2039,29,19,1364,2020,721,86,106,134,0,,0,0.0,0.0,0.0,0.0,0.0
2024,9,26,4,2024-09-26,MQ,8102,SLC,TPA,"Salt Lake City, UT",Utah,"Tampa, FL",Florida,2121,1553,-12,-15,2109,1538,8,5,2117,1533,1093,126,146,139,0,,0,0.0,0.0,0.0,0.0,0.0
2024,3,20,3,2024-03-20,UA,6207,HNL,PHX,"Honolulu, HI",Hawaii,"Phoenix, AZ",Arizona,596,2353,-20,-20,576,2333,11,15,587,2318,2316,294,314,320,0,,0,0.0,0.0,0.0,0.0,0.0
2024,4,2,2,2024-04-02,WN,9476,ATL,DTW,"Atlanta, GA",Georgia,"Detroit, MI",Michigan,1437,1059,0,5,1437,1064,18,4,1455,1060,2640,339,359,361,0,,0,0.0,0.0,0.0,0.0,0.0
2024,9,22,7,2024-09-22,9E,2893,TPA,SEA,"Tampa, FL",Florida,"Seattle, WA",Washington,1453,1817,5,0,1458,1817,24,17,1482,1800,2058,248,268,289,0,,0,0.0,0.0,0.0,0.0,0.0
2024,11,27,3,2024-11-27,MQ,2600,DEN,LAS,"Denver, CO",Colorado,"Las Vegas, NV",Nevada,2000,1154,3,5,2003,1159,9,19,2012,1140,713,83,103,111,0,,0,0.0,0.0,0.0,0.0,0.0
2024,12,15,7,2024-12-15,YX,8461,LGA,EWR,"New York, NY",New York,"Newark, NJ",New Jersey,1789,1489,-18,-10,1771,1479,5,3,1776,1476,2585,314,334,322,0,,0,0.0,0.0,0.0,0.0,0.0
2024,12,26,4,2024-12-26,OH,5025,HNL,LAS,"Honolulu, HI",Hawaii,"Las Vegas, NV",Nevada,1074,1235,7,10,1081,1245,5,16,1086,1229,2821,358,378,379,0,,0,0.0,0.0,0.0,0.0,0.0
2024,9,13,5,2024-09-13,HA,1180,ATL,MCO,"Atlanta, GA",Georgia,"Orlando, FL",Florida,602,1643,11,5,613,1648,23,3,636,1645,740,88,108,114,0,,0,0.0,0.0,0.0,0.0,0.0
2024,5,12,7,2024-05-12,AA,9555,MSP,SEA,"Minneapolis, MN",Minnesota,"Seattle, WA",Washington,1777,1530,8,10,1785,1540,10,13,1795,1527,2508,314,334,337,0,,0,0.0,0.0,0.0,0.0,0.0
2024,10,2,3,2024-10-02,WN,4964,LGA,HNL,"New York, NY",New York,"Honolulu, HI",Hawaii,1978,910,1,-5,1979,905,20,5,1999,900,1599,197,217,222,0,,0,0.0,0.0,0.0,0.0,0.0
2024,9,20,5,2024-09-20,OO,4553,BWI,ORD,"Baltimore, MD",Maryland,"Chicago, IL",Illinois,1328,1441,-16,-10,1312,1431,16,15,1328,1416,2997,374,394,405,0,,0,0.0,0.0,0.0,0.0,0.0
2024,6,19,3,2024-06-19,9E,2348,PHL,IAD,"Philadelphia, PA",Pennsylvania,"Washington, DC",District of Columbia,1012,1279,-10,-10,1002,1269,5,11,1007,1258,2444,313,333,329,0,,0,0.0,0.0,0.0,0.0,0.0
2024,1,1,1,2024-01-01,9E,1425,SLC,MCO,"Salt Lake City, UT",Utah,"Orlando, FL",Florida,1165,2181,10,15,1175,2196,16,17,1191,2179,2185,277,297,310,0,,0,0.0,0.0,0.0,0.0,0.0
2024,11,8,5,2024-11-08,YX,3973,JFK,EWR,"New York, NY",New York,"Newark, NJ",New Jersey,2016,1595,-7,-10,2009,1585,24,11,2033,1574,750,94,114,129,0,,0,0.0,0.0,0.0,0.0,0.0
2024,3,4,1,2024-03-04,OH,1788,ORD,JFK,"Chicago, IL",Illinois,"New York, NY",New York,1784,2358,-23,-15,1761,2343,29,9,1790,2334,1374,175,195,213,0,,0,0.0,0.0,0.0,0.0,0.0
2024,10,10,4,2024-10-10,G4,3085,PHX,SFO,"Phoenix, AZ",Arizona,"San Francisco, CA",California,534,678,-4,-10,530,668,22,9,552,659,934,122,142,153,0,,0,0.0,0.0,0.0,0.0,0.0
2024,4,30,2,2024-04-30,F9,2176,PHL,MSP,"Philadelphia, PA",Pennsylvania,"Minneapolis, MN",Minnesota,1904,1793,-2,5,1902,1798,6,4,1908,1794,2499,312,332,322,0,,0,0.0,0.0,0.0,0.0,0.0
2024,4,16,2,2024-04-16,OO,9821,ATL,STL,"Atlanta, GA",Georgia,"St. Louis, MO",Missouri,896,845,7,10,903,855,22,4,925,851,2745,349,369,375,0,,0,0.0,0.0,0.0,0.0,0.0
2024,6,23,7,2024-06-23,WN,1561,LGA,ATL,"New York, NY",New York,"Atlanta, GA",Georgia,526,1382,5,10,531,1392,14,3,545,1389,2007,251,271,268,0,,0,0.0,0.0,0.0,0.0,0.0
2024,7,22,1,2024-07-22,YX,9694,TPA,LAS,"Tampa, FL",Florida,"Las Vegas, NV",Nevada,805,1071,0,0,805,1071,14,18,819,1053,1629,202,222,234,0,,0,0.0,0.0,0.0,0.0,0.0
2024,6,13,4,2024-06-13,NK,172,LAX,SFO,"Los Angeles, CA",California,"San Francisco, CA",California,2259,1722,35,45,2294,1767,27,12,2321,1755,1954,239,259,278,0,,0,0.0,10.0,5.0,0.0,30.0
2024,10,31,4,2024-10-31,9E,6130,STL,SFO,"St. Louis, MO",Missouri,"San Francisco, CA",California,1198,921,-11,-15,1187,906,27,18,1214,888,1124,136,156,181,0,,0,0.0,0.0,0.0,0.0,0.0
2024,4,29,1,2024-04-29,UA,4711,PDX,PHL,"Portland, OR",Oregon,"Philadelphia, PA",Pennsylvania,2194,740,15,10,2209,750,10,15,2219,735,1363,173,193,198,0,,0,0.0,0.0,0.0,0.0,0.0
2024,2,13,2,2024-02-13,G4,2896,PDX,DTW,"Portland, OR",Oregon,"Detroit, MI",Michigan,1080,1732,-14,-5,1066,1727,6,4,1072,1723,2260,287,307,297,0,,0,0.0,0.0,0.0,0.0,0.0
2024,11,7,4,2024-11-07,9E,7817,ORD,DTW,"Chicago, IL",Illinois,"Detroit, MI",Michigan,664,912,2,0,666,912,20,4,686,908,833,96,116,120,0,,0,0.0,0.0,0.0,0.0,0.0
2024,6,4,2,2024-06-04,WN,4616,ATL,MSP,"Atlanta, GA",Georgia,"Minneapolis, MN",Minnesota,1781,2272,-14,-15,1767,2257,9,12,1776,2245,1349,166,186,187,0,,0,0.0,0.0,0.0,0.0,0.0
2024,7,25,4,2024-07-25,DL,2593,MSP,HNL,"Minneapolis, MN",Minnesota,"Honolulu, HI",Hawaii,601,1744,-17,-20,584,1724,10,14,594,1710,1103,132,152,156,0,,0,0.0,0.0,0.0,0.0,0.0
2024,4,17,3,2024-04-17,9E,4331,MDW,DTW,"Chicago, IL",Illinois,"Detroit, MI",Michigan,954,698,-15,-5,939,693,26,7,965,686,351,37,57,70,0,,0,0.0,0.0,0.0,0.0,0.0
2024,9,7,6,2024-09-07,B6,3676,PHL,ORD,"Philadelphia, PA",Pennsylvania,"Chicago, IL",Illinois,692,2201,-10,-10,682,2191,26,10,708,2181,2467,301,321,337,0,,0,0.0,0.0,0.0,0.0,0.0
2024,11,29,5,2024-11-29,DL,8200,ORD,PDX,"Chicago, IL",Illinois,"Portland, OR",Oregon,2294,1093,-7,0,2287,1093,26,19,2313,1074,2028,257,277,302,0,,0,0.0,0.0,0.0,0.0,0.0
2024,5,9,4,2024-05-09,OH,5828,SAN,TPA,"San Diego, CA",California,"Tampa, FL",Florida,1415,1767,-13,-15,1402,1752,5,11,1407,1741,2594,323,343,339,0,,0,0.0,0.0,0.0,0.0,0.0
2024,10,19,6,2024-10-19,9E,132,DEN,SAN,"Denver, CO",Colorado,"San Diego, CA",California,1397,709,-6,-15,1391,694,8,17,1399,677,875,99,119,124,0,,0,0.0,0.0,0.0,0.0,0.0
2024,1,20,6,2024-01-20,AS,4473,DFW,STL,"Dallas/Fort Worth, TX",Texas,"St. Louis, MO",Missouri,1309,1083,5,10,1314,1093,21,15,1335,1078,2832,350,370,386,0,,0,0.0,0.0,0.0,0.0,0.0
2024,10,8,2,2024-10-08,OO,3698,DCA,SEA,"Washington, DC",District of Columbia,"Seattle, WA",Washington,798,729,9,15,807,744,17,16,824,728,1238,160,180,193,0,,0,0.0,0.0,0.0,0.0,0.0
2024,10,11,5,2024-10-11,9E,2492,DTW,DFW,"Detroit, MI",Michigan,"Dallas/Fort Worth, TX",Texas,520,2023,13,20,533,2043,16,10,549,2033,1538,185,205,211,0,,0,5.0,2.0,3.0,0.0,10.0
2024,1,1,1,2024-01-01,AA,6805,BOS,MCO,"Boston, MA",Massachusetts,"Orlando, FL",Florida,544,1439,7,5,551,1444,17,19,568,1425,1973,245,265,281,0,,1,0.0,0.0,0.0,0.0,0.0
2024,4,28,7,2024-04-28,OH,6890,CLT,PHX,"Charlotte, NC",North Carolina,"Phoenix, AZ",Arizona,2003,1105,12,5,2015,1110,23,13,2038,1097,1996,239,259,275,0,,0,0.0,0.0,0.0,0.0,0.0
2024,2,4,7,2024-02-04,AS,2777,SEA,HNL,"Seattle, WA",Washington,"Honolulu, HI",Hawaii,995,1368,12,10,1007,1378,20,10,1027,1368,1699,211,231,241,0,,0,0.0,0.0,0.0,0.0,0.0
2024,7,16,2,2024-07-16,WN,1501,SEA,TPA,"Seattle, WA",Washington,"Tampa, FL",Florida,1182,809,2,5,1184,814,15,16,1199,798,2774,355,375,386,0,,0,0.0,0.0,0.0,0.0,0.0
2024,9,1,7,2024-09-01,UA,917,BWI,PHX,"Baltimore, MD",Maryland,"Phoenix, AZ",Arizona,2213,960,3,-5,2216,955,22,3,2238,952,2649,327,347,352,0,,0,0.0,0.0,0.0,0.0,0.0
2024,2,28,3,2024-02-28,DL,6303,LAS,IAH,"Las Vegas, NV",Nevada,"Houston, TX",Texas,722,753,-6,-10,716,743,22,14,738,729,1949,241,261,277,0,,0,0.0,0.0,0.0,0.0,0.0
2024,11,20,3,2024-11-20,NK,9952,TPA,SAN,"Tampa, FL",Florida,"San Diego, CA",California,798,2268,-20,-10,778,2258,26,12,804,2246,2892,352,372,390,0,,0,0.0,0.0,0.0,0.0,0.0
2024,6,9,7,2024-06-09,G4,4662,CLT,PDX,"Charlotte, NC",North Carolina,"Portland, OR",Oregon,2004,1132,10,10,2014,1142,5,14,2019,1128,2077,252,272,271,0,,0,0.0,0.0,0.0,0.0,0.0
2024,6,27,4,2024-06-27,YX,4823,STL,IAH,"St. Louis, MO",Missouri,"Houston, TX",Texas,1547,2170,10,5,1557,2175,8,17,1565,2158,2141,273,293,298,0,,0,0.0,0.0,0.0,0.0,0.0
2024,7,24,3,2024-07-24,UA,2538,LAX,PDX,"Los Angeles, CA",California,"Portland, OR",Oregon,1861,1983,-1,0,1860,1983,13,5,1873,1978,284,30,50,48,0,,0,0.0,0.0,0.0,0.0,0.0
2024,1,12,5,2024-01-12,AS,6928,BWI,DFW,"Baltimore, MD",Maryland,"Dallas/Fort Worth, TX",Texas,1607,909,-24,-20,1583,889,7,11,1590,878,2462,304,324,322,0,,0,0.0,0.0,0.0,0.0,0.0
2024,10,2,3,2024-10-02,G4,1310,BWI,MDW,"Baltimore, MD",Maryland,"Chicago, IL",Illinois,1583,1073,-13,-10,1570,1063,12,10,1582,1053,1415,179,199,201,0,,0,0.0,0.0,0.0,0.0,0.0
2024,6,29,6,2024-06-29,DL,6741,MIA,MSP,"Miami, FL",Florida,"Minneapolis, MN",Minnesota,787,1335,14,5,801,1340,13,12,814,1328,1891,237,257,262,0,,0,0.0,0.0,0.0,0.0,0.0
2024,8,29,4,2024-08-29,NK,699,PDX,SLC,"Portland, OR",Oregon,"Salt Lake City, UT",Utah,2157,1235,5,0,2162,1235,22,10,2184,1225,1443,188,208,220,0,,0,0.0,0.0,0.0,0.0,0.0
2024,8,3,6,2024-08-03,B6,5580,HNL,PHX,"Honolulu, HI",Hawaii,"Phoenix, AZ",Arizona,1016,1475,-6,-5,1010,1470,9,18,1019,1452,538,61,81,88,0,,0,0.0,0.0,0.0,0.0,0.0
2024,9,7,6,2024-09-07,B6,1946,ORD,SEA,"Chicago, IL",Illinois,"Seattle, WA",Washington,1397,899,-12,-5,1385,894,26,13,1411,881,2260,282,302,321,0,,0,0.0,0.0,0.0,0.0,0.0
2024,10,25,5,2024-10-25,OO,6692,IAD,DFW,"Washington, DC",District of Columbia,"Dallas/Fort Worth, TX",Texas,653,940,1,0,654,940,9,10,663,930,692,92,112,111,0,,0,0.0,0.0,0.0,0.0,0.0
2024,5,5,7,2024-05-05,NK,7961,MSP,DTW,"Minneapolis, MN",Minnesota,"Detroit, MI",Michigan,780,1627,25,20,805,1647,26,9,831,1638,756,95,115,130,0,,0,0.0,0.0,1.0,0.0,19.0
2024,8,4,7,2024-08-04,G4,1987,SEA,PHX,"Seattle, WA",Washington,"Phoenix, AZ",Arizona,933,1234,22,15,955,1249,9,5,964,1244,1334,160,180,174,0,,0,0.0,0.0,0.0,0.0,0.0
2024,11,1,5,2024-11-01,WN,779,MSP,MIA,"Minneapolis, MN",Minnesota,"Miami, FL",Florida,841,1153,-15,-20,826,1133,27,10,853,1123,2341,282,302,319,0,,0,0.0,0.0,0.0,0.0,0.0
2024,10,11,5,2024-10-11,G4,3352,DEN,HNL,"Denver, CO",Colorado,"Honolulu, HI",Hawaii,585,1792,2,0,587,1792,20,7,607,1785,2594,320,340,347,0,,0,0.0,0.0,0.0,0.0,0.0
2024,7,3,3,2024-07-03,HA,1935,ORD,MCO,"Chicago, IL",Illinois,"Orlando, FL",Florida,2110,1019,0,-5,2110,1014,9,7,2119,1007,2375,292,312,308,0,,0,0.0,0.0,0.0,0.0,0.0
2024,2,8,4,2024-02-08,OH,2277,MDW,HNL,"Chicago, IL",Illinois,"Honolulu, HI",Hawaii,1278,1903,4,0,1282,1903,9,19,1291,1884,317,39,59,67,0,,0,0.0,0.0,0.0,0.0,0.0
2024,8,10,6,2024-08-10,MQ,8242,HNL,DCA,"Honolulu, HI",Hawaii,"Washington, DC",District of Columbia,690,1336,-3,0,687,1336,16,16,703,1320,2502,307,327,339,0,,0,0.0,0.0,0.0,0.0,0.0
2024,7,2,2,2024-07-02,OO,248,HNL,CLT,"Honolulu, HI",Hawaii,"Charlotte, NC",North Carolina,1775,988,-6,-10,1769,978,11,4,1780,974,604,70,90,85,0,,0,0.0,0.0,0.0,0.0,0.0
2024,6,26,3,2024-06-26,9E,1595,STL,CLT,"St. Louis, MO",Missouri,"Charlotte, NC",North Carolina,1591,1808,1,5,1592,1813,7,9,1599,1804,245,29,49,45,0,,0,0.0,0.0,0.0,0.0,0.0
2024,10,20,7,2024-10-20,G4,1844,PDX,DCA,"Portland, OR",Oregon,"Washington, DC",District of Columbia,1669,1946,9,0,1678,1946,27,19,1705,1927,2748,335,355,381,0,,0,0.0,0.0,0.0,0.0,0.0
2024,12,5,4,2024-12-05,MQ,1746,CLT,DFW,"Charlotte, NC",North Carolina,"Dallas/Fort Worth, TX",Texas,1490,610,53,45,1543,655,12,18,1555,637,2502,306,326,336,0,,0,5.0,7.0,3.0,1.0,29.0
2024,5,30,4,2024-05-30,WN,3095,EWR,TPA,"Newark, NJ",New Jersey,"Tampa, FL",Florida,1375,2308,-17,-20,1358,2288,25,9,1383,2279,2188,280,300,314,0,,0,0.0,0.0,0.0,0.0,0.0
2024,5,5,7,2024-05-05,UA,6743,DCA,SFO,"Washington, DC",District of Columbia,"San Francisco, CA",California,2157,1207,-15,-10,2142,1197,24,14,2166,1183,696,91,111,129,0,,0,0.0,0.0,0.0,0.0,0.0
2024,10,27,7,2024-10-27,DL,9964,LGA,BWI,"New York, NY",New York,"Baltimore, MD",Maryland,2077,877,7,5,2084,882,22,18,2106,864,2111,264,284,304,0,,0,0.0,0.0,0.0,0.0,0.0
2024,11,3,7,2024-11-03,G4,7478,BOS,SLC,"Boston, MA",Massachusetts,"Salt Lake City, UT",Utah,1161,1762,6,5,1167,1767,9,16,1176,1751,321,37,57,62,0,,0,0.0,0.0,0.0,0.0,0.0
2024,12,1,7,2024-12-01,YX,8949,DCA,STL,"Washington, DC",District of Columbia,"St. Louis, MO",Missouri,1073,1617,-4,0,1069,1617,10,9,1079,1608,1097,133,153,152,0,,0,0.0,0.0,0.0,0.0,0.0
2024,8,21,3,2024-08-21,DL,3767,ATL,SLC,"Atlanta, GA",Georgia,"Salt Lake City, UT",Utah,1778,2301,29,20,1807,2321,29,10,1836,2311,2717,331,351,370,0,,0,2.0,5.0,3.0,0.0,10.0
2024,1,8,1,2024-01-08,AS,9345,PDX,MCO,"Portland, OR",Oregon,"Orlando, FL",Florida,630,2322,-13,-5,617,2317,26,16,643,2301,910,109,129,151,0,,0,0.0,0.0,0.0,0.0,0.0
2024,12,6,5,2024-12-06,B6,676,DTW,EWR,"Detroit, MI",Michigan,"Newark, NJ",New Jersey,1338,1709,-13,-5,1325,1704,26,16,1351,1688,1224,160,180,202,0,,0,0.0,0.0,0.0,0.0,0.0
2024,5,8,3,2024-05-08,OH,4879,BWI,MCO,"Baltimore, MD",Maryland,"Orlando, FL",Florida,1458,830,7,15,1465,845,10,5,1475,840,791,103,123,118,0,,0,0.0,0.0,0.0,0.0,0.0
2024,9,20,5,2024-09-20,B6,8287,DEN,TPA,"Denver, CO",Colorado,"Tampa, FL",Florida,1900,2074,4,0,1904,2074,28,10,1932,2064,2864,367,387,405,0,,0,0.0,0.0,0.0,0.0,0.0
2024,6,5,3,2024-06-05,WN,3072,BWI,SLC,"Baltimore, MD",Maryland,"Salt Lake City, UT",Utah,2055,737,0,-5,2055,732,10,14,2065,718,1891,227,247,251,0,,0,0.0,0.0,0.0,0.0,0.0
2024,12,17,2,2024-12-17,AS,7856,MCO,EWR,"Orlando, FL",Florida,"Newark, NJ",New Jersey,1722,1596,7,5,1729,1601,15,13,1744,1588,900,108,128,136,0,,0,0.0,0.0,0.0,0.0,0.0
2024,12,23,1,2024-12-23,B6,4048,PHX,BOS,"Phoenix, AZ",Arizona,"Boston, MA",Massachusetts,1338,1130,5,0,1343,1130,17,13,1360,1117,1633,198,218,228,0,,0,0.0,0.0,0.0,0.0,0.0
2024,1,5,5,2024-01-05,OO,6644,DFW,PHX,"Dallas/Fort Worth, TX",Texas,"Phoenix, AZ",Arizona,720,1961,-14,-5,706,1956,18,5,724,1951,1221,155,175,178,0,,0,0.0,0.0,0.0,0.0,0.0
2024,3,26,2,2024-03-26,WN,2145,SLC,PHX,"Salt Lake City, UT",Utah,"Phoenix, AZ",Arizona,1933,1779,-15,-10,1918,1769,21,11,1939,1758,2224,282,302,314,0,,0,0.0,0.0,0.0,0.0,0.0
2024,6,23,7,2024-06-23,MQ,1727,ORD,SFO,"Chicago, IL",Illinois,"San Francisco, CA",California,1142,1206,1,-5,1143,1201,5,13,1148,1188,2341,297,317,315,0,,0,0.0,0.0,0.0,0.0,0.0
2024,10,16,3,2024-10-16,G4,1588,JFK,EWR,"New York, NY",New York,"Newark, NJ",New Jersey,1694,1640,-20,-15,1674,1625,14,12,1688,1613,2374,287,307,313,0,,0,0.0,0.0,0.0,0.0,0.0
2024,7,11,4,2024-07-11,MQ,9227,DCA,MDW,"Washington, DC",District of Columbia,"Chicago, IL",Illinois,1668,1391,22,15,1690,1406,6,18,1696,1388,2961,379,399,403,0,,0,0.0,0.0,0.0,0.0,0.0
2024,11,6,3,2024-11-06,AS,3663,HNL,PHX,"Honolulu, HI",Hawaii,"Phoenix, AZ",Arizona,987,1884,-9,-10,978,1874,17,6,995,1868,1599,207,227,230,0,,0,0.0,0.0,0.0,0.0,0.0
2024,4,28,7,2024-04-28,OO,1902,LGA,SFO,"New York, NY",New York,"San Francisco, CA",California,1351,1783,-2,-10,1349,1773,21,3,1370,1770,220,26,46,50,0,,0,0.0,0.0,0.0,0.0,0.0
2024,8,5,1,2024-08-05,9E,9712,LAS,SEA,"Las Vegas, NV",Nevada,"Seattle, WA",Washington,853,1932,1,0,854,1932,23,6,877,1926,1111,145,165,174,0,,0,0.0,0.0,0.0,0.0,0.0
2024,4,23,2,2024-04-23,9E,3691,DFW,HNL,"Dallas/Fort Worth, TX",Texas,"Honolulu, HI",Hawaii,1704,680,11,5,1715,685,7,10,1722,675,1260,148,168,165,0,,0,0.0,0.0,0.0,0.0,0.0
2024,5,24,5,2024-05-24,MQ,3620,PDX,EWR,"Portland, OR",Oregon,"Newark, NJ",New Jersey,1447,1296,-4,5,1443,1301,8,18,1451,1283,1309,160,180,186,0,,0,0.0,0.0,0.0,0.0,0.0
2024,1,26,5,2024-01-26,9E,5996,PDX,SEA,"Portland, OR",Oregon,"Seattle, WA",Washington,660,812,-2,-5,658,807,10,8,668,799,1518,184,204,202,0,,0,0.0,0.0,0.0,0.0,0.0
2024,5,15,3,2024-05-15,MQ,7743,JFK,MSP,"New York, NY",New York,"Minneapolis, MN",Minnesota,963,2050,12,10,975,2060,17,3,992,2057,880,118,138,138,0,,0,0.0,0.0,0.0,0.0,0.0
2024,10,29,2,2024-10-29,UA,7141,BWI,PHX,"Baltimore, MD",Maryland,"Phoenix, AZ",Arizona,1583,1965,-5,0,1578,1965,27,18,1605,1947,2525,312,332,357,0,,0,0.0,0.0,0.0,0.0,0.0
2024,8,19,1,2024-08-19,9E,3411,BWI,MCO,"Baltimore, MD",Maryland,"Orlando, FL",Florida,714,1982,1,-5,715,1977,18,3,733,1974,760,103,123,124,0,,0,0.0,0.0,0.0,0.0,0.0
2024,3,16,6,2024-03-16,AS,2405,LGA,DTW,"New York, NY",New York,"Detroit, MI",Michigan,1079,2302,8,10,1087,2312,13,18,1100,2294,856,97,117,128,0,,0,0.0,0.0,0.0,0.0,0.0
2024,11,23,6,2024-11-23,OH,7975,MCO,PHL,"Orlando, FL",Florida,"Philadelphia, PA",Pennsylvania,1715,805,-13,-10,1702,795,28,6,1730,789,609,78,98,112,0,,0,0.0,0.0,0.0,0.0,0.0
2024,12,10,2,2024-12-10,AA,2067,MSP,DTW,"Minneapolis, MN",Minnesota,"Detroit, MI",Michigan,987,1959,13,10,1000,1969,19,4,1019,1965,1645,211,231,234,0,,0,0.0,0.0,0.0,0.0,0.0
2024,10,28,1,2024-10-28,B6,8109,PHX,TPA,"Phoenix, AZ",Arizona,"Tampa, FL",Florida,724,1884,-9,0,715,1884,10,16,725,1868,836,103,123,129,0,,0,0.0,0.0,0.0,0.0,0.0
2024,10,15,2,2024-10-15,9E,5562,PHL,HNL,"Philadelphia, PA",Pennsylvania,"Honolulu, HI",Hawaii,1915,1499,14,15,1929,1514,29,8,1958,1506,1329,173,193,210,0,,0,0.0,0.0,0.0,0.0,0.0
2024,1,1,1,2024-01-01,AS,6997,STL,SAN,"St. Louis, MO",Missouri,"San Diego, CA",California,1208,1347,-18,-10,1190,1337,24,14,1214,1323,952,125,145,163,0,,0,0.0,0.0,0.0,0.0,0.0
2024,5,26,7,2024-05-26,HA,3558,SEA,EWR,"Seattle, WA",Washington,"Newark, NJ",New Jersey,660,1866,21,15,681,1881,15,7,696,1874,2058,262,282,284,0,,0,0.0,0.0,0.0,0.0,0.0
2024,10,13,7,2024-10-13,OO,8685,PDX,JFK,"Portland, OR",Oregon,"New York, NY",New York,2284,2355,1,5,2285,2360,26,16,2311,2344,1851,235,255,277,0,,0,0.0,0.0,0.0,0.0,0.0
2024,5,21,2,2024-05-21,F9,4878,PHX,CLT,"Phoenix, AZ",Arizona,"Charlotte, NC",North Carolina,954,1476,1,0,955,1476,11,7,966,1469,1808,225,245,243,0,,0,0.0,0.0,0.0,0.0,0.0
2024,2,22,4,2024-02-22,OO,3830,EWR,DFW,"Newark, NJ",New Jersey,"Dallas/Fort Worth, TX",Texas,1634,1181,-9,-5,1625,1176,22,18,1647,1158,1626,197,217,237,0,,0,0.0,0.0,0.0,0.0,0.0
2024,10,30,3,2024-10-30,HA,4465,TPA,CLT,"Tampa, FL",Florida,"Charlotte, NC",North Carolina,1582,994,12,20,1594,1014,21,18,1615,996,213,26,46,65,0,,0,7.0,5.0,3.0,0.0,5.0
2024,3,9,6,2024-03-09,HA,7647,IAD,MIA,"Washington, DC",District of Columbia,"Miami, FL",Florida,1044,2348,-10,-5,1034,2343,18,12,1052,2331,687,85,105,115,0,,0,0.0,0.0,0.0,0.0,0.0
2024,12,26,4,2024-12-26,G4,127,LAX,ORD,"Los Angeles, CA",California,"Chicago, IL",Illinois,2076,936,-8,0,2068,936,12,13,2080,923,313,42,62,67,0,,0,0.0,0.0,0.0,0.0,0.0
2024,3,30,6,2024-03-30,OO,3591,STL,IAH,"St. Louis, MO",Missouri,"Houston, TX",Texas,2196,1398,-2,5,2194,1403,12,7,2206,1396,1987,243,263,262,0,,0,0.0,0.0,0.0,0.0,0.0
2024,8,7,3,2024-08-07,UA,6523,EWR,PHL,"Newark, NJ",New Jersey,"Philadelphia, PA",Pennsylvania,528,1380,-5,-10,523,1370,11,6,534,1364,1289,165,185,182,0,,0,0.0,0.0,0.0,0.0,0.0
2024,7,10,3,2024-07-10,DL,5401,BWI,MIA,"Baltimore, MD",Maryland,"Miami, FL",Florida,1266,878,-6,-10,1260,868,29,9,1289,859,1678,212,232,250,0,,0,0.0,0.0,0.0,0.0,0.0
2024,3,3,7,2024-03-03,MQ,6260,LAS,LGA,"Las Vegas, NV",Nevada,"New York, NY",New York,684,848,-5,5,679,853,13,8,692,845,2802,351,371,372,0,,0,0.0,0.0,0.0,0.0,0.0
2024,3,13,3,2024-03-13,WN,1273,SEA,PHL,"Seattle, WA",Washington,"Philadelphia, PA",Pennsylvania,1747,1432,-24,-15,1723,1417,16,17,1739,1400,1088,139,159,172,0,,0,0.0,0.0,0.0,0.0,0.0
2024,6,9,7,2024-06-09,F9,438,HNL,LAS,"Honolulu, HI",Hawaii,"Las Vegas, NV",Nevada,856,2331,0,10,856,2341,7,17,863,2324,965,120,140,144,0,,0,0.0,0.0,0.0,0.0,0.0
2024,6,17,1,2024-06-17,OO,9360,PHL,SFO,"Philadelphia, PA",Pennsylvania,"San Francisco, CA",California,991,1653,7,0,998,1653,5,19,1003,1634,593,81,101,105,0,,0,0.0,0.0,0.0,0.0,0.0
2024,3,29,5,2024-03-29,F9,941,DEN,IAH,"Denver, CO",Colorado,"Houston, TX",Texas,1232,1511,-7,0,1225,1511,19,12,1244,1499,836,111,131,142,0,,0,0.0,0.0,0.0,0.0,0.0
2024,6,24,1,2024-06-24,UA,393,HNL,ATL,"Honolulu, HI",Hawaii,"Atlanta, GA",Georgia,2121,1538,-15,-10,2106,1528,13,13,2119,1515,2322,293,313,319,0,,0,0.0,0.0,0.0,0.0,0.0
2024,9,25,3,2024-09-25,WN,9614,LAX,HNL,"Los Angeles, CA",California,"Honolulu, HI",Hawaii,1077,1754,5,5,1082,1759,21,4,1103,1755,1799,220,240,245,0,,0,0.0,0.0,0.0,0.0,0.0
2024,3,13,3,2024-03-13,UA,6658,MSP,SEA,"Minneapolis, MN",Minnesota,"Seattle, WA",Washington,613,1123,11,10,624,1133,16,5,640,1128,303,31,51,52,0,,0,0.0,0.0,0.0,0.0,0.0
2024,9,1,7,2024-09-01,9E,1747,TPA,STL,"Tampa, FL",Florida,"St. Louis, MO",Missouri,877,1059,-3,0,874,1059,21,8,895,1051,2753,350,370,379,0,,0,0.0,0.0,0.0,0.0,0.0
2024,3,17,7,2024-03-17,DL,4998,DEN,ATL,"Denver, CO",Colorado,"Atlanta, GA",Georgia,1808,994,-2,-5,1806,989,17,5,1823,984,1780,219,239,241,0,,0,0.0,0.0,0.0,0.0,0.0
2024,6,7,5,2024-06-07,WN,4626,IAH,DFW,"Houston, TX",Texas,"Dallas/Fort Worth, TX",Texas,596,2151,-11,-10,585,2141,17,9,602,2132,685,91,111,117,0,,0,0.0,0.0,0.0,0.0,0.0
2024,11,19,2,2024-11-19,AS,5714,MSP,ORD,"Minneapolis, MN",Minnesota,"Chicago, IL",Illinois,1341,1012,-2,5,1339,1017,19,5,1358,1012,1937,246,266,270,0,,0,0.0,0.0,0.0,0.0,0.0
2024,4,7,7,2024-04-07,OO,3901,IAH,DFW,"Houston, TX",Texas,"Dallas/Fort Worth, TX",Texas,623,716,4,0,627,716,25,17,652,699,473,65,85,107,0,,0,0.0,0.0,0.0,0.0,0.0
2024,4,11,4,2024-04-11,OH,8380,DTW,DEN,"Detroit, MI",Michigan,"Denver, CO",Colorado,655,1772,-5,-10,650,1762,22,15,672,1747,2758,335,355,372,0,,0,0.0,0.0,0.0,0.0,0.0
2024,5,11,6,2024-05-11,OO,7476,SFO,BOS,"San Francisco, CA",California,"Boston, MA",Massachusetts,609,708,8,5,617,713,19,8,636,705,1206,144,164,171,0,,0,0.0,0.0,0.0,0.0,0.0
2024,4,11,4,2024-04-11,B6,999,SEA,IAD,"Seattle, WA",Washington,"Washington, DC",District of Columbia,552,835,14,10,566,845,22,4,588,841,1292,170,190,196,0,,0,0.0,0.0,0.0,0.0,0.0
2024,1,19,5,2024-01-19,UA,3577,DFW,LGA,"Dallas/Fort Worth, TX",Texas,"New York, NY",New York,1697,1425,-9,-15,1688,1410,9,4,1697,1406,210,19,39,32,0,,0,0.0,0.0,0.0,0.0,0.0
2024,3,22,5,2024-03-22,DL,1844,TPA,DCA,"Tampa, FL",Florida,"Washington, DC",District of Columbia,2202,2050,6,5,2208,2055,11,10,2219,2045,994,130,150,151,0,,0,0.0,0.0,0.0,0.0,0.0
2024,10,5,6,2024-10-05,G4,6196,BWI,LAX,"Baltimore, MD",Maryland,"Los Angeles, CA",California,1087,1609,12,10,1099,1619,10,11,1109,1608,643,70,90,91,0,,0,0.0,0.0,0.0,0.0,0.0
2024,12,4,3,2024-12-04,HA,2353,ORD,MSP,"Chicago, IL",Illinois,"Minneapolis, MN",Minnesota,1837,2140,48,45,1885,2185,9,4,1894,2181,2667,332,352,345,0,,0,8.0,9.0,1.0,1.0,26.0
2024,12,30,1,2024-12-30,AA,1733,HNL,MSP,"Honolulu, HI",Hawaii,"Minneapolis, MN",Minnesota,1225,1803,-10,-10,1215,1793,23,9,1238,1784,1846,221,241,253,0,,0,0.0,0.0,0.0,0.0,0.0
2024,11,26,2,2024-11-26,G4,7101,EWR,IAH,"Newark, NJ",New Jersey,"Houston, TX",Texas,2217,1508,-5,-5,2212,1503,13,19,2225,1484,1635,211,231,243,0,,0,0.0,0.0,0.0,0.0,0.0
2024,5,8,3,2024-05-08,AA,7120,PHL,MDW,"Philadelphia, PA",Pennsylvania,"Chicago, IL",Illinois,1913,995,15,20,1928,1015,28,17,1956,998,1545,183,203,228,0,,0,1.0,1.0,0.0,0.0,18.0
2024,12,9,1,2024-12-09,HA,9153,MIA,SLC,"Miami, FL",Florida,"Salt Lake City, UT",Utah,544,1576,-25,-15,519,1561,15,6,534,1555,1742,216,236,237,0,,0,0.0,0.0,0.0,0.0,0.0
2024,11,5,2,2024-11-05,OH,8249,IAD,TPA,"Washington, DC",District of Columbia,"Tampa, FL",Florida,1435,600,9,0,1444,600,7,15,1451,585,295,44,64,66,0,,0,0.0,0.0,0.0,0.0,0.0
2024,3,29,5,2024-03-29,NK,4801,SEA,IAH,"Seattle, WA",Washington,"Houston, TX",Texas,2186,607,-3,0,2183,607,11,5,2194,602,2189,273,293,289,0,,0,0.0,0.0,0.0,0.0,0.0
2024,7,31,3,2024-07-31,AS,6835,JFK,STL,"New York, NY",New York,"St. Louis, MO",Missouri,1640,743,-3,0,1637,743,7,14,1644,729,2774,354,374,375,0,,0,0.0,0.0,0.0,0.0,0.0
2024,5,22,3,2024-05-22,NK,1113,HNL,MDW,"Honolulu, HI",Hawaii,"Chicago, IL",Illinois,621,2278,2,-5,623,2273,10,5,633,2268,2590,314,334,329,0,,0,0.0,0.0,0.0,0.0,0.0
2024,3,5,2,2024-03-05,HA,3399,MCO,LAS,"Orlando, FL",Florida,"Las Vegas, NV",Nevada,981,874,17,15,998,889,23,11,1021,878,1823,217,237,251,0,,0,0.0,0.0,0.0,0.0,0.0
2024,3,16,6,2024-03-16,UA,1606,STL,PHX,"St. Louis, MO",Missouri,"Phoenix, AZ",Arizona,1693,2288,-7,-10,1686,2278,20,18,1706,2260,2555,321,341,359,0,,0,0.0,0.0,0.0,0.0,0.0
2024,7,17,3,2024-07-17,OH,4903,LAS,IAH,"Las Vegas, NV",Nevada,"Houston, TX",Texas,1177,886,4,0,1181,886,12,18,1193,868,2211,268,288,298,0,,0,0.0,0.0,0.0,0.0,0.0
2024,5,22,3,2024-05-22,UA,1077,PHX,IAD,"Phoenix, AZ",Arizona,"Washington, DC",District of Columbia,1923,1089,-7,0,1916,1089,23,14,1939,1075,735,87,107,124,0,,0,0.0,0.0,0.0,0.0,0.0
2024,11,11,1,2024-11-11,MQ,1917,IAD,LGA,"Washington, DC",District of Columbia,"New York, NY",New York,2184,2265,-2,-10,2182,2255,25,9,2207,2246,253,35,55,69,0,,0,0.0,0.0,0.0,0.0,0.0
2024,4,2,2,2024-04-02,OO,5001,SFO,DCA,"San Francisco, CA",California,"Washington, DC",District of Columbia,999,1232,-8,-10,991,1222,23,14,1014,1208,2940,376,396,413,0,,0,0.0,0.0,0.0,0.0,0.0
2024,10,31,4,2024-10-31,AA,9240,JFK,DCA,"New York, NY",New York,"Washington, DC",District of Columbia,573,2194,18,20,591,2214,20,13,611,2201,1791,216,236,249,0,,0,4.0,2.0,0.0,0.0,14.0
2024,8,11,7,2024-08-11,WN,6898,SFO,PDX,"San Francisco, CA",California,"Portland, OR",Oregon,1470,1328,5,0,1475,1328,12,14,1487,1314,2525,306,326,332,0,,0,0.0,0.0,0.0,0.0,0.0
2024,10,17,4,2024-10-17,YX,573,LAX,SAN,"Los Angeles, CA",California,"San Diego, CA",California,648,630,-2,0,646,630,14,19,660,611,1457,177,197,210,0,,0,0.0,0.0,0.0,0.0,0.0
2024,4,11,4,2024-04-11,DL,667,BWI,ATL,"Baltimore, MD",Maryland,"Atlanta, GA",Georgia,2060,1563,-4,5,2056,1568,13,17,2069,1551,397,41,61,71,0,,0,0.0,0.0,0.0,0.0,0.0
2024,9,23,1,2024-09-23,9E,8066,IAD,EWR,"Washington, DC",District of Columbia,"Newark, NJ",New Jersey,1391,2075,-16,-15,1375,2060,20,12,1395,2048,1654,197,217,229,0,,0,0.0,0.0,0.0,0.0,0.0
2024,12,20,5,2024-12-20,F9,2358,EWR,LAS,"Newark, NJ",New Jersey,"Las Vegas, NV",Nevada,1584,843,1,5,1585,848,26,6,1611,842,459,66,86,98,0,,0,0.0,0.0,0.0,0.0,0.0
2024,4,19,5,2024-04-19,UA,8220,ATL,ORD,"Atlanta, GA",Georgia,"Chicago, IL",Illinois,1577,739,-12,-10,1565,729,18,15,1583,714,2409,299,319,332,0,,0,0.0,0.0,0.0,0.0,0.0
2024,11,25,1,2024-11-25,NK,4410,SEA,CLT,"Seattle, WA",Washington,"Charlotte, NC",North Carolina,1746,1000,2,5,1748,1005,14,7,1762,998,378,53,73,74,0,,0,0.0,0.0,0.0,0.0,0.0
2024,9,21,6,2024-09-21,NK,2082,LGA,EWR,"New York, NY",New York,"Newark, NJ",New Jersey,2254,1324,-6,-15,2248,1309,8,6,2256,1303,2478,312,332,326,0,,0,0.0,0.0,0.0,0.0,0.0
2024,1,3,3,2024-01-03,YX,1196,CLT,DEN,"Charlotte, NC",North Carolina,"Denver, CO",Colorado,972,2164,18,10,990,2174,14,18,1004,2156,2018,255,275,287,0,,0,0.0,0.0,0.0,0.0,0.0
2024,3,25,1,2024-03-25,G4,6710,IAD,HNL,"Washington, DC",District of Columbia,"Honolulu, HI",Hawaii,1839,1581,-5,5,1834,1586,24,11,1858,1575,2998,373,393,408,0,,0,0.0,0.0,0.0,0.0,0.0
2024,10,8,2,2024-10-08,AS,3670,LAX,IAH,"Los Angeles, CA",California,"Houston, TX",Texas,669,763,-15,-5,654,758,25,9,679,749,2135,272,292,306,0,,0,0.0,0.0,0.0,0.0,0.0
2024,11,23,6,2024-11-23,AA,6597,BWI,PHX,"Baltimore, MD",Maryland,"Phoenix, AZ",Arizona,1200,703,4,-5,1204,698,19,12,1223,686,768,92,112,123,0,,0,0.0,0.0,0.0,0.0,0.0
2024,10,30,3,2024-10-30,F9,3746,PHX,LAS,"Phoenix, AZ",Arizona,"Las Vegas, NV",Nevada,531,662,-18,-15,513,647,23,17,536,630,652,75,95,115,0,,0,0.0,0.0,0.0,0.0,0.0
2024,4,26,5,2024-04-26,AA,2519,SEA,SLC,"Seattle, WA",Washington,"Salt Lake City, UT",Utah,552,614,8,15,560,629,15,11,575,618,258,36,56,62,0,,0,0.0,0.0,0.0,0.0,0.0
2024,8,8,4,2024-08-08,UA,4379,PHL,MIA,"Philadelphia, PA",Pennsylvania,"Miami, FL",Florida,1439,2117,-22,-15,1417,2102,24,13,1441,2089,1384,182,202,219,0,,0,0.0,0.0,0.0,0.0,0.0
2024,6,2,7,2024-06-02,OO,773,DFW,IAD,"Dallas/Fort Worth, TX",Texas,"Washington, DC",District of Columbia,638,778,4,0,642,778,18,14,660,764,884,115,135,147,0,,0,0.0,0.0,0.0,0.0,0.0
2024,6,1,6,2024-06-01,B6,2902,STL,MCO,"St. Louis, MO",Missouri,"Orlando, FL",Florida,1897,2146,-19,-10,1878,2136,19,4,1897,2132,1066,136,156,159,0,,0,0.0,0.0,0.0,0.0,0.0
2024,1,12,5,2024-01-12,F9,7412,TPA,SLC,"Tampa, FL",Florida,"Salt Lake City, UT",Utah,1570,1040,66,60,1636,1100,8,11,1644,1089,268,27,47,46,0,,0,14.0,9.0,9.0,1.0,27.0
2024,5,12,7,2024-05-12,G4,2469,SFO,TPA,"San Francisco, CA",California,"Tampa, FL",Florida,589,1124,-3,0,586,1124,21,19,607,1105,1397,166,186,206,0,,0,0.0,0.0,0.0,0.0,0.0
2024,10,30,3,2024-10-30,HA,4630,PHL,LAS,"Philadelphia, PA",Pennsylvania,"Las Vegas, NV",Nevada,1327,1326,-10,-15,1317,1311,5,5,1322,1306,2604,331,351,341,0,,0,0.0,0.0,0.0,0.0,0.0
2024,10,19,6,2024-10-19,NK,1166,DEN,CLT,"Denver, CO",Colorado,"Charlotte, NC",North Carolina,535,2111,0,5,535,2116,29,16,564,2100,1511,182,202,227,0,,0,0.0,0.0,0.0,0.0,0.0
2024,10,26,6,2024-10-26,G4,5532,DTW,IAD,"Detroit, MI",Michigan,"Washington, DC",District of Columbia,1515,910,35,45,1550,955,23,5,1573,950,1787,218,238,246,0,,0,11.0,1.0,7.0,1.0,25.0
2024,8,15,4,2024-08-15,OO,8173,DTW,PHX,"Detroit, MI",Michigan,"Phoenix, AZ",Arizona,1428,1337,-6,0,1422,1337,9,8,1431,1329,1084,140,160,157,0,,0,0.0,0.0,0.0,0.0,0.0
2024,9,27,5,2024-09-27,UA,787,SFO,BWI,"San Francisco, CA",California,"Baltimore, MD",Maryland,1748,2198,8,0,1756,2198,22,13,1778,2185,652,85,105,120,0,,0,0.0,0.0,0.0,0.0,0.0
2024,2,12,1,2024-02-12,MQ,168,BOS,SFO,"Boston, MA",Massachusetts,"San Francisco, CA",California,1053,729,-3,-10,1050,719,21,5,1071,714,1969,243,263,269,0,,0,0.0,0.0,0.0,0.0,0.0
2024,12,8,7,2024-12-08,B6,6874,LAS,ATL,"Las Vegas, NV",Nevada,"Atlanta, GA",Georgia,1239,1567,-23,-15,1216,1552,27,17,1243,1535,2173,270,290,314,0,,0,0.0,0.0,0.0,0.0,0.0
2024,11,21,4,2024-11-21,9E,519,DEN,TPA,"Denver, CO",Colorado,"Tampa, FL",Florida,768,2089,-19,-10,749,2079,14,10,763,2069,432,57,77,81,0,,0,0.0,0.0,0.0,0.0,0.0
2024,10,28,1,2024-10-28,F9,6991,DTW,MSP,"Detroit, MI",Michigan,"Minneapolis, MN",Minnesota,1409,2125,-9,0,1400,2125,13,4,1413,2121,310,37,57,54,0,,0,0.0,0.0,0.0,0.0,0.0
2024,12,29,7,2024-12-29,YX,5693,PHX,CLT,"Phoenix, AZ",Arizona,"Charlotte, NC",North Carolina,685,1886,-5,5,680,1891,8,13,688,1878,2733,349,369,370,0,,0,0.0,0.0,0.0,0.0,0.0
2024,1,21,7,2024-01-21,AA,6204,MIA,IAD,"Miami, FL",Florida,"Washington, DC",District of Columbia,1894,1794,2,10,1896,1804,24,16,1920,1788,925,118,138,158,0,,0,0.0,0.0,0.0,0.0,0.0
2024,4,16,2,2024-04-16,F9,3992,SEA,MSP,"Seattle, WA",Washington,"Minneapolis, MN",Minnesota,1368,1526,13,5,1381,1531,23,5,1404,1526,2317,296,316,324,0,,0,0.0,0.0,0.0,0.0,0.0
2024,12,1,7,2024-12-01,NK,539,BOS,BWI,"Boston, MA",Massachusetts,"Baltimore, MD",Maryland,1758,2029,-22,-15,1736,2014,7,12,1743,2002,702,94,114,113,0,,0,0.0,0.0,0.0,0.0,0.0
2024,10,29,2,2024-10-29,AA,9578,TPA,CLT,"Tampa, FL",Florida,"Charlotte, NC",North Carolina,1645,2325,-3,5,1642,2330,22,14,1664,2316,2877,352,372,388,0,,0,0.0,0.0,0.0,0.0,0.0
2024,4,26,5,2024-04-26,MQ,1308,SEA,DTW,"Seattle, WA",Washington,"Detroit, MI",Michigan,923,1648,-3,0,920,1648,7,11,927,1637,1279,151,171,169,0,,0,0.0,0.0,0.0,0.0,0.0
2024,5,3,5,2024-05-03,MQ,9370,MIA,SAN,"Miami, FL",Florida,"San Diego, CA",California,1332,1611,1,0,1333,1611,25,3,1358,1608,2569,327,347,355,0,,0,0.0,0.0,0.0,0.0,0.0
2024,10,7,1,2024-10-07,9E,2663,TPA,DFW,"Tampa, FL",Florida,"Dallas/Fort Worth, TX",Texas,1912,1048,-7,0,1905,1048,12,14,1917,1034,2128,258,278,284,1,,0,0.0,0.0,0.0,0.0,0.0
2024,10,18,5,2024-10-18,YX,7566,DTW,BWI,"Detroit, MI",Michigan,"Baltimore, MD",Maryland,1425,759,-17,-20,1408,739,28,4,1436,735,1573,192,212,224,0,,0,0.0,0.0,0.0,0.0,0.0
2024,7,21,7,2024-07-21,9E,1353,IAH,SFO,"Houston, TX",Texas,"San Francisco, CA",California,1640,1840,-16,-15,1624,1825,9,4,1633,1821,2220,272,292,285,0,,0,0.0,0.0,0.0,0.0,0.0
2024,2,20,2,2024-02-20,HA,3309,SEA,BOS,"Seattle, WA",Washington,"Boston, MA",Massachusetts,1989,1287,6,0,1995,1287,5,7,2000,1280,858,99,119,111,0,,0,0.0,0.0,0.0,0.0,0.0
2024,9,27,5,2024-09-27,YX,3649,STL,LAS,"St. Louis, MO",Missouri,"Las Vegas, NV",Nevada,1952,1447,-3,-10,1949,1437,22,3,1971,1434,1798,226,246,251,0,,0,0.0,0.0,0.0,0.0,0.0
2024,11,19,2,2024-11-19,AS,714,MCO,ORD,"Orlando, FL",Florida,"Chicago, IL",Illinois,1368,2356,-4,0,1364,2356,28,14,1392,2342,1552,201,221,243,0,,0,0.0,0.0,0.0,0.0,0.0
2024,10,3,4,2024-10-03,AA,3178,MIA,TPA,"Miami, FL",Florida,"Tampa, FL",Florida,1515,1089,-3,-5,1512,1084,18,7,1530,1077,2647,332,352,357,0,,0,0.0,0.0,0.0,0.0,0.0
2024,5,20,1,2024-05-20,DL,3590,DFW,BOS,"Dallas/Fort Worth, TX",Texas,"Boston, MA",Massachusetts,941,879,17,15,958,894,29,16,987,878,1697,213,233,258,1,,0,0.0,0.0,0.0,0.0,0.0
2024,10,1,2,2024-10-01,B6,3643,LAS,IAD,"Las Vegas, NV",Nevada,"Washington, DC",District of Columbia,538,680,6,15,544,695,11,10,555,685,2126,261,281,282,0,,0,0.0,0.0,0.0,0.0,0.0
2024,10,16,3,2024-10-16,DL,8202,STL,DCA,"St. Louis, MO",Missouri,"Washington, DC",District of Columbia,1407,1748,17,20,1424,1768,13,13,1437,1755,1737,224,244,250,0,,0,3.0,2.0,1.0,0.0,14.0
2024,11,29,5,2024-11-29,OH,2000,PHL,DTW,"Philadelphia, PA",Pennsylvania,"Detroit, MI",Michigan,1685,769,19,10,1704,779,29,12,1733,767,2589,331,351,372,0,,0,0.0,0.0,0.0,0.0,0.0
2024,2,21,3,2024-02-21,9E,5780,DFW,SFO,"Dallas/Fort Worth, TX",Texas,"San Francisco, CA",California,2144,2205,30,30,2174,2235,18,11,2192,2224,616,80,100,109,1,,0,8.0,3.0,4.0,0.0,15.0
2024,1,27,6,2024-01-27,AA,6851,PHL,TPA,"Philadelphia, PA",Pennsylvania,"Tampa, FL",Florida,2049,2213,-4,5,2045,2218,20,17,2065,2201,2946,369,389,406,0,,0,0.0,0.0,0.0,0.0,0.0
2024,6,5,3,2024-06-05,AS,5962,MSP,PDX,"Minneapolis, MN",Minnesota,"Portland, OR",Oregon,665,1713,21,20,686,1733,20,12,706,1721,1958,250,270,282,0,,0,0.0,5.0,2.0,0.0,13.0
2024,8,26,1,2024-08-26,F9,1812,CLT,ORD,"Charlotte, NC",North Carolina,"Chicago, IL",Illinois,1968,979,-6,0,1962,979,26,6,1988,973,2074,257,277,289,0,,0,0.0,0.0,0.0,0.0,0.0
2024,6,4,2,2024-06-04,F9,2429,DCA,LAX,"Washington, DC",District of Columbia,"Los Angeles, CA",California,942,1459,15,10,957,1469,10,13,967,1456,589,66,86,89,0,,0,0.0,0.0,0.0,0.0,0.0
2024,10,17,4,2024-10-17,MQ,1294,LAS,DEN,"Las Vegas, NV",Nevada,"Denver, CO",Colorado,830,710,-25,-15,805,695,11,19,816,676,2677,328,348,358,0,,0,0.0,0.0,0.0,0.0,0.0
2024,5,15,3,2024-05-15,MQ,6881,MDW,DFW,"Chicago, IL",Illinois,"Dallas/Fort Worth, TX",Texas,1492,763,6,5,1498,768,5,19,1503,749,1077,126,146,150,0,,0,0.0,0.0,0.0,0.0,0.0
2024,5,23,4,2024-05-23,F9,8262,IAD,TPA,"Washington, DC",District of Columbia,"Tampa, FL",Florida,1858,1014,9,15,1867,1029,15,3,1882,1026,723,86,106,104,0,,0,0.0,0.0,0.0,0.0,0.0
2024,4,15,1,2024-04-15,OO,5006,BWI,SFO,"Baltimore, MD",Maryland,"San Francisco, CA",California,1635,1239,-10,0,1625,1239,13,14,1638,1225,1569,201,221,228,0,,0,0.0,0.0,0.0,0.0,0.0
2024,6,6,4,2024-06-06,AS,1478,BOS,MIA,"Boston, MA",Massachusetts,"Miami, FL",Florida,2269,754,-18,-10,2251,744,5,17,2256,727,1338,176,196,198,0,,0,0.0,0.0,0.0,0.0,0.0
2024,5,25,6,2024-05-25,OO,9604,PHL,IAH,"Philadelphia, PA",Pennsylvania,"Houston, TX",Texas,1213,793,-7,0,1206,793,28,19,1234,774,248,24,44,71,0,,0,0.0,0.0,0.0,0.0,0.0
2024,1,2,2,2024-01-02,UA,849,PHL,IAD,"Philadelphia, PA",Pennsylvania,"Washington, DC",District of Columbia,1334,2099,3,5,1337,2104,22,5,1359,2099,1996,247,267,274,0,,0,0.0,0.0,0.0,0.0,0.0
2024,3,17,7,2024-03-17,AA,5392,CLT,MCO,"Charlotte, NC",North Carolina,"Orlando, FL",Florida,638,1284,11,5,649,1289,14,9,663,1280,580,64,84,87,0,,0,0.0,0.0,0.0,0.0,0.0
2024,5,11,6,2024-05-11,DL,400,SEA,DTW,"Seattle, WA",Washington,"Detroit, MI",Michigan,1689,1424,1,0,1690,1424,17,3,1707,1421,607,83,103,103,0,,0,0.0,0.0,0.0,0.0,0.0
2024,3,30,6,2024-03-30,B6,4795,JFK,DFW,"New York, NY",New York,"Dallas/Fort Worth, TX",Texas,1937,620,-2,-10,1935,610,27,13,1962,597,2101,264,284,304,0,,0,0.0,0.0,0.0,0.0,0.0
2024,12,10,2,2024-12-10,MQ,4724,PDX,CLT,"Portland, OR",Oregon,"Charlotte, NC",North Carolina,1692,1422,7,15,1699,1437,9,7,1708,1430,2154,276,296,292,0,,0,0.0,0.0,0.0,0.0,0.0
2024,12,15,7,2024-12-15,9E,3937,DCA,ATL,"Washington, DC",District of Columbia,"Atlanta, GA",Georgia,1268,1622,14,5,1282,1627,12,5,1294,1622,2380,288,308,305,1,,0,0.0,0.0,0.0,0.0,0.0
2024,9,19,4,2024-09-19,B6,377,DCA,MCO,"Washington, DC",District of Columbia,"Orlando, FL",Florida,623,708,-11,-10,612,698,17,11,629,687,1423,171,191,199,0,,0,0.0,0.0,0.0,0.0,0.0
2024,12,16,1,2024-12-16,9E,4017,MCO,DTW,"Orlando, FL",Florida,"Detroit, MI",Michigan,2073,998,19,10,2092,1008,20,10,2112,998,1469,186,206,216,0,,0,0.0,0.0,0.0,0.0,0.0
2024,4,17,3,2024-04-17,OH,7407,STL,MCO,"St. Louis, MO",Missouri,"Orlando, FL",Florida,1381,1529,-8,-5,1373,1524,11,4,1384,1520,2730,343,363,358,0,,0,0.0,0.0,0.0,0.0,0.0
2024,3,14,4,2024-03-14,AA,2261,MCO,STL,"Orlando, FL",Florida,"St. Louis, MO",Missouri,1260,1471,-13,-5,1247,1466,12,18,1259,1448,2440,304,324,334,0,,0,0.0,0.0,0.0,0.0,0.0
2024,2,8,4,2024-02-08,AA,1489,DEN,EWR,"Denver, CO",Colorado,"Newark, NJ",New Jersey,2272,728,10,10,2282,738,22,18,2304,720,2953,370,390,410,0,,0,0.0,0.0,0.0,0.0,0.0
2024,6,7,5,2024-06-07,HA,8982,LAX,ATL,"Los Angeles, CA",California,"Atlanta, GA",Georgia,1621,2132,14,10,1635,2142,13,6,1648,2136,718,84,104,103,0,,0,0.0,0.0,0.0,0.0,0.0
2024,3,11,1,2024-03-11,G4,4832,LAS,DTW,"Las Vegas, NV",Nevada,"Detroit, MI",Michigan,1583,879,4,-5,1587,874,26,12,1613,862,214,30,50,68,0,,0,0.0,0.0,0.0,0.0,0.0
2024,11,7,4,2024-11-07,DL,3568,SAN,IAH,"San Diego, CA",California,"Houston, TX",Texas,1542,1026,-19,-20,1523,1006,15,19,1538,987,789,88,108,122,0,,0,0.0,0.0,0.0,0.0,0.0
2024,8,28,3,2024-08-28,NK,6241,LAS,BOS,"Las Vegas, NV",Nevada,"Boston, MA",Massachusetts,1647,1650,-18,-10,1629,1640,26,17,1655,1623,356,36,56,79,0,,0,0.0,0.0,0.0,0.0,0.0
2024,10,24,4,2024-10-24,9E,6069,MIA,BOS,"Miami, FL",Florida,"Boston, MA",Massachusetts,725,1504,11,15,736,1519,26,4,762,1515,1849,227,247,257,0,,0,0.0,0.0,0.0,0.0,0.0
2024,2,5,1,2024-02-05,WN,3916,CLT,MIA,"Charlotte, NC",North Carolina,"Miami, FL",Florida,1111,943,0,10,1111,953,21,10,1132,943,2945,361,381,392,0,,0,0.0,0.0,0.0,0.0,0.0
2024,3,24,7,2024-03-24,NK,9231,MIA,ATL,"Miami, FL",Florida,"Atlanta, GA",Georgia,823,2024,-1,0,822,2024,18,12,840,2012,1550,188,208,218,0,,0,0.0,0.0,0.0,0.0,0.0
2024,9,19,4,2024-09-19,F9,5137,IAD,PHX,"Washington, DC",District of Columbia,"Phoenix, AZ",Arizona,1540,1203,1,-5,1541,1198,27,3,1568,1195,2001,254,274,284,0,,0,0.0,0.0,0.0,0.0,0.0
2024,11,5,2,2024-11-05,B6,6094,IAD,MCO,"Washington, DC",District of Columbia,"Orlando, FL",Florida,2283,1918,-10,-5,2273,1913,6,18,2279,1895,1696,212,232,236,0,,0,0.0,0.0,0.0,0.0,0.0
2024,6,20,4,2024-06-20,MQ,2551,JFK,BWI,"New York, NY",New York,"Baltimore, MD",Maryland,1603,2190,18,10,1621,2200,19,12,1640,2188,510,66,86,97,0,,0,0.0,0.0,0.0,0.0,0.0
2024,6,21,5,2024-06-21,YX,124,SEA,DCA,"Seattle, WA",Washington,"Washington, DC",District of Columbia,1096,795,-4,-5,1092,790,22,7,1114,783,1825,235,255,264,0,,0,0.0,0.0,0.0,0.0,0.0
2024,12,27,5,2024-12-27,YX,6062,MDW,MSP,"Chicago, IL",Illinois,"Minneapolis, MN",Minnesota,1979,1492,-9,0,1970,1492,9,11,1979,1481,2699,342,362,362,0,,0,0.0,0.0,0.0,0.0,0.0
2024,2,16,5,2024-02-16,AA,2656,MSP,BWI,"Minneapolis, MN",Minnesota,"Baltimore, MD",Maryland,1040,1332,6,5,1046,1337,26,12,1072,1325,2191,279,299,317,0,,0,0.0,0.0,0.0,0.0,0.0
2024,5,20,1,2024-05-20,WN,7732,TPA,MIA,"Tampa, FL",Florida,"Miami, FL",Florida,1145,755,-2,-10,1143,745,5,7,1148,738,1748,224,244,236,0,,0,0.0,0.0,0.0,0.0,0.0
2024,4,27,6,2024-04-27,9E,160,DEN,SLC,"Denver, CO",Colorado,"Salt Lake City, UT",Utah,1489,1039,-12,-10,1477,1029,20,9,1497,1020,364,51,71,80,0,,0,0.0,0.0,0.0,0.0,0.0
2024,10,3,4,2024-10-03,UA,7775,DTW,MIA,"Detroit, MI",Michigan,"Miami, FL",Florida,1205,700,-10,-5,1195,695,16,8,1211,687,1359,178,198,202,0,,0,0.0,0.0,0.0,0.0,0.0
2024,8,1,4,2024-08-01,9E,222,DTW,SFO,"Detroit, MI",Michigan,"San Francisco, CA",California,1130,1347,11,5,1141,1352,18,16,1159,1336,2499,303,323,337,0,,0,0.0,0.0,0.0,0.0,0.0
2024,8,7,3,2024-08-07,HA,5716,PHL,LAS,"Philadelphia, PA",Pennsylvania,"Las Vegas, NV",Nevada,1901,1099,1,10,1902,1109,21,15,1923,1094,2799,342,362,378,0,,0,0.0,0.0,0.0,0.0,0.0
2024,1,26,5,2024-01-26,YX,1286,DCA,PDX,"Washington, DC",District of Columbia,"Portland, OR",Oregon,1378,1908,-4,0,1374,1908,5,12,1379,1896,2084,260,280,277,0,,0,0.0,0.0,0.0,0.0,0.0
2024,1,9,2,2024-01-09,B6,5258,LAX,TPA,"Los Angeles, CA",California,"Tampa, FL",Florida,690,1692,-20,-15,670,1677,18,16,688,1661,1826,235,255,269,0,,0,0.0,0.0,0.0,0.0,0.0
2024,9,27,5,2024-09-27,9E,7964,EWR,SEA,"Newark, NJ",New Jersey,"Seattle, WA",Washington,2188,985,-2,-5,2186,980,19,10,2205,970,2384,300,320,329,0,,0,0.0,0.0,0.0,0.0,0.0
2024,1,10,3,2024-01-10,MQ,4189,DFW,PHL,"Dallas/Fort Worth, TX",Texas,"Philadelphia, PA",Pennsylvania,1354,2075,-9,-15,1345,2060,27,16,1372,2044,2884,368,388,411,0,,0,0.0,0.0,0.0,0.0,0.0
2024,4,30,2,2024-04-30,9E,2572,TPA,BWI,"Tampa, FL",Florida,"Baltimore, MD",Maryland,990,737,-8,-15,982,722,16,6,998,716,1938,243,263,265,0,,0,0.0,0.0,0.0,0.0,0.0
2024,5,4,6,2024-05-04,MQ,7550,DCA,IAD,"Washington, DC",District of Columbia,"Washington, DC",District of Columbia,904,847,-5,0,899,847,21,11,920,836,416,58,78,90,0,,0,0.0,0.0,0.0,0.0,0.0
2024,6,18,2,2024-06-18,AS,3064,DTW,LAX,"Detroit, MI",Michigan,"Los Angeles, CA",California,1795,702,21,20,1816,722,13,8,1829,714,1105,136,156,157,0,,0,1.0,1.0,1.0,0.0,17.0
2024,3,12,2,2024-03-12,DL,8204,MIA,ATL,"Miami, FL",Florida,"Atlanta, GA",Georgia,2167,2243,5,10,2172,2253,7,4,2179,2249,1044,130,150,141,0,,0,0.0,0.0,0.0,0.0,0.0
2024,5,31,5,2024-05-31,NK,1410,ATL,SEA,"Atlanta, GA",Georgia,"Seattle, WA",Washington,1374,2335,8,5,1382,2340,16,5,1398,2335,2992,369,389,390,0,,0,0.0,0.0,0.0,0.0,0.0
2024,7,26,5,2024-07-26,MQ,8446,PDX,BOS,"Portland, OR",Oregon,"Boston, MA",Massachusetts,929,1109,7,5,936,1114,17,13,953,1101,1199,151,171,181,0,,0,0.0,0.0,0.0,0.0,0.0
2024,2,18,7,2024-02-18,UA,2312,JFK,CLT,"New York, NY",New York,"Charlotte, NC",North Carolina,1019,1998,8,10,1027,2008,6,19,1033,1989,2744,343,363,368,0,,0,0.0,0.0,0.0,0.0,0.0
2024,6,2,7,2024-06-02,HA,9554,DTW,HNL,"Detroit, MI",Michigan,"Honolulu, HI",Hawaii,2169,1326,12,5,2181,1331,26,3,2207,1328,895,115,135,144,0,,0,0.0,0.0,0.0,0.0,0.0
2024,12,12,4,2024-12-12,AA,6892,MCO,MSP,"Orlando, FL",Florida,"Minneapolis, MN",Minnesota,1392,1778,-1,0,1391,1778,19,5,1410,1773,1397,174,194,198,0,,0,0.0,0.0,0.0,0.0,0.0
2024,10,19,6,2024-10-19,9E,9654,BWI,STL,"Baltimore, MD",Maryland,"St. Louis, MO",Missouri,1907,686,-6,-5,1901,681,6,16,1907,665,1625,196,216,218,0,,0,0.0,0.0,0.0,0.0,0.0
2024,3,8,5,2024-03-08,UA,9229,LAS,SFO,"Las Vegas, NV",Nevada,"San Francisco, CA",California,1320,1479,-12,-15,1308,1464,9,13,1317,1451,784,107,127,129,0,,0,0.0,0.0,0.0,0.0,0.0
2024,2,19,1,2024-02-19,G4,8803,LAX,MSP,"Los Angeles, CA",California,"Minneapolis, MN",Minnesota,1386,2105,-2,0,1384,2105,25,18,1409,2087,2077,258,278,301,0,,0,0.0,0.0,0.0,0.0,0.0
2024,5,31,5,2024-05-31,9E,8478,HNL,ORD,"Honolulu, HI",Hawaii,"Chicago, IL",Illinois,1715,1530,13,15,1728,1545,13,16,1741,1529,2364,294,314,323,0,,0,0.0,0.0,0.0,0.0,0.0
2024,1,19,5,2024-01-19,OO,1945,MSP,DCA,"Minneapolis, MN",Minnesota,"Washington, DC",District of Columbia,2126,1832,-2,0,2124,1832,18,11,2142,1821,1538,189,209,218,0,,0,0.0,0.0,0.0,0.0,0.0
2024,4,9,2,2024-04-09,OO,7760,LAS,SFO,"Las Vegas, NV",Nevada,"San Francisco, CA",California,934,1606,-18,-10,916,1596,17,4,933,1592,516,54,74,75,0,,0,0.0,0.0,0.0,0.0,0.0
2024,2,29,4,2024-02-29,HA,1802,EWR,SEA,"Newark, NJ",New Jersey,"Seattle, WA",Washington,2284,1801,-2,0,2282,1801,8,12,2290,1789,2742,335,355,355,0,,0,0.0,0.0,0.0,0.0,0.0
2024,6,15,6,2024-06-15,AS,490,EWR,SAN,"Newark, NJ",New Jersey,"San Diego, CA",California,2287,2209,2,0,2289,2209,12,5,2301,2204,2743,335,355,352,0,,0,0.0,0.0,0.0,0.0,0.0
2024,7,20,6,2024-07-20,OO,754,BOS,IAD,"Boston, MA",Massachusetts,"Washington, DC",District of Columbia,562,1613,14,15,576,1628,27,17,603,1611,1659,204,224,248,0,,0,0.0,0.0,0.0,0.0,0.0
2024,12,10,2,2024-12-10,AS,5935,DCA,DEN,"Washington, DC",District of Columbia,"Denver, CO",Colorado,1739,857,-18,-10,1721,847,11,14,1732,833,2512,319,339,344,0,,0,0.0,0.0,0.0,0.0,0.0
2024,5,25,6,2024-05-25,WN,4371,DTW,STL,"Detroit, MI",Michigan,"St. Louis, MO",Missouri,633,872,14,5,647,877,21,11,668,866,2054,259,279,291,1,,0,0.0,0.0,0.0,0.0,0.0
2024,6,12,3,2024-06-12,HA,9055,DTW,SEA,"Detroit, MI",Michigan,"Seattle, WA",Washington,1457,1462,-2,5,1455,1467,26,16,1481,1451,1159,135,155,177,0,,0,0.0,0.0,0.0,0.0,0.0
2024,8,29,4,2024-08-29,F9,3500,TPA,BOS,"Tampa, FL",Florida,"Boston, MA",Massachusetts,1118,1447,33,30,1151,1477,10,17,1161,1460,2261,273,293,300,0,,0,3.0,7.0,4.0,0.0,16.0
2024,3,9,6,2024-03-09,B6,5419,LGA,EWR,"New York, NY",New York,"Newark, NJ",New Jersey,1684,1647,2,0,1686,1647,12,13,1698,1634,2579,316,336,341,0,,0,0.0,0.0,0.0,0.0,0.0
2024,6,23,7,2024-06-23,NK,6832,CLT,ORD,"Charlotte, NC",North Carolina,"Chicago, IL",Illinois,1781,1424,19,10,1800,1434,26,13,1826,1421,2479,301,321,340,0,,0,0.0,0.0,0.0,0.0,0.0
2024,2,18,7,2024-02-18,G4,6774,ORD,PHL,"Chicago, IL",Illinois,"Philadelphia, PA",Pennsylvania,924,2206,-24,-20,900,2186,12,5,912,2181,1530,189,209,206,0,,0,0.0,0.0,0.0,0.0,0.0
2024,4,17,3,2024-04-17,MQ,1185,SFO,DTW,"San Francisco, CA",California,"Detroit, MI",Michigan,2051,1194,-19,-15,2032,1179,17,13,2049,1166,639,74,94,104,0,,0,0.0,0.0,0.0,0.0,0.0
2024,8,13,2,2024-08-13,MQ,5546,DCA,SFO,"Washington, DC",District of Columbia,"San Francisco, CA",California,857,999,-10,-5,847,994,26,3,873,991,2489,314,334,343,0,,0,0.0,0.0,0.0,0.0,0.0
2024,6,9,7,2024-06-09,OH,4476,DFW,SLC,"Dallas/Fort Worth, TX",Texas,"Salt Lake City, UT",Utah,1898,952,-3,0,1895,952,12,6,1907,946,2872,367,387,385,0,,0,0.0,0.0,0.0,0.0,0.0
2024,4,28,7,2024-04-28,B6,2063,LAS,ORD,"Las Vegas, NV",Nevada,"Chicago, IL",Illinois,2094,1403,-10,-5,2084,1398,9,12,2093,1386,2283,283,303,304,0,,0,0.0,0.0,0.0,0.0,0.0
2024,5,28,2,2024-05-28,OO,5277,MDW,DTW,"Chicago, IL",Illinois,"Detroit, MI",Michigan,1532,1924,-17,-10,1515,1914,13,3,1528,1911,1541,188,208,204,0,,0,0.0,0.0,0.0,0.0,0.0
2024,5,29,3,2024-05-29,OH,4672,PDX,MSP,"Portland, OR",Oregon,"Minneapolis, MN",Minnesota,1510,609,-6,0,1504,609,24,5,1528,604,1957,247,267,276,0,,0,0.0,0.0,0.0,0.0,0.0
2024,10,19,6,2024-10-19,B6,7643,MIA,DEN,"Miami, FL",Florida,"Denver, CO",Colorado,696,1666,7,0,703,1666,26,5,729,1661,2115,260,280,291,0,,0,0.0,0.0,0.0,0.0,0.0
2024,5,22,3,2024-05-22,OH,9007,DTW,MIA,"Detroit, MI",Michigan,"Miami, FL",Florida,1640,1674,-9,0,1631,1674,6,15,1637,1659,2814,350,370,371,0,,0,0.0,0.0,0.0,0.0,0.0
2024,6,8,6,2024-06-08,WN,342,BOS,EWR,"Boston, MA",Massachusetts,"Newark, NJ",New Jersey,1533,1318,-12,-15,1521,1303,7,5,1528,1298,578,63,83,75,0,,0,0.0,0.0,0.0,0.0,0.0
2024,1,11,4,2024-01-11,AS,6610,LGA,PHX,"New York, NY",New York,"Phoenix, AZ",Arizona,1361,706,18,15,1379,721,8,10,1387,711,2883,355,375,373,0,,0,0.0,0.0,0.0,0.0,0.0
2024,5,17,5,2024-05-17,DL,4015,STL,DTW,"St. Louis, MO",Missouri,"Detroit, MI",Michigan,1018,1370,-6,0,1012,1370,23,16,1035,1354,1708,207,227,246,0,,0,0.0,0.0,0.0,0.0,0.0
2024,3,18,1,2024-03-18,UA,9815,MIA,ATL,"Miami, FL",Florida,"Atlanta, GA",Georgia,848,2329,-10,-10,838,2319,11,3,849,2316,1032,124,144,138,0,,0,0.0,0.0,0.0,0.0,0.0
2024,3,17,7,2024-03-17,AA,937,BOS,MCO,"Boston, MA",Massachusetts,"Orlando, FL",Florida,2229,1858,14,5,2243,1863,13,3,2256,1860,465,62,82,78,0,,0,0.0,0.0,0.0,0.0,0.0
2024,9,10,2,2024-09-10,DL,3423,BOS,SLC,"Boston, MA",Massachusetts,"Salt Lake City, UT",Utah,1927,1089,-13,-5,1914,1084,10,10,1924,1074,1117,140,160,160,0,,0,0.0,0.0,0.0,0.0,0.0
2024,9,14,6,2024-09-14,DL,3053,PHX,LGA,"Phoenix, AZ",Arizona,"New York, NY",New York,2158,1274,5,0,2163,1274,7,14,2170,1260,2596,325,345,346,0,,0,0.0,0.0,0.0,0.0,0.0
2024,11,15,5,2024-11-15,F9,9637,BOS,MIA,"Boston, MA",Massachusetts,"Miami, FL",Florida,1074,1074,4,-5,1078,1069,18,10,1096,1059,1730,208,228,236,0,,0,0.0,0.0,0.0,0.0,0.0
2024,10,17,4,2024-10-17,F9,1532,STL,SFO,"St. Louis, MO",Missouri,"San Francisco, CA",California,1527,1180,7,10,1534,1190,17,13,1551,1177,1574,194,214,224,0,,0,0.0,0.0,0.0,0.0,0.0
2024,9,19,4,2024-09-19,DL,6954,MCO,ORD,"Orlando, FL",Florida,"Chicago, IL",Illinois,827,1446,54,45,881,1491,17,16,898,1475,364,50,70,83,0,,0,1.0,10.0,3.0,1.0,30.0
2024,3,25,1,2024-03-25,MQ,7755,LAX,PHL,"Los Angeles, CA",California,"Philadelphia, PA",Pennsylvania,2285,1915,-6,-10,2279,1905,29,14,2308,1891,2408,297,317,340,0,,0,0.0,0.0,0.0,0.0,0.0
2024,5,25,6,2024-05-25,OH,8531,LGA,MIA,"New York, NY",New York,"Miami, FL",Florida,1011,2104,-17,-20,994,2084,5,10,999,2074,2257,284,304,299,0,,0,0.0,0.0,0.0,0.0,0.0
2024,11,18,1,2024-11-18,AS,8430,IAD,ORD,"Washington, DC",District of Columbia,"Chicago, IL",Illinois,1430,1059,-7,-10,1423,1049,19,3,1442,1046,1671,217,237,239,0,,0,0.0,0.0,0.0,0.0,0.0
2024,2,11,7,2024-02-11,HA,8711,STL,DEN,"St. Louis, MO",Missouri,"Denver, CO",Colorado,629,1024,-3,0,626,1024,9,12,635,1012,385,56,76,77,0,,0,0.0,0.0,0.0,0.0,0.0
2024,5,4,6,2024-05-04,B6,403,HNL,TPA,"Honolulu, HI",Hawaii,"Tampa, FL",Florida,1086,928,-20,-10,1066,918,25,7,1091,911,2950,372,392,404,0,,0,0.0,0.0,0.0,0.0,0.0
2024,6,15,6,2024-06-15,UA,2262,PDX,EWR,"Portland, OR",Oregon,"Newark, NJ",New Jersey,983,1808,15,10,998,1818,6,16,1004,1802,1386,181,201,203,1,,0,0.0,0.0,0.0,0.0,0.0
2024,8,28,3,2024-08-28,B6,6586,LAX,LAS,"Los Angeles, CA",California,"Las Vegas, NV",Nevada,857,1366,-4,-5,853,1361,9,10,862,1351,2114,262,282,281,0,,0,0.0,0.0,0.0,0.0,0.0
2024,10,6,7,2024-10-06,B6,4202,SLC,LAS,"Salt Lake City, UT",Utah,"Las Vegas, NV",Nevada,884,1105,3,0,887,1105,21,14,908,1091,1728,222,242,257,0,,0,0.0,0.0,0.0,0.0,0.0
2024,7,6,6,2024-07-06,B6,6974,EWR,DCA,"Newark, NJ",New Jersey,"Washington, DC",District of Columbia,753,1227,-2,0,751,1227,5,6,756,1221,2403,298,318,309,0,,0,0.0,0.0,0.0,0.0,0.0
2024,10,28,1,2024-10-28,UA,1268,JFK,PHL,"New York, NY",New York,"Philadelphia, PA",Pennsylvania,1334,1077,18,15,1352,1092,8,17,1360,1075,2737,332,352,357,0,,0,0.0,0.0,0.0,0.0,0.0
2024,1,19,5,2024-01-19,HA,515,BWI,TPA,"Baltimore, MD",Maryland,"Tampa, FL",Florida,1690,613,-18,-20,1672,593,19,8,1691,585,336,51,71,78,0,,0,0.0,0.0,0.0,0.0,0.0
2024,3,8,5,2024-03-08,UA,5343,DTW,DFW,"Detroit, MI",Michigan,"Dallas/Fort Worth, TX",Texas,2236,1489,13,5,2249,1494,19,13,2268,1481,1200,147,167,179,0,,0,0.0,0.0,0.0,0.0,0.0
2024,8,5,1,2024-08-05,WN,249,BOS,DEN,"Boston, MA",Massachusetts,"Denver, CO",Colorado,2203,1326,10,5,2213,1331,26,15,2239,1316,884,116,136,157,0,,0,0.0,0.0,0.0,0.0,0.0
2024,4,11,4,2024-04-11,NK,6624,SFO,STL,"San Francisco, CA",California,"St. Louis, MO",Missouri,1295,1716,8,0,1303,1716,20,4,1323,1712,2658,325,345,349,0,,0,0.0,0.0,0.0,0.0,0.0
2024,2,11,7,2024-02-11,YX,5999,STL,PHL,"St. Louis, MO",Missouri,"Philadelphia, PA",Pennsylvania,968,1610,1,-5,969,1605,17,11,986,1594,1648,197,217,225,0,,0,0.0,0.0,0.0,0.0,0.0
2024,10,14,1,2024-10-14,YX,938,MSP,PHL,"Minneapolis, MN",Minnesota,"Philadelphia, PA",Pennsylvania,992,1345,-26,-20,966,1325,18,11,984,1314,2369,286,306,315,0,,0,0.0,0.0,0.0,0.0,0.0
2024,6,15,6,2024-06-15,YX,6244,DEN,DFW,"Denver, CO",Colorado,"Dallas/Fort Worth, TX",Texas,1419,779,-3,5,1416,784,6,4,1422,780,1230,162,182,172,0,,0,0.0,0.0,0.0,0.0,0.0
2024,4,18,4,2024-04-18,OH,9988,DTW,ATL,"Detroit, MI",Michigan,"Atlanta, GA",Georgia,1861,1165,0,10,1861,1175,25,5,1886,1170,989,131,151,161,0,,0,0.0,0.0,0.0,0.0,0.0
2024,2,5,1,2024-02-05,DL,9713,BWI,LGA,"Baltimore, MD",Maryland,"New York, NY",New York,550,904,-19,-15,531,889,14,12,545,877,2826,356,376,382,0,,0,0.0,0.0,0.0,0.0,0.0
2024,8,19,1,2024-08-19,9E,7566,SFO,PDX,"San Francisco, CA",California,"Portland, OR",Oregon,1579,1074,-9,-5,1570,1069,9,3,1579,1066,2323,280,300,292,0,,0,0.0,0.0,0.0,0.0,0.0
2024,8,16,5,2024-08-16,WN,1420,JFK,SLC,"New York, NY",New York,"Salt Lake City, UT",Utah,572,2165,-4,-10,568,2155,7,17,575,2138,660,85,105,109,0,,0,0.0,0.0,0.0,0.0,0.0
2024,12,18,3,2024-12-18,WN,1623,PHX,SFO,"Phoenix, AZ",Arizona,"San Francisco, CA",California,1099,1498,-4,0,1095,1498,24,15,1119,1483,1565,188,208,227,0,,0,0.0,0.0,0.0,0.0,0.0
2024,6,12,3,2024-06-12,AA,5334,SLC,SFO,"Salt Lake City, UT",Utah,"San Francisco, CA",California,551,1123,7,5,558,1128,15,17,573,1111,2417,311,331,343,0,,0,0.0,0.0,0.0,0.0,0.0
2024,3,13,3,2024-03-13,9E,6244,IAH,DCA,"Houston, TX",Texas,"Washington, DC",District of Columbia,624,1734,7,5,631,1739,17,6,648,1733,2477,301,321,324,0,,0,0.0,0.0,0.0,0.0,0.0
2024,5,15,3,2024-05-15,F9,652,MCO,STL,"Orlando, FL",Florida,"St. Louis, MO",Missouri,761,2038,-6,-5,755,2033,6,5,761,2028,1251,163,183,174,0,,0,0.0,0.0,0.0,0.0,0.0
2024,12,18,3,2024-12-18,AA,3856,IAD,MSP,"Washington, DC",District of Columbia,"Minneapolis, MN",Minnesota,1454,1020,-6,-15,1448,1005,11,15,1459,990,769,105,125,131,0,,0,0.0,0.0,0.0,0.0,0.0
2024,3,10,7,2024-03-10,F9,3771,ATL,HNL,"Atlanta, GA",Georgia,"Honolulu, HI",Hawaii,2098,1010,-4,5,2094,1015,7,9,2101,1006,972,117,137,133,0,,0,0.0,0.0,0.0,0.0,0.0
2024,7,14,7,2024-07-14,NK,581,EWR,DEN,"Newark, NJ",New Jersey,"Denver, CO",Colorado,2071,2247,-10,-5,2061,2242,17,14,2078,2228,2853,346,366,377,0,,0,0.0,0.0,0.0,0.0,0.0
2024,9,25,3,2024-09-25,G4,699,DFW,JFK,"Dallas/Fort Worth, TX",Texas,"New York, NY",New York,2044,1280,-24,-20,2020,1260,10,4,2030,1256,1406,180,200,194,0,,0,0.0,0.0,0.0,0.0,0.0
2024,2,18,7,2024-02-18,F9,7777,PHX,MIA,"Phoenix, AZ",Arizona,"Miami, FL",Florida,829,1215,2,0,831,1215,13,18,844,1197,679,86,106,117,0,,0,0.0,0.0,0.0,0.0,0.0
2024,11,11,1,2024-11-11,B6,9456,DTW,HNL,"Detroit, MI",Michigan,"Honolulu, HI",Hawaii,1846,1122,-13,-10,1833,1112,27,10,1860,1102,1027,120,140,157,0,,0,0.0,0.0,0.0,0.0,0.0
2024,5,9,4,2024-05-09,F9,9295,IAH,LAS,"Houston, TX",Texas,"Las Vegas, NV",Nevada,740,928,12,10,752,938,24,14,776,924,244,31,51,69,0,,0,0.0,0.0,0.0,0.0,0.0
2024,1,5,5,2024-01-05,OH,2082,HNL,EWR,"Honolulu, HI",Hawaii,"Newark, NJ",New Jersey,1808,871,-15,-15,1793,856,6,4,1799,852,1179,140,160,150,0,,0,0.0,0.0,0.0,0.0,0.0
2024,1,27,6,2024-01-27,HA,1734,PHX,SAN,"Phoenix, AZ",Arizona,"San Diego, CA",California,2125,613,-6,-5,2119,608,16,18,2135,590,2112,272,292,306,0,,0,0.0,0.0,0.0,0.0,0.0
2024,6,8,6,2024-06-08,OO,7930,MSP,EWR,"Minneapolis, MN",Minnesota,"Newark, NJ",New Jersey,1787,774,-17,-10,1770,764,19,17,1789,747,1115,142,162,178,0,,0,0.0,0.0,0.0,0.0,0.0
2024,5,28,2,2024-05-28,9E,3097,ATL,DCA,"Atlanta, GA",Georgia,"Washington, DC",District of Columbia,1822,757,4,5,1826,762,27,11,1853,751,2096,258,278,296,0,,0,0.0,0.0,0.0,0.0,0.0
2024,9,20,5,2024-09-20,YX,786,CLT,BOS,"Charlotte, NC",North Carolina,"Boston, MA",Massachusetts,1728,1221,6,0,1734,1221,28,17,1762,1204,705,81,101,126,0,,0,0.0,0.0,0.0,0.0,0.0
2024,8,17,6,2024-08-17,HA,5629,JFK,PHX,"New York, NY",New York,"Phoenix, AZ",Arizona,790,2287,2,5,792,2292,20,5,812,2287,848,107,127,132,0,,0,0.0,0.0,0.0,0.0,0.0
2024,7,18,4,2024-07-18,YX,1859,SLC,MSP,"Salt Lake City, UT",Utah,"Minneapolis, MN",Minnesota,710,833,9,0,719,833,7,13,726,820,2382,293,313,313,0,,0,0.0,0.0,0.0,0.0,0.0
2024,2,19,1,2024-02-19,UA,7123,SAN,MCO,"San Diego, CA",California,"Orlando, FL",Florida,1889,740,-26,-20,1863,720,18,17,1881,703,2600,328,348,363,0,,0,0.0,0.0,0.0,0.0,0.0
2024,3,7,4,2024-03-07,HA,6308,SFO,PHL,"San Francisco, CA",California,"Philadelphia, PA",Pennsylvania,1987,2104,-1,-10,1986,2094,27,3,2013,2091,1273,163,183,193,0,,0,0.0,0.0,0.0,0.0,0.0
2024,10,26,6,2024-10-26,9E,7334,IAD,MSP,"Washington, DC",District of Columbia,"Minneapolis, MN",Minnesota,1218,718,124,120,1342,838,5,9,1347,829,1843,225,245,239,0,,0,15.0,15.0,10.0,3.0,77.0
2024,2,27,2,2024-02-27,NK,2580,LAX,SLC,"Los Angeles, CA",California,"Salt Lake City, UT",Utah,821,981,-6,-5,815,976,20,6,835,970,2998,380,400,406,0,,0,0.0,0.0,0.0,0.0,0.0
2024,9,15,7,2024-09-15,YX,9629,DTW,SLC,"Detroit, MI",Michigan,"Salt Lake City, UT",Utah,857,2144,8,0,865,2144,28,3,893,2141,554,75,95,106,0,,0,0.0,0.0,0.0,0.0,0.0
2024,12,7,6,2024-12-07,WN,7576,SFO,SEA,"San Francisco, CA",California,"Seattle, WA",Washington,1416,1288,22,15,1438,1303,27,13,1465,1290,2538,318,338,358,0,,0,0.0,0.0,0.0,0.0,0.0
2024,11,21,4,2024-11-21,B6,7870,SAN,MSP,"San Diego, CA",California,"Minneapolis, MN",Minnesota,593,2033,-19,-20,574,2013,10,14,584,1999,2438,297,317,321,0,,0,0.0,0.0,0.0,0.0,0.0
2024,5,9,4,2024-05-09,G4,214,JFK,LAX,"New York, NY",New York,"Los Angeles, CA",California,1210,648,-4,5,1206,653,19,10,1225,643,2778,343,363,372,0,,0,0.0,0.0,0.0,0.0,0.0
2024,8,2,5,2024-08-02,NK,668,DEN,MDW,"Denver, CO",Colorado,"Chicago, IL",Illinois,668,1993,-14,-10,654,1983,19,15,673,1968,2562,313,333,347,0,,0,0.0,0.0,0.0,0.0,0.0
2024,6,20,4,2024-06-20,WN,9845,BWI,MIA,"Baltimore, MD",Maryland,"Miami, FL",Florida,1820,1956,-10,-10,1810,1946,7,7,1817,1939,2952,365,385,379,0,,0,0.0,0.0,0.0,0.0,0.0
2024,9,14,6,2024-09-14,AS,8051,DCA,ATL,"Washington, DC",District of Columbia,"Atlanta, GA",Georgia,2262,748,-6,-10,2256,738,8,3,2264,735,2759,339,359,350,0,,0,0.0,0.0,0.0,0.0,0.0
2024,4,11,4,2024-04-11,9E,2789,ORD,MIA,"Chicago, IL",Illinois,"Miami, FL",Florida,1015,756,11,10,1026,766,28,4,1054,762,2264,276,296,308,0,,0,0.0,0.0,0.0,0.0,0.0
2024,7,27,6,2024-07-27,OH,4690,LAS,SEA,"Las Vegas, NV",Nevada,"Seattle, WA",Washington,597,1203,-6,-5,591,1198,21,11,612,1187,2461,306,326,338,0,,0,0.0,0.0,0.0,0.0,0.0
2024,10,17,4,2024-10-17,OO,3440,LAS,MSP,"Las Vegas, NV",Nevada,"Minneapolis, MN",Minnesota,2228,751,-13,-15,2215,736,17,15,2232,721,1491,176,196,208,0,,0,0.0,0.0,0.0,0.0,0.0
2024,12,19,4,2024-12-19,NK,3088,LAS,TPA,"Las Vegas, NV",Nevada,"Tampa, FL",Florida,849,2084,-24,-15,825,2069,6,15,831,2054,1113,129,149,150,0,,0,0.0,0.0,0.0,0.0,0.0
2024,10,12,6,2024-10-12,MQ,3251,EWR,PDX,"Newark, NJ",New Jersey,"Portland, OR",Oregon,1235,975,-11,-15,1224,960,5,17,1229,943,2185,269,289,291,0,,0,0.0,0.0,0.0,0.0,0.0
2024,4,25,4,2024-04-25,9E,3115,LGA,DFW,"New York, NY",New York,"Dallas/Fort Worth, TX",Texas,1078,1281,7,10,1085,1291,24,11,1109,1280,607,68,88,103,0,,0,0.0,0.0,0.0,0.0,0.0
2024,9,20,5,2024-09-20,MQ,9113,SLC,MDW,"Salt Lake City, UT",Utah,"Chicago, IL",Illinois,2173,1195,-10,-5,2163,1190,10,17,2173,1173,430,58,78,85,0,,0,0.0,0.0,0.0,0.0,0.0
2024,5,29,3,2024-05-29,G4,6445,PDX,BOS,"Portland, OR",Oregon,"Boston, MA",Massachusetts,1340,2048,8,15,1348,2063,9,9,1357,2054,286,42,62,60,0,,0,0.0,0.0,0.0,0.0,0.0
2024,10,26,6,2024-10-26,WN,3674,PHX,SEA,"Phoenix, AZ",Arizona,"Seattle, WA",Washington,900,1671,7,10,907,1681,10,13,917,1668,708,91,111,114,0,,0,0.0,0.0,0.0,0.0,0.0
2024,2,5,1,2024-02-05,9E,7938,BWI,MCO,"Baltimore, MD",Maryland,"Orlando, FL",Florida,1250,1958,19,10,1269,1968,22,7,1291,1961,988,125,145,154,0,,0,0.0,0.0,0.0,0.0,0.0
2024,11,28,4,2024-11-28,UA,1708,DTW,ORD,"Detroit, MI",Michigan,"Chicago, IL",Illinois,1974,2352,-16,-10,1958,2342,25,11,1983,2331,2274,288,308,324,1,,0,0.0,0.0,0.0,0.0,0.0
2024,10,13,7,2024-10-13,F9,659,MDW,SEA,"Chicago, IL",Illinois,"Seattle, WA",Washington,1998,1188,-1,-10,1997,1178,5,16,2002,1162,1413,166,186,187,0,,0,0.0,0.0,0.0,0.0,0.0
2024,10,29,2,2024-10-29,HA,6721,JFK,PHL,"New York, NY",New York,"Philadelphia, PA",Pennsylvania,1320,1622,-3,0,1317,1622,17,17,1334,1605,1543,191,211,225,0,,0,0.0,0.0,0.0,0.0,0.0
2024,11,6,3,2024-11-06,AA,7226,MDW,MSP,"Chicago, IL",Illinois,"Minneapolis, MN",Minnesota,1942,2178,-2,-5,1940,2173,10,18,1950,2155,2847,362,382,390,0,,0,0.0,0.0,0.0,0.0,0.0
2024,7,26,5,2024-07-26,G4,5665,IAD,MDW,"Washington, DC",District of Columbia,"Chicago, IL",Illinois,1527,1375,6,0,1533,1375,24,17,1557,1358,866,102,122,143,0,,0,0.0,0.0,0.0,0.0,0.0
2024,4,15,1,2024-04-15,MQ,4535,ATL,DTW,"Atlanta, GA",Georgia,"Detroit, MI",Michigan,1847,2092,-6,-15,1841,2077,16,17,1857,2060,322,36,56,69,0,,0,0.0,0.0,0.0,0.0,0.0
2024,6,6,4,2024-06-06,AA,5750,TPA,PHL,"Tampa, FL",Florida,"Philadelphia, PA",Pennsylvania,868,2198,11,20,879,2218,14,6,893,2212,647,71,91,91,0,,0,5.0,3.0,1.0,0.0,11.0
2024,4,30,2,2024-04-30,DL,8903,DCA,ATL,"Washington, DC",District of Columbia,"Atlanta, GA",Georgia,2137,1868,-7,-15,2130,1853,29,7,2159,1846,2850,354,374,390,0,,0,0.0,0.0,0.0,0.0,0.0
2024,2,24,6,2024-02-24,MQ,1981,EWR,DTW,"Newark, NJ",New Jersey,"Detroit, MI",Michigan,1918,1231,-17,-10,1901,1221,23,4,1924,1217,261,26,46,53,0,,0,0.0,0.0,0.0,0.0,0.0
2024,1,12,5,2024-01-12,F9,4269,SAN,PHX,"San Diego, CA",California,"Phoenix, AZ",Arizona,1055,861,8,5,1063,866,7,3,1070,863,2678,341,361,351,0,,0,0.0,0.0,0.0,0.0,0.0
2024,5,24,5,2024-05-24,G4,3963,LGA,SFO,"New York, NY",New York,"San Francisco, CA",California,1642,1441,-14,-10,1628,1431,19,11,1647,1420,2473,310,330,340,0,,0,0.0,0.0,0.0,0.0,0.0
2024,5,15,3,2024-05-15,NK,7536,MSP,SAN,"Minneapolis, MN",Minnesota,"San Diego, CA",California,2223,1873,-10,-15,2213,1858,29,10,2242,1848,496,55,75,94,0,,0,0.0,0.0,0.0,0.0,0.0
2024,1,3,3,2024-01-03,UA,3808,CLT,SAN,"Charlotte, NC",North Carolina,"San Diego, CA",California,2266,2120,-11,-10,2255,2110,18,14,2273,2096,417,57,77,89,0,,0,0.0,0.0,0.0,0.0,0.0
2024,5,23,4,2024-05-23,NK,1809,EWR,MIA,"Newark, NJ",New Jersey,"Miami, FL",Florida,1504,1675,-15,-15,1489,1660,8,5,1497,1655,278,34,54,47,0,,0,0.0,0.0,0.0,0.0,0.0
2024,1,30,2,2024-01-30,AS,7960,CLT,ATL,"Charlotte, NC",North Carolina,"Atlanta, GA",Georgia,1465,1088,-16,-10,1449,1078,11,10,1460,1068,735,99,119,120,0,,0,0.0,0.0,0.0,0.0,0.0
2024,8,24,6,2024-08-24,DL,1792,HNL,BWI,"Honolulu, HI",Hawaii,"Baltimore, MD",Maryland,1514,1765,-9,-10,1505,1755,14,11,1519,1744,602,65,85,90,0,,0,0.0,0.0,0.0,0.0,0.0
2024,10,5,6,2024-10-05,UA,9537,HNL,DTW,"Honolulu, HI",Hawaii,"Detroit, MI",Michigan,1713,1995,4,0,1717,1995,18,6,1735,1989,1934,243,263,267,0,,0,0.0,0.0,0.0,0.0,0.0
2024,12,13,5,2024-12-13,OO,225,SFO,IAD,"San Francisco, CA",California,"Washington, DC",District of Columbia,2145,850,-6,-5,2139,845,6,18,2145,827,1719,208,228,232,0,,0,0.0,0.0,0.0,0.0,0.0
2024,4,24,3,2024-04-24,MQ,1299,MCO,BWI,"Orlando, FL",Florida,"Baltimore, MD",Maryland,1939,913,-9,0,1930,913,5,12,1935,901,1707,210,230,227,1,,0,0.0,0.0,0.0,0.0,0.0
2024,4,13,6,2024-04-13,YX,6192,PHL,ORD,"Philadelphia, PA",Pennsylvania,"Chicago, IL",Illinois,1313,1848,7,0,1320,1848,20,19,1340,1829,2543,316,336,355,0,,0,0.0,0.0,0.0,0.0,0.0
2024,4,27,6,2024-04-27,MQ,2811,MIA,BOS,"Miami, FL",Florida,"Boston, MA",Massachusetts,605,2288,-10,-10,595,2278,20,10,615,2268,293,40,60,70,0,,0,0.0,0.0,0.0,0.0,0.0
2024,1,5,5,2024-01-05,9E,9282,DFW,MCO,"Dallas/Fort Worth, TX",Texas,"Orlando, FL",Florida,664,1679,-21,-15,643,1664,17,4,660,1660,391,52,72,73,0,,0,0.0,0.0,0.0,0.0,0.0
2024,12,25,3,2024-12-25,9E,9813,IAH,SAN,"Houston, TX",Texas,"San Diego, CA",California,1137,1962,5,10,1142,1972,5,12,1147,1960,2939,369,389,386,0,,0,0.0,0.0,0.0,0.0,0.0
2024,9,4,3,2024-09-04,MQ,6328,SEA,IAD,"Seattle, WA",Washington,"Washington, DC",District of Columbia,1869,2144,2,0,1871,2144,10,14,1881,2130,2608,317,337,341,0,,0,0.0,0.0,0.0,0.0,0.0
2024,12,29,7,2024-12-29,YX,6095,DFW,DCA,"Dallas/Fort Worth, TX",Texas,"Washington, DC",District of Columbia,1621,1352,-9,-15,1612,1337,8,9,1620,1328,1413,169,189,186,0,,0,0.0,0.0,0.0,0.0,0.0
2024,11,16,6,2024-11-16,HA,8282,LAS,TPA,"Las Vegas, NV",Nevada,"Tampa, FL",Florida,1523,1606,25,20,1548,1626,6,9,1554,1617,2673,336,356,351,0,,0,4.0,0.0,1.0,0.0,15.0
2024,4,30,2,2024-04-30,B6,5602,SFO,HNL,"San Francisco, CA",California,"Honolulu, HI",Hawaii,2009,2123,-5,5,2004,2128,11,15,2015,2113,2690,334,354,360,0,,0,0.0,0.0,0.0,0.0,0.0
2024,10,12,6,2024-10-12,9E,5860,LAS,PDX,"Las Vegas, NV",Nevada,"Portland, OR",Oregon,830,2107,-8,-10,822,2097,28,12,850,2085,501,56,76,96,0,,0,0.0,0.0,0.0,0.0,0.0
2024,5,28,2,2024-05-28,WN,5682,LAS,PHX,"Las Vegas, NV",Nevada,"Phoenix, AZ",Arizona,1893,763,19,20,1912,783,18,8,1930,775,2367,296,316,322,0,,0,7.0,3.0,3.0,0.0,7.0
2024,3,24,7,2024-03-24,DL,2598,SFO,MCO,"San Francisco, CA",California,"Orlando, FL",Florida,1965,2064,-3,-5,1962,2059,27,15,1989,2044,987,114,134,156,0,,0,0.0,0.0,0.0,0.0,0.0
2024,8,18,7,2024-08-18,WN,2665,SEA,LAX,"Seattle, WA",Washington,"Los Angeles, CA",California,1643,1574,39,30,1682,1604,29,18,1711,1586,1861,241,261,288,0,,0,5.0,5.0,4.0,0.0,16.0
2024,10,14,1,2024-10-14,YX,7089,ATL,PHX,"Atlanta, GA",Georgia,"Phoenix, AZ",Arizona,798,732,-8,-15,790,717,5,9,795,708,2660,329,349,343,0,,0,0.0,0.0,0.0,0.0,0.0
2024,6,9,7,2024-06-09,F9,4890,TPA,JFK,"Tampa, FL",Florida,"New York, NY",New York,1355,680,-3,-10,1352,670,14,10,1366,660,2225,287,307,311,0,,0,0.0,0.0,0.0,0.0,0.0
2024,9,28,6,2024-09-28,B6,5124,LAX,DCA,"Los Angeles, CA",California,"Washington, DC",District of Columbia,1666,949,-2,5,1664,954,10,10,1674,944,1346,173,193,193,0,,0,0.0,0.0,0.0,0.0,0.0
2024,2,7,3,2024-02-07,B6,8407,PDX,SFO,"Portland, OR",Oregon,"San Francisco, CA",California,1206,2270,-28,-20,1178,2250,12,18,1190,2232,2301,296,316,326,0,,0,0.0,0.0,0.0,0.0,0.0
2024,8,13,2,2024-08-13,MQ,1131,MIA,EWR,"Miami, FL",Florida,"Newark, NJ",New Jersey,2165,733,-15,-20,2150,713,13,10,2163,703,2172,268,288,291,0,,0,0.0,0.0,0.0,0.0,0.0
2024,5,21,2,2024-05-21,YX,1341,ATL,STL,"Atlanta, GA",Georgia,"St. Louis, MO",Missouri,2139,1574,1,5,2140,1579,15,17,2155,1562,1441,188,208,220,0,,0,0.0,0.0,0.0,0.0,0.0
2024,10,18,5,2024-10-18,YX,1842,DCA,SEA,"Washington, DC",District of Columbia,"Seattle, WA",Washington,1616,1675,-14,-10,1602,1665,28,10,1630,1655,2586,332,352,370,0,,0,0.0,0.0,0.0,0.0,0.0
2024,5,30,4,2024-05-30,9E,5809,EWR,DCA,"Newark, NJ",New Jersey,"Washington, DC",District of Columbia,1820,1093,6,15,1826,1108,10,8,1836,1100,2383,296,316,314,0,,0,0.0,0.0,0.0,0.0,0.0
2024,4,23,2,2024-04-23,UA,6099,STL,PHX,"St. Louis, MO",Missouri,"Phoenix, AZ",Arizona,946,801,0,-5,946,796,12,3,958,793,685,79,99,94,0,,0,0.0,0.0,0.0,0.0,0.0
2024,8,24,6,2024-08-24,MQ,4190,IAD,DEN,"Washington, DC",District of Columbia,"Denver, CO",Colorado,979,1309,4,10,983,1319,28,18,1011,1301,2267,275,295,321,0,,0,0.0,0.0,0.0,0.0,0.0
2024,3,6,3,2024-03-06,F9,8260,DCA,PDX,"Washington, DC",District of Columbia,"Portland, OR",Oregon,1233,1217,-8,-5,1225,1212,20,15,1245,1197,2199,282,302,317,0,,0,0.0,0.0,0.0,0.0,0.0
2024,12,26,4,2024-12-26,AS,6983,DTW,BOS,"Detroit, MI",Michigan,"Boston, MA",Massachusetts,2235,1355,-3,0,2232,1355,21,6,2253,1349,1288,170,190,197,0,,0,0.0,0.0,0.0,0.0,0.0
2024,12,6,5,2024-12-06,DL,5229,DFW,IAD,"Dallas/Fort Worth, TX",Texas,"Washington, DC",District of Columbia,1373,2131,-5,-5,1368,2126,28,9,1396,2117,1642,196,216,233,0,,0,0.0,0.0,0.0,0.0,0.0
2024,9,14,6,2024-09-14,DL,4503,CLT,MSP,"Charlotte, NC",North Carolina,"Minneapolis, MN",Minnesota,1781,1572,14,5,1795,1577,11,3,1806,1574,2895,357,377,371,0,,0,0.0,0.0,0.0,0.0,0.0
2024,9,5,4,2024-09-05,G4,6677,LGA,SAN,"New York, NY",New York,"San Diego, CA",California,1021,1637,-6,-5,1015,1632,12,7,1027,1625,2185,271,291,290,0,,0,0.0,0.0,0.0,0.0,0.0
2024,11,26,2,2024-11-26,MQ,4997,LAS,JFK,"Las Vegas, NV",Nevada,"New York, NY",New York,2206,2008,-20,-10,2186,1998,12,10,2198,1988,739,89,109,111,0,,0,0.0,0.0,0.0,0.0,0.0
2024,11,18,1,2024-11-18,NK,263,BWI,DFW,"Baltimore, MD",Maryland,"Dallas/Fort Worth, TX",Texas,1898,2346,-20,-15,1878,2331,14,6,1892,2325,2854,364,384,384,0,,0,0.0,0.0,0.0,0.0,0.0
2024,6,28,5,2024-06-28,9E,3410,PDX,CLT,"Portland, OR",Oregon,"Charlotte, NC",North Carolina,1950,1824,-19,-15,1931,1809,26,9,1957,1800,1139,136,156,171,0,,0,0.0,0.0,0.0,0.0,0.0
2024,7,8,1,2024-07-08,G4,3488,DFW,SAN,"Dallas/Fort Worth, TX",Texas,"San Diego, CA",California,1624,764,1,-5,1625,759,13,18,1638,741,215,23,43,54,0,,0,0.0,0.0,0.0,0.0,0.0
2024,6,2,7,2024-06-02,OH,1095,SLC,PHL,"Salt Lake City, UT",Utah,"Philadelphia, PA",Pennsylvania,1121,1160,10,5,1131,1165,23,7,1154,1158,2706,342,362,372,0,,0,0.0,0.0,0.0,0.0,0.0
2024,7,14,7,2024-07-14,AS,6261,SEA,DCA,"Seattle, WA",Washington,"Washington, DC",District of Columbia,1258,1756,-7,-10,1251,1746,14,19,1265,1727,2232,270,290,303,0,,0,0.0,0.0,0.0,0.0,0.0
2024,11,6,3,2024-11-06,HA,1977,SAN,IAH,"San Diego, CA",California,"Houston, TX",Texas,743,1181,-18,-10,725,1171,21,13,746,1158,519,65,85,99,0,,0,0.0,0.0,0.0,0.0,0.0
2024,9,18,3,2024-09-18,B6,8203,SLC,MCO,"Salt Lake City, UT",Utah,"Orlando, FL",Florida,522,718,13,15,535,733,13,7,548,726,2668,339,359,359,0,,0,0.0,0.0,0.0,0.0,0.0
2024,5,22,3,2024-05-22,YX,3364,CLT,MDW,"Charlotte, NC",North Carolina,"Chicago, IL",Illinois,1877,2274,-1,0,1876,2274,18,5,1894,2269,1347,173,193,196,0,,0,0.0,0.0,0.0,0.0,0.0
2024,12,7,6,2024-12-07,AA,1448,PHL,DFW,"Philadelphia, PA",Pennsylvania,"Dallas/Fort Worth, TX",Texas,965,1292,7,15,972,1307,6,5,978,1302,2792,343,363,354,0,,0,0.0,0.0,0.0,0.0,0.0
2024,11,11,1,2024-11-11,YX,2351,SEA,TPA,"Seattle, WA",Washington,"Tampa, FL",Florida,1748,2109,16,15,1764,2124,7,14,1771,2110,2767,335,355,356,0,,0,0.0,0.0,0.0,0.0,0.0
2024,4,10,3,2024-04-10,AS,7390,BOS,ATL,"Boston, MA",Massachusetts,"Atlanta, GA",Georgia,1364,1806,-22,-15,1342,1791,24,17,1366,1774,2992,376,396,417,0,,0,0.0,0.0,0.0,0.0,0.0
2024,8,31,6,2024-08-31,AS,9885,PHX,SEA,"Phoenix, AZ",Arizona,"Seattle, WA",Washington,1967,2081,21,20,1988,2101,28,11,2016,2090,2025,249,269,288,0,,0,3.0,2.0,3.0,0.0,12.0
2024,1,12,5,2024-01-12,UA,8118,LGA,EWR,"New York, NY",New York,"Newark, NJ",New Jersey,2297,934,-13,-15,2284,919,13,16,2297,903,852,103,123,132,0,,0,0.0,0.0,0.0,0.0,0.0
2024,8,26,1,2024-08-26,UA,6690,HNL,SEA,"Honolulu, HI",Hawaii,"Seattle, WA",Washington,768,2185,11,15,779,2200,23,10,802,2190,2941,375,395,408,0,,0,0.0,0.0,0.0,0.0,0.0
2024,2,18,7,2024-02-18,HA,7758,STL,HNL,"St. Louis, MO",Missouri,"Honolulu, HI",Hawaii,1032,2316,8,0,1040,2316,22,12,1062,2304,2606,328,348,362,0,,0,0.0,0.0,0.0,0.0,0.0
2024,2,11,7,2024-02-11,UA,532,SAN,PHL,"San Diego, CA",California,"Philadelphia, PA",Pennsylvania,813,1236,7,0,820,1236,22,19,842,1217,1948,242,262,283,0,,0,0.0,0.0,0.0,0.0,0.0
2024,6,14,5,2024-06-14,UA,5843,LAX,IAH,"Los Angeles, CA",California,"Houston, TX",Texas,619,830,12,5,631,835,15,17,646,818,2072,265,285,297,0,,0,0.0,0.0,0.0,0.0,0.0
2024,3,22,5,2024-03-22,NK,5347,MDW,ORD,"Chicago, IL",Illinois,"Chicago, IL",Illinois,1480,910,8,10,1488,920,13,4,1501,916,750,100,120,117,0,,0,0.0,0.0,0.0,0.0,0.0
2024,10,17,4,2024-10-17,9E,7815,BWI,ATL,"Baltimore, MD",Maryland,"Atlanta, GA",Georgia,2004,602,-4,0,2000,602,16,5,2016,597,636,70,90,91,0,,0,0.0,0.0,0.0,0.0,0.0
2024,6,6,4,2024-06-06,OO,3917,TPA,BWI,"Tampa, FL",Florida,"Baltimore, MD",Maryland,1643,1284,-9,-5,1634,1279,12,11,1646,1268,985,122,142,145,0,,0,0.0,0.0,0.0,0.0,0.0
2024,8,3,6,2024-08-03,DL,1170,ORD,DEN,"Chicago, IL",Illinois,"Denver, CO",Colorado,1209,680,-13,-15,1196,665,22,19,1218,646,1776,229,249,270,0,,0,0.0,0.0,0.0,0.0,0.0
2024,6,6,4,2024-06-06,9E,4700,PHL,DEN,"Philadelphia, PA",Pennsylvania,"Denver, CO",Colorado,635,1898,0,5,635,1903,12,4,647,1899,1712,213,233,229,0,,0,0.0,0.0,0.0,0.0,0.0
2024,5,13,1,2024-05-13,MQ,8406,LGA,DTW,"New York, NY",New York,"Detroit, MI",Michigan,1600,987,-19,-15,1581,972,8,8,1589,964,306,29,49,45,0,,0,0.0,0.0,0.0,0.0,0.0
2024,3,7,4,2024-03-07,9E,9731,PDX,JFK,"Portland, OR",Oregon,"New York, NY",New York,1877,1426,7,5,1884,1431,10,13,1894,1418,1963,243,263,266,0,,0,0.0,0.0,0.0,0.0,0.0
2024,12,1,7,2024-12-01,DL,1094,LGA,DTW,"New York, NY",New York,"Detroit, MI",Michigan,1581,1968,9,0,1590,1968,25,13,1615,1955,702,92,112,130,0,,0,0.0,0.0,0.0,0.0,0.0
2024,1,7,7,2024-01-07,UA,4418,DEN,BWI,"Denver, CO",Colorado,"Baltimore, MD",Maryland,1435,818,-10,-5,1425,813,20,11,1445,802,1251,151,171,182,0,,0,0.0,0.0,0.0,0.0,0.0
2024,1,14,7,2024-01-14,9E,4831,PDX,DEN,"Portland, OR",Oregon,"Denver, CO",Colorado,1609,1251,6,0,1615,1251,25,18,1640,1233,1144,139,159,182,0,,0,0.0,0.0,0.0,0.0,0.0
2024,3,13,3,2024-03-13,YX,6168,BWI,HNL,"Baltimore, MD",Maryland,"Honolulu, HI",Hawaii,500,662,14,5,514,667,17,16,531,651,2444,297,317,330,0,,0,0.0,0.0,0.0,0.0,0.0
2024,6,11,2,2024-06-11,NK,7770,LAX,JFK,"Los Angeles, CA",California,"New York, NY",New York,576,1039,22,15,598,1054,20,13,618,1041,523,61,81,94,0,,0,0.0,0.0,0.0,0.0,0.0
2024,3,6,3,2024-03-06,UA,4867,LAS,DCA,"Las Vegas, NV",Nevada,"Washington, DC",District of Columbia,1460,1650,-1,-10,1459,1640,27,12,1486,1628,2152,278,298,317,0,,0,0.0,0.0,0.0,0.0,0.0
2024,12,12,4,2024-12-12,NK,1057,DEN,ORD,"Denver, CO",Colorado,"Chicago, IL",Illinois,2045,1307,12,15,2057,1322,28,4,2085,1318,768,93,113,125,0,,0,0.0,0.0,0.0,0.0,0.0
2024,5,9,4,2024-05-09,G4,8387,MIA,CLT,"Miami, FL",Florida,"Charlotte, NC",North Carolina,1967,2004,27,20,1994,2024,25,9,2019,2015,2570,315,335,349,0,,0,2.0,4.0,3.0,0.0,11.0
2024,7,24,3,2024-07-24,OO,2254,DCA,SEA,"Washington, DC",District of Columbia,"Seattle, WA",Washington,1080,2287,14,10,1094,2297,24,3,1118,2294,2703,329,349,356,0,,0,0.0,0.0,0.0,0.0,0.0
2024,10,2,3,2024-10-02,9E,731,MDW,EWR,"Chicago, IL",Illinois,"Newark, NJ",New Jersey,647,1871,0,10,647,1881,22,7,669,1874,2782,350,370,379,0,,0,0.0,0.0,0.0,0.0,0.0
2024,9,12,4,2024-09-12,YX,9993,DFW,SEA,"Dallas/Fort Worth, TX",Texas,"Seattle, WA",Washington,1073,1777,-5,5,1068,1782,25,17,1093,1765,482,55,75,97,0,,0,0.0,0.0,0.0,0.0,0.0
2024,9,22,7,2024-09-22,HA,6145,LAX,SLC,"Los Angeles, CA",California,"Salt Lake City, UT",Utah,2048,809,-24,-20,2024,789,12,13,2036,776,2589,315,335,340,0,,0,0.0,0.0,0.0,0.0,0.0
2024,1,25,4,2024-01-25,OO,797,BWI,IAH,"Baltimore, MD",Maryland,"Houston, TX",Texas,685,1645,5,0,690,1645,5,11,695,1634,617,73,93,89,0,,0,0.0,0.0,0.0,0.0,0.0
2024,10,7,1,2024-10-07,WN,131,BOS,STL,"Boston, MA",Massachusetts,"St. Louis, MO",Missouri,2200,2205,14,5,2214,2210,10,3,2224,2207,960,115,135,128,0,,0,0.0,0.0,0.0,0.0,0.0
2024,9,9,1,2024-09-09,NK,6309,MDW,HNL,"Chicago, IL",Illinois,"Honolulu, HI",Hawaii,1021,1642,18,15,1039,1657,22,8,1061,1649,392,58,78,88,0,,0,0.0,0.0,0.0,0.0,0.0
2024,11,5,2,2024-11-05,G4,4974,PHL,BWI,"Philadelphia, PA",Pennsylvania,"Baltimore, MD",Maryland,2294,1108,1,0,2295,1108,6,12,2301,1096,1211,158,178,176,0,,0,0.0,0.0,0.0,0.0,0.0
2024,10,15,2,2024-10-15,OH,5662,SAN,LAX,"San Diego, CA",California,"Los Angeles, CA",California,661,2236,-1,5,660,2241,12,6,672,2235,2539,316,336,334,0,,0,0.0,0.0,0.0,0.0,0.0
2024,6,12,3,2024-06-12,F9,8840,JFK,SAN,"New York, NY",New York,"San Diego, CA",California,1813,1273,1,5,1814,1278,10,14,1824,1264,720,84,104,108,0,,0,0.0,0.0,0.0,0.0,0.0
2024,4,4,4,2024-04-04,F9,2348,MSP,ORD,"Minneapolis, MN",Minnesota,"Chicago, IL",Illinois,1944,1250,-9,-10,1935,1240,10,11,1945,1229,2611,323,343,344,0,,0,0.0,0.0,0.0,0.0,0.0
2024,9,26,4,2024-09-26,G4,6292,MSP,SEA,"Minneapolis, MN",Minnesota,"Seattle, WA",Washington,695,1487,-2,-10,693,1477,26,19,719,1458,1978,251,271,296,0,,0,0.0,0.0,0.0,0.0,0.0
2024,11,16,6,2024-11-16,OH,9995,CLT,STL,"Charlotte, NC",North Carolina,"St. Louis, MO",Missouri,533,2223,-1,5,532,2228,29,19,561,2209,736,97,117,145,0,,0,0.0,0.0,0.0,0.0,0.0
2024,4,19,5,2024-04-19,B6,6506,ATL,DFW,"Atlanta, GA",Georgia,"Dallas/Fort Worth, TX",Texas,2195,2052,-14,-10,2181,2042,18,16,2199,2026,2325,290,310,324,0,,0,0.0,0.0,0.0,0.0,0.0
2024,12,1,7,2024-12-01,OH,1256,DCA,PHX,"Washington, DC",District of Columbia,"Phoenix, AZ",Arizona,2120,636,-14,-10,2106,626,7,11,2113,615,1214,150,170,168,0,,0,0.0,0.0,0.0,0.0,0.0
2024,11,5,2,2024-11-05,B6,8635,MIA,DCA,"Miami, FL",Florida,"Washington, DC",District of Columbia,2093,1006,2,0,2095,1006,22,15,2117,991,665,73,93,110,0,,0,0.0,0.0,0.0,0.0,0.0
2024,8,25,7,2024-08-25,UA,5395,DTW,BWI,"Detroit, MI",Michigan,"Baltimore, MD",Maryland,907,1023,14,5,921,1028,9,5,930,1023,440,45,65,59,0,,0,0.0,0.0,0.0,0.0,0.0
2024,1,25,4,2024-01-25,B6,6254,IAD,SEA,"Washington, DC",District of Columbia,"Seattle, WA",Washington,1820,1282,6,0,1826,1282,26,11,1852,1271,482,66,86,103,0,,0,0.0,0.0,0.0,0.0,0.0
2024,5,20,1,2024-05-20,F9,2348,BOS,SAN,"Boston, MA",Massachusetts,"San Diego, CA",California,1036,937,4,10,1040,947,29,18,1069,929,915,107,127,154,0,,0,0.0,0.0,0.0,0.0,0.0
2024,4,26,5,2024-04-26,YX,9236,MDW,EWR,"Chicago, IL",Illinois,"Newark, NJ",New Jersey,535,1894,-7,-10,528,1884,20,9,548,1875,1919,244,264,273,0,,0,0.0,0.0,0.0,0.0,0.0
2024,1,25,4,2024-01-25,B6,3385,LAS,JFK,"Las Vegas, NV",Nevada,"New York, NY",New York,1787,1518,-10,-10,1777,1508,29,16,1806,1492,2294,294,314,339,0,,0,0.0,0.0,0.0,0.0,0.0
2024,3,19,2,2024-03-19,WN,9622,MDW,SEA,"Chicago, IL",Illinois,"Seattle, WA",Washington,1905,1366,9,0,1914,1366,22,12,1936,1354,888,105,125,139,0,,0,0.0,0.0,0.0,0.0,0.0
2024,3,8,5,2024-03-08,F9,2103,SAN,DFW,"San Diego, CA",California,"Dallas/Fort Worth, TX",Texas,613,1251,18,10,631,1261,13,12,644,1249,1877,226,246,251,0,,0,0.0,0.0,0.0,0.0,0.0
2024,6,21,5,2024-06-21,NK,3715,PHX,MDW,"Phoenix, AZ",Arizona,"Chicago, IL",Illinois,2140,2203,-7,0,2133,2203,29,8,2162,2195,2321,293,313,330,0,,0,0.0,0.0,0.0,0.0,0.0
2024,1,12,5,2024-01-12,HA,3772,BOS,IAH,"Boston, MA",Massachusetts,"Houston, TX",Texas,1104,2203,-14,-20,1090,2183,26,5,1116,2178,1819,234,254,265,0,,0,0.0,0.0,0.0,0.0,0.0
2024,10,14,1,2024-10-14,OH,7558,BOS,DTW,"Boston, MA",Massachusetts,"Detroit, MI",Michigan,2124,1547,11,5,2135,1552,5,19,2140,1533,989,130,150,154,0,,0,0.0,0.0,0.0,0.0,0.0
2024,5,7,2,2024-05-07,OH,2255,LAS,DEN,"Las Vegas, NV",Nevada,"Denver, CO",Colorado,942,2304,2,10,944,2314,15,4,959,2310,898,104,124,123,0,,0,0.0,0.0,0.0,0.0,0.0
2024,4,5,5,2024-04-05,AS,3579,DFW,MDW,"Dallas/Fort Worth, TX",Texas,"Chicago, IL",Illinois,1686,2240,-7,-10,1679,2230,12,9,1691,2221,2039,253,273,274,0,,0,0.0,0.0,0.0,0.0,0.0
2024,4,1,1,2024-04-01,B6,151,SFO,PDX,"San Francisco, CA",California,"Portland, OR",Oregon,537,2085,-20,-15,517,2070,12,14,529,2056,2605,333,353,359,0,,0,0.0,0.0,0.0,0.0,0.0
2024,5,20,1,2024-05-20,OH,2259,HNL,SAN,"Honolulu, HI",Hawaii,"San Diego, CA",California,591,1938,-1,0,590,1938,28,3,618,1935,1676,201,221,232,0,,0,0.0,0.0,0.0,0.0,0.0
2024,1,31,3,2024-01-31,B6,4490,MCO,SFO,"Orlando, FL",Florida,"San Francisco, CA",California,1130,1681,-14,-20,1116,1661,17,7,1133,1654,2277,287,307,311,0,,0,0.0,0.0,0.0,0.0,0.0
2024,11,29,5,2024-11-29,MQ,3751,DFW,MCO,"Dallas/Fort Worth, TX",Texas,"Orlando, FL",Florida,2246,975,-14,-5,2232,970,12,15,2244,955,2785,345,365,372,0,,0,0.0,0.0,0.0,0.0,0.0
2024,1,20,6,2024-01-20,9E,7456,PHX,ATL,"Phoenix, AZ",Arizona,"Atlanta, GA",Georgia,1171,2322,-19,-20,1152,2302,20,8,1172,2294,398,57,77,85,0,,0,0.0,0.0,0.0,0.0,0.0
2024,5,25,6,2024-05-25,DL,2212,BWI,DFW,"Baltimore, MD",Maryland,"Dallas/Fort Worth, TX",Texas,600,2079,-5,-10,595,2069,25,7,620,2062,2510,308,328,340,0,,0,0.0,0.0,0.0,0.0,0.0
2024,11,11,1,2024-11-11,MQ,5865,MCO,ATL,"Orlando, FL",Florida,"Atlanta, GA",Georgia,1006,1006,0,-5,1006,1001,22,7,1028,994,2612,324,344,353,0,,0,0.0,0.0,0.0,0.0,0.0
2024,6,8,6,2024-06-08,HA,1454,ATL,MSP,"Atlanta, GA",Georgia,"Minneapolis, MN",Minnesota,678,2008,-23,-15,655,1993,13,12,668,1981,2252,286,306,311,0,,0,0.0,0.0,0.0,0.0,0.0
2024,12,14,6,2024-12-14,WN,5720,MCO,LGA,"Orlando, FL",Florida,"New York, NY",New York,783,655,-8,-15,775,640,16,4,791,636,795,94,114,114,0,,0,0.0,0.0,0.0,0.0,0.0
2024,2,12,1,2024-02-12,F9,3854,SEA,PHL,"Seattle, WA",Washington,"Philadelphia, PA",Pennsylvania,854,2082,6,10,860,2092,26,13,886,2079,2105,268,288,307,0,,0,0.0,0.0,0.0,0.0,0.0
2024,9,10,2,2024-09-10,F9,309,DEN,DFW,"Denver, CO",Colorado,"Dallas/Fort Worth, TX",Texas,1820,1074,-21,-20,1799,1054,7,3,1806,1051,2695,335,355,345,0,,0,0.0,0.0,0.0,0.0,0.0
2024,5,9,4,2024-05-09,OO,6332,SAN,HNL,"San Diego, CA",California,"Honolulu, HI",Hawaii,2058,2139,2,5,2060,2144,5,8,2065,2136,2270,280,300,293,0,,0,0.0,0.0,0.0,0.0,0.0
2024,2,29,4,2024-02-29,AA,7946,MSP,BOS,"Minneapolis, MN",Minnesota,"Boston, MA",Massachusetts,987,616,17,10,1004,626,25,16,1029,610,1871,237,257,278,0,,0,0.0,0.0,0.0,0.0,0.0
2024,5,30,4,2024-05-30,DL,6271,LAX,PDX,"Los Angeles, CA",California,"Portland, OR",Oregon,1505,1032,-9,-15,1496,1017,24,5,1520,1012,1654,206,226,235,0,,0,0.0,0.0,0.0,0.0,0.0
2024,10,13,7,2024-10-13,B6,337,TPA,SLC,"Tampa, FL",Florida,"Salt Lake City, UT",Utah,778,836,-18,-10,760,826,24,9,784,817,368,46,66,79,0,,0,0.0,0.0,0.0,0.0,0.0
2024,1,5,5,2024-01-05,G4,8627,STL,PDX,"St. Louis, MO",Missouri,"Portland, OR",Oregon,1043,906,-3,0,1040,906,13,17,1053,889,1143,145,165,175,0,,0,0.0,0.0,0.0,0.0,0.0
2024,9,22,7,2024-09-22,9E,8175,DTW,STL,"Detroit, MI",Michigan,"St. Louis, MO",Missouri,1149,1032,4,-5,1153,1027,26,9,1179,1018,2706,333,353,368,0,,0,0.0,0.0,0.0,0.0,0.0
2024,12,10,2,2024-12-10,OO,1676,HNL,LAX,"Honolulu, HI",Hawaii,"Los Angeles, CA",California,2116,623,-6,0,2110,623,12,5,2122,618,1609,202,222,219,0,,0,0.0,0.0,0.0,0.0,0.0
2024,5,9,4,2024-05-09,YX,8791,DTW,SLC,"Detroit, MI",Michigan,"Salt Lake City, UT",Utah,1430,1923,19,10,1449,1933,29,13,1478,1920,1542,196,216,238,0,,0,0.0,0.0,0.0,0.0,0.0
2024,9,23,1,2024-09-23,MQ,9856,PHX,MIA,"Phoenix, AZ",Arizona,"Miami, FL",Florida,854,2251,-14,-15,840,2236,17,7,857,2229,922,109,129,133,0,,0,0.0,0.0,0.0,0.0,0.0
2024,6,26,3,2024-06-26,OO,9082,SAN,LAS,"San Diego, CA",California,"Las Vegas, NV",Nevada,1842,1861,-5,0,1837,1861,21,16,1858,1845,2152,269,289,306,1,,0,0.0,0.0,0.0,0.0,0.0
2024,9,9,1,2024-09-09,NK,3640,STL,DCA,"St. Louis, MO",Missouri,"Washington, DC",District of Columbia,694,1613,14,15,708,1628,27,5,735,1623,574,63,83,95,0,,0,0.0,0.0,0.0,0.0,0.0
2024,2,25,7,2024-02-25,9E,9427,BOS,SAN,"Boston, MA",Massachusetts,"San Diego, CA",California,1303,1280,-16,-15,1287,1265,11,6,1298,1259,1504,180,200,197,0,,0,0.0,0.0,0.0,0.0,0.0
2024,3,23,6,2024-03-23,B6,7357,ATL,MCO,"Atlanta, GA",Georgia,"Orlando, FL",Florida,592,2115,-25,-15,567,2100,19,7,586,2093,1197,148,168,174,0,,0,0.0,0.0,0.0,0.0,0.0
2024,4,8,1,2024-04-08,AA,249,EWR,DFW,"Newark, NJ",New Jersey,"Dallas/Fort Worth, TX",Texas,932,1551,-2,0,930,1551,18,6,948,1545,1461,181,201,205,0,,0,0.0,0.0,0.0,0.0,0.0
2024,5,28,2,2024-05-28,HA,1724,MSP,LGA,"Minneapolis, MN",Minnesota,"New York, NY",New York,1057,1911,27,20,1084,1931,29,6,1113,1925,815,110,130,145,0,,0,4.0,1.0,3.0,0.0,12.0
2024,11,24,7,2024-11-24,HA,7761,ORD,JFK,"Chicago, IL",Illinois,"New York, NY",New York,1550,1014,-18,-10,1532,1004,20,4,1552,1000,2073,253,273,277,0,,0,0.0,0.0,0.0,0.0,0.0
2024,6,4,2,2024-06-04,AS,2674,STL,MSP,"St. Louis, MO",Missouri,"Minneapolis, MN",Minnesota,1938,1352,-15,-5,1923,1347,21,7,1944,1340,708,86,106,114,0,,0,0.0,0.0,0.0,0.0,0.0
2024,7,8,1,2024-07-08,YX,4528,HNL,SAN,"Honolulu, HI",Hawaii,"San Diego, CA",California,661,2023,-16,-15,645,2008,20,5,665,2003,1764,219,239,244,0,,0,0.0,0.0,0.0,0.0,0.0
2024,9,19,4,2024-09-19,F9,7629,LGA,DCA,"New York, NY",New York,"Washington, DC",District of Columbia,600,1015,-13,-5,587,1010,22,16,609,994,2796,349,369,387,0,,0,0.0,0.0,0.0,0.0,0.0
2024,3,20,3,2024-03-20,NK,4369,DCA,HNL,"Washington, DC",District of Columbia,"Honolulu, HI",Hawaii,1198,1475,-13,-20,1185,1455,18,6,1203,1449,436,45,65,69,0,,0,0.0,0.0,0.0,0.0,0.0
2024,9,8,7,2024-09-08,DL,7869,ORD,SFO,"Chicago, IL",Illinois,"San Francisco, CA",California,1996,1409,-9,-5,1987,1404,10,18,1997,1386,880,101,121,129,0,,0,0.0,0.0,0.0,0.0,0.0
2024,4,6,6,2024-04-06,YX,2208,PHL,DEN,"Philadelphia, PA",Pennsylvania,"Denver, CO",Colorado,2229,1489,-4,0,2225,1489,24,6,2249,1483,566,73,93,103,0,,0,0.0,0.0,0.0,0.0,0.0
2024,9,16,1,2024-09-16,B6,4047,MDW,DFW,"Chicago, IL",Illinois,"Dallas/Fort Worth, TX",Texas,657,2106,19,20,676,2126,25,8,701,2118,2996,380,400,413,0,,0,5.0,3.0,1.0,0.0,11.0
2024,9,16,1,2024-09-16,OH,7999,SEA,MIA,"Seattle, WA",Washington,"Miami, FL",Florida,991,1874,12,10,1003,1884,19,19,1022,1865,2590,320,340,358,0,,0,0.0,0.0,0.0,0.0,0.0
2024,4,12,5,2024-04-12,OO,5014,SEA,PDX,"Seattle, WA",Washington,"Portland, OR",Oregon,1418,1276,3,10,1421,1286,9,6,1430,1280,2846,361,381,376,0,,0,0.0,0.0,0.0,0.0,0.0
2024,2,9,5,2024-02-09,WN,6767,SAN,ORD,"San Diego, CA",California,"Chicago, IL",Illinois,1532,999,-9,-10,1523,989,21,14,1544,975,2794,351,371,386,0,,0,0.0,0.0,0.0,0.0,0.0
2024,9,29,7,2024-09-29,G4,2363,IAH,LGA,"Houston, TX",Texas,"New York, NY",New York,1735,1452,-23,-15,1712,1437,5,9,1717,1428,1226,148,168,162,0,,0,0.0,0.0,0.0,0.0,0.0
2024,4,10,3,2024-04-10,9E,9904,SEA,PDX,"Seattle, WA",Washington,"Portland, OR",Oregon,1962,740,5,0,1967,740,17,18,1984,722,2437,295,315,330,0,,0,0.0,0.0,0.0,0.0,0.0
2024,12,24,2,2024-12-24,AA,3915,IAD,DEN,"Washington, DC",District of Columbia,"Denver, CO",Colorado,1323,977,0,0,1323,977,11,16,1334,961,2560,329,349,356,0,,0,0.0,0.0,0.0,0.0,0.0
2024,11,3,7,2024-11-03,YX,677,MIA,JFK,"Miami, FL",Florida,"New York, NY",New York,1178,1743,-8,0,1170,1743,23,15,1193,1728,2832,361,381,399,0,,0,0.0,0.0,0.0,0.0,0.0
2024,8,8,4,2024-08-08,AS,522,ORD,LAS,"Chicago, IL",Illinois,"Las Vegas, NV",Nevada,1285,1961,-18,-15,1267,1946,25,13,1292,1933,2267,279,299,317,0,,0,0.0,0.0,0.0,0.0,0.0
2024,11,3,7,2024-11-03,UA,2863,ATL,MIA,"Atlanta, GA",Georgia,"Miami, FL",Florida,1491,1049,-4,0,1487,1049,28,13,1515,1036,1183,141,161,182,0,,0,0.0,0.0,0.0,0.0,0.0
2024,5,3,5,2024-05-03,OO,1329,MDW,MIA,"Chicago, IL",Illinois,"Miami, FL",Florida,610,1487,-7,-10,603,1477,9,3,612,1474,2456,297,317,309,0,,0,0.0,0.0,0.0,0.0,0.0
2024,8,18,7,2024-08-18,G4,3276,SAN,LAX,"San Diego, CA",California,"Los Angeles, CA",California,1340,1784,-14,-5,1326,1779,13,10,1339,1769,308,45,65,68,0,,0,0.0,0.0,0.0,0.0,0.0
2024,6,26,3,2024-06-26,B6,9045,PDX,SAN,"Portland, OR",Oregon,"San Diego, CA",California,702,1728,-16,-15,686,1713,8,15,694,1698,2664,326,346,349,0,,0,0.0,0.0,0.0,0.0,0.0
2024,3,3,7,2024-03-03,MQ,787,DEN,SAN,"Denver, CO",Colorado,"San Diego, CA",California,2283,1449,2,10,2285,1459,11,6,2296,1453,326,45,65,62,0,,0,0.0,0.0,0.0,0.0,0.0
2024,4,25,4,2024-04-25,AS,822,MCO,LGA,"Orlando, FL",Florida,"New York, NY",New York,1588,691,-20,-20,1568,671,17,8,1585,663,2189,268,288,293,0,,0,0.0,0.0,0.0,0.0,0.0
2024,7,9,2,2024-07-09,OO,846,TPA,MDW,"Tampa, FL",Florida,"Chicago, IL",Illinois,2238,1084,23,15,2261,1099,12,5,2273,1094,2317,295,315,312,0,,0,0.0,0.0,0.0,0.0,0.0
2024,3,2,6,2024-03-02,G4,4437,HNL,MDW,"Honolulu, HI",Hawaii,"Chicago, IL",Illinois,1684,2042,7,10,1691,2052,27,11,1718,2041,1143,147,167,185,0,,0,0.0,0.0,0.0,0.0,0.0
2024,9,12,4,2024-09-12,G4,2812,PDX,CLT,"Portland, OR",Oregon,"Charlotte, NC",North Carolina,913,1020,14,5,927,1025,8,9,935,1016,2293,283,303,300,0,,0,0.0,0.0,0.0,0.0,0.0
2024,1,7,7,2024-01-07,F9,807,TPA,MCO,"Tampa, FL",Florida,"Orlando, FL",Florida,2168,1315,24,30,2192,1345,12,13,2204,1332,1870,235,255,260,0,,0,2.0,2.0,0.0,0.0,26.0
2024,6,3,1,2024-06-03,G4,8726,LAS,DTW,"Las Vegas, NV",Nevada,"Detroit, MI",Michigan,1189,1151,-17,-15,1172,1136,20,17,1192,1119,1249,165,185,202,0,,0,0.0,0.0,0.0,0.0,0.0
2024,4,1,1,2024-04-01,WN,583,PDX,CLT,"Portland, OR",Oregon,"Charlotte, NC",North Carolina,2228,1503,2,0,2230,1503,17,17,2247,1486,1024,121,141,155,0,,0,0.0,0.0,0.0,0.0,0.0
2024,1,14,7,2024-01-14,AS,1633,SLC,CLT,"Salt Lake City, UT",Utah,"Charlotte, NC",North Carolina,765,1677,10,10,775,1687,14,19,789,1668,2442,299,319,332,0,,0,0.0,0.0,0.0,0.0,0.0
2024,8,16,5,2024-08-16,B6,269,SAN,DEN,"San Diego, CA",California,"Denver, CO",Colorado,1071,1200,-24,-15,1047,1185,18,17,1065,1168,2966,370,390,405,0,,0,0.0,0.0,0.0,0.0,0.0
2024,3,26,2,2024-03-26,B6,1120,STL,PHL,"St. Louis, MO",Missouri,"Philadelphia, PA",Pennsylvania,704,2270,1,0,705,2270,24,14,729,2256,323,32,52,70,0,,0,0.0,0.0,0.0,0.0,0.0
2024,5,12,7,2024-05-12,WN,7193,MDW,IAD,"Chicago, IL",Illinois,"Washington, DC",District of Columbia,2190,2137,-13,-5,2177,2132,14,5,2191,2127,779,104,124,123,0,,0,0.0,0.0,0.0,0.0,0.0
2024,7,1,1,2024-07-01,DL,6566,CLT,BOS,"Charlotte, NC",North Carolina,"Boston, MA",Massachusetts,1083,1720,-1,-5,1082,1715,17,4,1099,1711,2925,366,386,387,0,,0,0.0,0.0,0.0,0.0,0.0
2024,3,2,6,2024-03-02,YX,947,BWI,IAH,"Baltimore, MD",Maryland,"Houston, TX",Texas,1679,2191,5,15,1684,2206,12,3,1696,2203,2164,262,282,277,0,,0,0.0,0.0,0.0,0.0,0.0
2024,8,6,2,2024-08-06,AS,8987,SFO,ATL,"San Francisco, CA",California,"Atlanta, GA",Georgia,672,2259,0,0,672,2259,28,6,700,2253,2365,295,315,329,0,,0,0.0,0.0,0.0,0.0,0.0
2024,9,2,1,2024-09-02,G4,3446,ATL,DTW,"Atlanta, GA",Georgia,"Detroit, MI",Michigan,807,784,-16,-15,791,769,24,9,815,760,519,68,88,101,0,,0,0.0,0.0,0.0,0.0,0.0
2024,8,17,6,2024-08-17,YX,4113,LAX,TPA,"Los Angeles, CA",California,"Tampa, FL",Florida,949,2056,7,15,956,2071,9,14,965,2057,1948,235,255,258,0,,0,0.0,0.0,0.0,0.0,0.0
2024,3,19,2,2024-03-19,AA,8178,EWR,JFK,"Newark, NJ",New Jersey,"New York, NY",New York,561,2094,-7,-10,554,2084,25,19,579,2065,2045,251,271,295,0,,0,0.0,0.0,0.0,0.0,0.0
2024,5,28,2,2024-05-28,OH,131,PHX,MIA,"Phoenix, AZ",Arizona,"Miami, FL",Florida,1896,1564,15,10,1911,1574,25,5,1936,1569,933,111,131,141,0,,0,0.0,0.0,0.0,0.0,0.0
2024,5,17,5,2024-05-17,NK,8468,SLC,PHX,"Salt Lake City, UT",Utah,"Phoenix, AZ",Arizona,1983,1748,18,20,2001,1768,23,19,2024,1749,1422,169,189,211,0,,0,4.0,4.0,3.0,0.0,9.0
2024,11,9,6,2024-11-09,AS,7977,PDX,LAS,"Portland, OR",Oregon,"Las Vegas, NV",Nevada,974,1957,13,10,987,1967,17,19,1004,1948,1620,197,217,233,0,,0,0.0,0.0,0.0,0.0,0.0
2024,3,5,2,2024-03-05,UA,6270,DTW,LGA,"Detroit, MI",Michigan,"New York, NY",New York,1904,1887,-5,5,1899,1892,6,12,1905,1880,1401,165,185,183,0,,0,0.0,0.0,0.0,0.0,0.0
2024,1,13,6,2024-01-13,AA,7930,BOS,ORD,"Boston, MA",Massachusetts,"Chicago, IL",Illinois,2240,1451,-5,5,2235,1456,20,17,2255,1439,2382,300,320,337,0,,0,0.0,0.0,0.0,0.0,0.0
2024,7,31,3,2024-07-31,MQ,9794,LAS,SLC,"Las Vegas, NV",Nevada,"Salt Lake City, UT",Utah,2095,790,-2,5,2093,795,18,11,2111,784,1907,247,267,276,0,,0,0.0,0.0,0.0,0.0,0.0
2024,8,29,4,2024-08-29,WN,2415,IAH,CLT,"Houston, TX",Texas,"Charlotte, NC",North Carolina,585,2350,-10,0,575,2350,21,19,596,2331,1671,200,220,240,0,,0,0.0,0.0,0.0,0.0,0.0
2024,7,31,3,2024-07-31,HA,165,PDX,LAX,"Portland, OR",Oregon,"Los Angeles, CA",California,1666,1844,-2,-10,1664,1834,7,6,1671,1828,2769,354,374,367,0,,0,0.0,0.0,0.0,0.0,0.0
2024,6,29,6,2024-06-29,OH,2028,PHL,IAH,"Philadelphia, PA",Pennsylvania,"Houston, TX",Texas,1530,798,-9,-10,1521,788,20,11,1541,777,1301,159,179,190,0,,0,0.0,0.0,0.0,0.0,0.0
2024,12,3,2,2024-12-03,G4,5111,ORD,MDW,"Chicago, IL",Illinois,"Chicago, IL",Illinois,794,943,14,5,808,948,13,8,821,940,2956,377,397,398,0,,0,0.0,0.0,0.0,0.0,0.0
2024,6,21,5,2024-06-21,HA,7633,JFK,LAX,"New York, NY",New York,"Los Angeles, CA",California,2214,773,-7,0,2207,773,11,17,2218,756,232,36,56,64,0,,0,0.0,0.0,0.0,0.0,0.0
2024,6,8,6,2024-06-08,DL,6325,TPA,IAD,"Tampa, FL",Florida,"Washington, DC",District of Columbia,1238,816,-2,0,1236,816,6,14,1242,802,2565,314,334,334,0,,0,0.0,0.0,0.0,0.0,0.0
2024,6,12,3,2024-06-12,UA,5547,PHL,BOS,"Philadelphia, PA",Pennsylvania,"Boston, MA",Massachusetts,2042,1829,1,5,2043,1834,15,10,2058,1824,1340,175,195,200,0,,0,0.0,0.0,0.0,0.0,0.0
2024,7,6,6,2024-07-06,DL,684,DCA,IAH,"Washington, DC",District of Columbia,"Houston, TX",Texas,2175,2202,8,5,2183,2207,28,11,2211,2196,1765,219,239,258,0,,0,0.0,0.0,0.0,0.0,0.0
2024,7,9,2,2024-07-09,OH,6570,LAS,LAX,"Las Vegas, NV",Nevada,"Los Angeles, CA",California,1025,1996,-3,5,1022,2001,15,11,1037,1990,2371,301,321,327,0,,0,0.0,0.0,0.0,0.0,0.0
2024,11,3,7,2024-11-03,DL,6785,STL,LAX,"St. Louis, MO",Missouri,"Los Angeles, CA",California,533,773,-11,-15,522,758,18,4,540,754,747,101,121,123,0,,0,0.0,0.0,0.0,0.0,0.0
2024,9,12,4,2024-09-12,9E,5344,BWI,PHL,"Baltimore, MD",Maryland,"Philadelphia, PA",Pennsylvania,1251,677,-5,-5,1246,672,20,12,1266,660,573,68,88,100,0,,0,0.0,0.0,0.0,0.0,0.0
2024,7,1,1,2024-07-01,OO,8254,TPA,DTW,"Tampa, FL",Florida,"Detroit, MI",Michigan,1852,1946,-11,-10,1841,1936,12,6,1853,1930,914,112,132,130,0,,0,0.0,0.0,0.0,0.0,0.0
2024,4,26,5,2024-04-26,OO,8051,MSP,MCO,"Minneapolis, MN",Minnesota,"Orlando, FL",Florida,2132,2177,9,0,2141,2177,27,8,2168,2169,2866,349,369,384,0,,0,0.0,0.0,0.0,0.0,0.0
2024,10,8,2,2024-10-08,F9,1848,HNL,ORD,"Honolulu, HI",Hawaii,"Chicago, IL",Illinois,1279,1175,-11,-15,1268,1160,26,14,1294,1146,811,103,123,143,0,,0,0.0,0.0,0.0,0.0,0.0
2024,7,14,7,2024-07-14,UA,7770,LGA,ATL,"New York, NY",New York,"Atlanta, GA",Georgia,1137,2007,11,5,1148,2012,19,15,1167,1997,2391,301,321,335,0,,0,0.0,0.0,0.0,0.0,0.0
2024,2,3,6,2024-02-03,NK,2304,MCO,DCA,"Orlando, FL",Florida,"Washington, DC",District of Columbia,1557,1440,-7,-15,1550,1425,20,19,1570,1406,792,105,125,144,0,,0,0.0,0.0,0.0,0.0,0.0
2024,2,21,3,2024-02-21,F9,1992,SEA,SLC,"Seattle, WA",Washington,"Salt Lake City, UT",Utah,1294,1036,-10,-10,1284,1026,6,8,1290,1018,2266,282,302,296,0,,0,0.0,0.0,0.0,0.0,0.0
2024,4,21,7,2024-04-21,UA,7118,SFO,MIA,"San Francisco, CA",California,"Miami, FL",Florida,905,798,14,5,919,803,8,17,927,786,2410,296,316,321,0,,0,0.0,0.0,0.0,0.0,0.0
2024,9,8,7,2024-09-08,DL,3193,HNL,BOS,"Honolulu, HI",Hawaii,"Boston, MA",Massachusetts,1541,1201,-10,-15,1531,1186,5,10,1536,1176,1517,191,211,206,0,,0,0.0,0.0,0.0,0.0,0.0
2024,3,22,5,2024-03-22,MQ,1073,LAS,ATL,"Las Vegas, NV",Nevada,"Atlanta, GA",Georgia,1953,1630,-2,5,1951,1635,11,6,1962,1629,1409,178,198,195,0,,0,0.0,0.0,0.0,0.0,0.0
2024,8,19,1,2024-08-19,MQ,4124,ORD,IAH,"Chicago, IL",Illinois,"Houston, TX",Texas,927,1886,11,15,938,1901,15,6,953,1895,2310,294,314,315,0,,0,0.0,0.0,0.0,0.0,0.0
2024,8,14,3,2024-08-14,F9,9734,DTW,IAD,"Detroit, MI",Michigan,"Washington, DC",District of Columbia,1413,1603,0,0,1413,1603,22,5,1435,1598,375,40,60,67,0,,0,0.0,0.0,0.0,0.0,0.0
2024,8,20,2,2024-08-20,UA,6715,MIA,BWI,"Miami, FL",Florida,"Baltimore, MD",Maryland,792,1233,14,5,806,1238,26,18,832,1220,521,69,89,113,0,,0,0.0,0.0,0.0,0.0,0.0
2024,8,8,4,2024-08-08,NK,4429,JFK,MDW,"New York, NY",New York,"Chicago, IL",Illinois,1079,2299,11,5,1090,2304,29,10,1119,2294,2094,255,275,294,1,,0,0.0,0.0,0.0,0.0,0.0
2024,2,11,7,2024-02-11,YX,6815,STL,BOS,"St. Louis, MO",Missouri,"Boston, MA",Massachusetts,2272,1227,-2,-10,2270,1217,9,8,2279,1209,2438,312,332,329,0,,0,0.0,0.0,0.0,0.0,0.0
2024,1,21,7,2024-01-21,AA,1577,SEA,PHX,"Seattle, WA",Washington,"Phoenix, AZ",Arizona,1603,1124,-1,0,1602,1124,9,15,1611,1109,2946,359,379,383,0,,0,0.0,0.0,0.0,0.0,0.0
2024,2,11,7,2024-02-11,OH,5789,DFW,PHL,"Dallas/Fort Worth, TX",Texas,"Philadelphia, PA",Pennsylvania,1609,1562,-1,-5,1608,1557,24,18,1632,1539,2184,271,291,313,0,,0,0.0,0.0,0.0,0.0,0.0
2024,4,22,1,2024-04-22,HA,9062,PHL,TPA,"Philadelphia, PA",Pennsylvania,"Tampa, FL",Florida,2095,1643,-15,-10,2080,1633,21,11,2101,1622,1033,129,149,161,0,,0,0.0,0.0,0.0,0.0,0.0
2024,4,14,7,2024-04-14,YX,7429,SFO,TPA,"San Francisco, CA",California,"Tampa, FL",Florida,547,2336,-8,-10,539,2326,8,4,547,2322,1340,163,183,175,0,,0,0.0,0.0,0.0,0.0,0.0
2024,7,10,3,2024-07-10,AS,6544,BOS,CLT,"Boston, MA",Massachusetts,"Charlotte, NC",North Carolina,2214,853,-8,0,2206,853,13,8,2219,845,2104,271,291,292,0,,0,0.0,0.0,0.0,0.0,0.0
2024,1,17,3,2024-01-17,YX,8597,LGA,SEA,"New York, NY",New York,"Seattle, WA",Washington,583,1197,2,5,585,1202,18,16,603,1186,2555,309,329,343,0,,0,0.0,0.0,0.0,0.0,0.0
2024,4,29,1,2024-04-29,YX,101,CLT,SFO,"Charlotte, NC",North Carolina,"San Francisco, CA",California,1106,1803,6,10,1112,1813,13,19,1125,1794,534,73,93,105,1,,0,0.0,0.0,0.0,0.0,0.0
2024,5,8,3,2024-05-08,MQ,8562,MCO,MSP,"Orlando, FL",Florida,"Minneapolis, MN",Minnesota,807,1976,-11,-5,796,1971,27,17,823,1954,573,66,86,110,0,,0,0.0,0.0,0.0,0.0,0.0
2024,5,9,4,2024-05-09,G4,6943,CLT,BWI,"Charlotte, NC",North Carolina,"Baltimore, MD",Maryland,751,1172,2,-5,753,1167,17,7,770,1160,2242,285,305,309,0,,0,0.0,0.0,0.0,0.0,0.0
2024,2,29,4,2024-02-29,YX,9155,BWI,DTW,"Baltimore, MD",Maryland,"Detroit, MI",Michigan,2004,2350,10,5,2014,2355,20,4,2034,2351,2568,312,332,336,0,,0,0.0,0.0,0.0,0.0,0.0
2024,2,17,6,2024-02-17,UA,6072,DCA,EWR,"Washington, DC",District of Columbia,"Newark, NJ",New Jersey,679,1492,3,5,682,1497,24,14,706,1483,2917,362,382,400,0,,0,0.0,0.0,0.0,0.0,0.0
2024,1,29,1,2024-01-29,OH,8003,DEN,ORD,"Denver, CO",Colorado,"Chicago, IL",Illinois,2119,814,-10,-10,2109,804,17,7,2126,797,627,77,97,101,0,,0,0.0,0.0,0.0,0.0,0.0
2024,4,6,6,2024-04-06,NK,5205,LGA,JFK,"New York, NY",New York,"New York, NY",New York,1833,1981,-2,-10,1831,1971,13,3,1844,1968,319,45,65,61,0,,0,0.0,0.0,0.0,0.0,0.0
2024,1,10,3,2024-01-10,MQ,7802,CLT,HNL,"Charlotte, NC",North Carolina,"Honolulu, HI",Hawaii,925,1483,3,0,928,1483,25,4,953,1479,1186,141,161,170,0,,0,0.0,0.0,0.0,0.0,0.0
2024,8,29,4,2024-08-29,AS,3014,DTW,MIA,"Detroit, MI",Michigan,"Miami, FL",Florida,2009,1201,-9,-5,2000,1196,16,3,2016,1193,1304,172,192,191,0,,0,0.0,0.0,0.0,0.0,0.0
2024,11,9,6,2024-11-09,F9,5256,HNL,LAX,"Honolulu, HI",Hawaii,"Los Angeles, CA",California,2185,2231,6,5,2191,2236,16,13,2207,2223,2543,320,340,349,0,,0,0.0,0.0,0.0,0.0,0.0
2024,8,19,1,2024-08-19,UA,8398,SEA,DEN,"Seattle, WA",Washington,"Denver, CO",Colorado,538,2196,8,0,546,2196,14,4,560,2192,2847,361,381,379,0,,0,0.0,0.0,0.0,0.0,0.0
2024,10,3,4,2024-10-03,UA,3268,MDW,ORD,"Chicago, IL",Illinois,"Chicago, IL",Illinois,1802,1167,-18,-15,1784,1152,6,13,1790,1139,770,91,111,110,0,,0,0.0,0.0,0.0,0.0,0.0
2024,10,10,4,2024-10-10,WN,2699,STL,TPA,"St. Louis, MO",Missouri,"Tampa, FL",Florida,1315,1843,-16,-10,1299,1833,29,4,1328,1829,1565,193,213,226,0,,0,0.0,0.0,0.0,0.0,0.0
2024,7,21,7,2024-07-21,UA,5816,TPA,MSP,"Tampa, FL",Florida,"Minneapolis, MN",Minnesota,1124,1205,10,15,1134,1220,26,9,1160,1211,447,55,75,90,0,,0,0.0,0.0,0.0,0.0,0.0
2024,9,3,2,2024-09-03,G4,2335,ATL,SAN,"Atlanta, GA",Georgia,"San Diego, CA",California,875,1151,-10,-10,865,1141,9,9,874,1132,1588,195,215,213,0,,0,0.0,0.0,0.0,0.0,0.0
2024,10,16,3,2024-10-16,OO,2899,MIA,LAS,"Miami, FL",Florida,"Las Vegas, NV",Nevada,2162,936,-23,-15,2139,921,15,9,2154,912,290,40,60,64,0,,0,0.0,0.0,0.0,0.0,0.0
2024,9,20,5,2024-09-20,WN,7113,EWR,IAH,"Newark, NJ",New Jersey,"Houston, TX",Texas,540,918,5,5,545,923,28,4,573,919,2007,259,279,291,0,,0,0.0,0.0,0.0,0.0,0.0
2024,8,1,4,2024-08-01,AS,9803,ATL,MCO,"Atlanta, GA",Georgia,"Orlando, FL",Florida,2193,1065,6,5,2199,1070,6,18,2205,1052,246,25,45,49,0,,0,0.0,0.0,0.0,0.0,0.0
2024,7,18,4,2024-07-18,F9,5573,ATL,DFW,"Atlanta, GA",Georgia,"Dallas/Fort Worth, TX",Texas,2241,1328,-10,0,2231,1328,25,5,2256,1323,1429,184,204,214,0,,0,0.0,0.0,0.0,0.0,0.0
2024,3,19,2,2024-03-19,OO,118,HNL,BOS,"Honolulu, HI",Hawaii,"Boston, MA",Massachusetts,546,1499,-7,0,539,1499,14,4,553,1495,523,61,81,79,0,,0,0.0,0.0,0.0,0.0,0.0
2024,12,8,7,2024-12-08,MQ,958,PHL,LAX,"Philadelphia, PA",Pennsylvania,"Los Angeles, CA",California,2007,1777,29,20,2036,1797,12,7,2048,1790,1083,135,155,154,0,,0,6.0,5.0,2.0,0.0,7.0
2024,12,9,1,2024-12-09,F9,9708,MSP,BWI,"Minneapolis, MN",Minnesota,"Baltimore, MD",Maryland,684,950,-25,-15,659,935,24,5,683,930,2079,255,275,284,0,,0,0.0,0.0,0.0,0.0,0.0
2024,6,21,5,2024-06-21,HA,5480,LAS,MIA,"Las Vegas, NV",Nevada,"Miami, FL",Florida,571,1685,-5,0,566,1685,14,8,580,1677,788,92,112,114,0,,0,0.0,0.0,0.0,0.0,0.0
2024,3,9,6,2024-03-09,B6,3132,DCA,MCO,"Washington, DC",District of Columbia,"Orlando, FL",Florida,1068,2083,-9,0,1059,2083,15,7,1074,2076,1327,170,190,192,0,,0,0.0,0.0,0.0,0.0,0.0
2024,3,27,3,2024-03-27,B6,4605,CLT,SAN,"Charlotte, NC",North Carolina,"San Diego, CA",California,2274,1549,-18,-20,2256,1529,13,10,2269,1519,1857,233,253,256,0,,0,0.0,0.0,0.0,0.0,0.0
2024,4,10,3,2024-04-10,AS,9718,MSP,DCA,"Minneapolis, MN",Minnesota,"Washington, DC",District of Columbia,1073,1863,0,-5,1073,1858,11,15,1084,1843,684,86,106,112,0,,0,0.0,0.0,0.0,0.0,0.0
2024,1,8,1,2024-01-08,9E,5889,ATL,HNL,"Atlanta, GA",Georgia,"Honolulu, HI",Hawaii,841,789,5,5,846,794,16,4,862,790,399,41,61,61,0,,0,0.0,0.0,0.0,0.0,0.0
2024,11,28,4,2024-11-28,NK,2631,SLC,BWI,"Salt Lake City, UT",Utah,"Baltimore, MD",Maryland,1068,1769,3,0,1071,1769,11,15,1082,1754,1518,195,215,221,0,,0,0.0,0.0,0.0,0.0,0.0
2024,7,18,4,2024-07-18,MQ,7571,MCO,IAH,"Orlando, FL",Florida,"Houston, TX",Texas,1463,2145,5,10,1468,2155,20,19,1488,2136,2513,307,327,346,0,,0,0.0,0.0,0.0,0.0,0.0
2024,3,27,3,2024-03-27,MQ,4819,PHX,LAX,"Phoenix, AZ",Arizona,"Los Angeles, CA",California,1766,1915,5,0,1771,1915,29,8,1800,1907,2714,334,354,371,0,,0,0.0,0.0,0.0,0.0,0.0
2024,2,12,1,2024-02-12,9E,4963,BOS,BWI,"Boston, MA",Massachusetts,"Baltimore, MD",Maryland,827,2265,11,5,838,2270,23,4,861,2266,950,125,145,152,0,,0,0.0,0.0,0.0,0.0,0.0
2024,4,18,4,2024-04-18,OH,4138,DEN,SFO,"Denver, CO",Colorado,"San Francisco, CA",California,2159,1683,9,10,2168,1693,20,14,2188,1679,2380,302,322,336,0,,0,0.0,0.0,0.0,0.0,0.0
2024,5,31,5,2024-05-31,NK,2552,BOS,PDX,"Boston, MA",Massachusetts,"Portland, OR",Oregon,652,2096,7,5,659,2101,19,18,678,2083,2509,317,337,354,0,,0,0.0,0.0,0.0,0.0,0.0
2024,1,17,3,2024-01-17,MQ,2946,CLT,BOS,"Charlotte, NC",North Carolina,"Boston, MA",Massachusetts,1778,1286,7,5,1785,1291,18,6,1803,1285,1027,119,139,143,0,,0,0.0,0.0,0.0,0.0,0.0
2024,5,12,7,2024-05-12,WN,8164,MDW,IAH,"Chicago, IL",Illinois,"Houston, TX",Texas,1228,672,-4,5,1224,677,17,18,1241,659,1069,136,156,171,0,,0,0.0,0.0,0.0,0.0,0.0
2024,5,27,1,2024-05-27,AS,6722,MSP,DTW,"Minneapolis, MN",Minnesota,"Detroit, MI",Michigan,1947,1862,-10,0,1937,1862,7,15,1944,1847,300,42,62,64,1,,0,0.0,0.0,0.0,0.0,0.0
2024,10,3,4,2024-10-03,NK,8996,EWR,STL,"Newark, NJ",New Jersey,"St. Louis, MO",Missouri,731,1015,-10,0,721,1015,17,16,738,999,1150,135,155,168,0,,0,0.0,0.0,0.0,0.0,0.0
2024,8,19,1,2024-08-19,B6,9633,LGA,DCA,"New York, NY",New York,"Washington, DC",District of Columbia,2052,778,-14,-10,2038,768,11,11,2049,757,833,102,122,124,0,,0,0.0,0.0,0.0,0.0,0.0
2024,11,9,6,2024-11-09,B6,3562,STL,LAX,"St. Louis, MO",Missouri,"Los Angeles, CA",California,2115,1690,12,10,2127,1700,6,14,2133,1686,1690,204,224,224,0,,0,0.0,0.0,0.0,0.0,0.0
2024,8,15,4,2024-08-15,DL,1259,SAN,ATL,"San Diego, CA",California,"Atlanta, GA",Georgia,2019,2216,1,-5,2020,2211,14,16,2034,2195,1713,214,234,244,0,,0,0.0,0.0,0.0,0.0,0.0
2024,5,18,6,2024-05-18,NK,4726,BWI,LGA,"Baltimore, MD",Maryland,"New York, NY",New York,675,676,-2,0,673,676,19,13,692,663,2674,330,350,362,0,,0,0.0,0.0,0.0,0.0,0.0
2024,7,29,1,2024-07-29,YX,7156,DEN,IAD,"Denver, CO",Colorado,"Washington, DC",District of Columbia,1050,847,-8,-10,1042,837,7,12,1049,825,921,111,131,130,0,,0,0.0,0.0,0.0,0.0,0.0
2024,1,28,7,2024-01-28,AS,3822,BWI,LGA,"Baltimore, MD",Maryland,"New York, NY",New York,642,1306,10,5,652,1311,10,9,662,1302,454,58,78,77,0,,0,0.0,0.0,0.0,0.0,0.0
2024,2,20,2,2024-02-20,OO,3660,SLC,DTW,"Salt Lake City, UT",Utah,"Detroit, MI",Michigan,516,1587,14,20,530,1607,29,8,559,1599,1580,193,213,230,0,,0,0.0,1.0,0.0,0.0,19.0
2024,9,17,2,2024-09-17,AA,6217,STL,IAD,"St. Louis, MO",Missouri,"Washington, DC",District of Columbia,748,667,6,10,754,677,18,19,772,658,1411,175,195,212,0,,0,0.0,0.0,0.0,0.0,0.0
2024,9,17,2,2024-09-17,WN,6689,MSP,IAD,"Minneapolis, MN",Minnesota,"Washington, DC",District of Columbia,1558,1449,-10,0,1548,1449,8,15,1556,1434,637,83,103,106,0,,0,0.0,0.0,0.0,0.0,0.0
2024,12,15,7,2024-12-15,UA,6949,MIA,SLC,"Miami, FL",Florida,"Salt Lake City, UT",Utah,1300,2191,-3,0,1297,2191,19,17,1316,2174,2712,339,359,375,0,,0,0.0,0.0,0.0,0.0,0.0
2024,12,17,2,2024-12-17,YX,2343,BOS,STL,"Boston, MA",Massachusetts,"St. Louis, MO",Missouri,1499,1722,-5,0,1494,1722,9,6,1503,1716,1894,238,258,253,0,,0,0.0,0.0,0.0,0.0,0.0
2024,1,8,1,2024-01-08,HA,8277,MIA,CLT,"Miami, FL",Florida,"Charlotte, NC",North Carolina,1498,1187,-9,-10,1489,1177,10,5,1499,1172,924,110,130,125,0,,0,0.0,0.0,0.0,0.0,0.0
2024,11,15,5,2024-11-15,UA,1860,DCA,LAX,"Washington, DC",District of Columbia,"Los Angeles, CA",California,645,1442,-14,-5,631,1437,23,13,654,1424,1156,137,157,173,0,,0,0.0,0.0,0.0,0.0,0.0
2024,5,17,5,2024-05-17,NK,5542,HNL,SLC,"Honolulu, HI",Hawaii,"Salt Lake City, UT",Utah,1425,2201,-15,-5,1410,2196,22,4,1432,2192,791,98,118,124,0,,0,0.0,0.0,0.0,0.0,0.0
2024,2,7,3,2024-02-07,OO,7779,MDW,LAS,"Chicago, IL",Illinois,"Las Vegas, NV",Nevada,1226,2168,19,15,1245,2183,24,13,1269,2170,2320,299,319,336,0,,0,0.0,0.0,0.0,0.0,0.0
2024,4,20,6,2024-04-20,YX,2775,HNL,MSP,"Honolulu, HI",Hawaii,"Minneapolis, MN",Minnesota,664,1380,1,-5,665,1375,10,6,675,1369,2362,293,313,309,0,,0,0.0,0.0,0.0,0.0,0.0
2024,8,7,3,2024-08-07,9E,7224,MIA,HNL,"Miami, FL",Florida,"Honolulu, HI",Hawaii,1634,2165,9,0,1643,2165,8,19,1651,2146,1326,159,179,186,0,,0,0.0,0.0,0.0,0.0,0.0
2024,12,2,1,2024-12-02,WN,5881,DFW,DEN,"Dallas/Fort Worth, TX",Texas,"Denver, CO",Colorado,1146,2161,7,15,1153,2176,16,19,1169,2157,1758,217,237,252,0,,0,0.0,0.0,0.0,0.0,0.0
2024,8,10,6,2024-08-10,HA,3336,IAD,PDX,"Washington, DC",District of Columbia,"Portland, OR",Oregon,1597,1481,-5,0,1592,1481,28,19,1620,1462,1019,125,145,172,0,,0,0.0,0.0,0.0,0.0,0.0
2024,5,15,3,2024-05-15,YX,5998,IAD,SEA,"Washington, DC",District of Columbia,"Seattle, WA",Washington,1167,1321,-5,-10,1162,1311,29,15,1191,1296,458,58,78,102,0,,0,0.0,0.0,0.0,0.0,0.0
2024,9,12,4,2024-09-12,F9,8335,DTW,SFO,"Detroit, MI",Michigan,"San Francisco, CA",California,2250,923,-6,-5,2244,918,28,15,2272,903,2936,375,395,418,0,,0,0.0,0.0,0.0,0.0,0.0
2024,12,25,3,2024-12-25,OO,8780,LAX,STL,"Los Angeles, CA",California,"St. Louis, MO",Missouri,853,1746,-3,-5,850,1741,18,5,868,1736,347,44,64,67,0,,0,0.0,0.0,0.0,0.0,0.0
2024,11,24,7,2024-11-24,G4,4376,EWR,PHL,"Newark, NJ",New Jersey,"Philadelphia, PA",Pennsylvania,1797,1656,2,5,1799,1661,11,12,1810,1649,2277,276,296,299,0,,0,0.0,0.0,0.0,0.0,0.0
2024,2,18,7,2024-02-18,UA,4823,CLT,ATL,"Charlotte, NC",North Carolina,"Atlanta, GA",Georgia,1442,1254,-4,-10,1438,1244,6,18,1444,1226,2663,325,345,349,0,,0,0.0,0.0,0.0,0.0,0.0
2024,10,18,5,2024-10-18,B6,9248,LAX,IAH,"Los Angeles, CA",California,"Houston, TX",Texas,1802,744,1,5,1803,749,6,3,1809,746,2829,361,381,370,0,,0,0.0,0.0,0.0,0.0,0.0
2024,11,19,2,2024-11-19,WN,5744,SEA,TPA,"Seattle, WA",Washington,"Tampa, FL",Florida,2183,1373,4,10,2187,1383,25,7,2212,1376,2662,339,359,371,0,,0,0.0,0.0,0.0,0.0,0.0
2024,3,18,1,2024-03-18,OH,1215,IAH,LGA,"Houston, TX",Texas,"New York, NY",New York,1554,2140,-8,-5,1546,2135,24,3,1570,2132,1111,139,159,166,0,,0,0.0,0.0,0.0,0.0,0.0
2024,4,14,7,2024-04-14,YX,1881,IAD,DCA,"Washington, DC",District of Columbia,"Washington, DC",District of Columbia,1025,2296,-25,-15,1000,2281,8,18,1008,2263,477,62,82,88,0,,0,0.0,0.0,0.0,0.0,0.0
2024,6,17,1,2024-06-17,9E,8942,SEA,DCA,"Seattle, WA",Washington,"Washington, DC",District of Columbia,2058,909,-9,0,2049,909,24,13,2073,896,1903,232,252,269,0,,0,0.0,0.0,0.0,0.0,0.0
2024,8,4,7,2024-08-04,HA,1976,MSP,DEN,"Minneapolis, MN",Minnesota,"Denver, CO",Colorado,1009,743,-12,-5,997,738,27,6,1024,732,1123,144,164,177,0,,0,0.0,0.0,0.0,0.0,0.0
2024,4,28,7,2024-04-28,AS,5463,ORD,DTW,"Chicago, IL",Illinois,"Detroit, MI",Michigan,2037,1541,-10,0,2027,1541,7,7,2034,1534,1686,218,238,232,0,,0,0.0,0.0,0.0,0.0,0.0
2024,7,8,1,2024-07-08,OO,8632,DFW,SEA,"Dallas/Fort Worth, TX",Texas,"Seattle, WA",Washington,677,1263,-1,0,676,1263,6,18,682,1245,1308,161,181,185,0,,0,0.0,0.0,0.0,0.0,0.0
2024,9,11,3,2024-09-11,9E,3475,JFK,LGA,"New York, NY",New York,"New York, NY",New York,828,1492,-13,-5,815,1487,25,14,840,1473,1103,142,162,181,0,,0,0.0,0.0,0.0,0.0,0.0
2024,9,22,7,2024-09-22,WN,2850,DTW,IAD,"Detroit, MI",Michigan,"Washington, DC",District of Columbia,2094,1116,6,15,2100,1131,10,14,2110,1117,2312,284,304,308,0,,0,0.0,0.0,0.0,0.0,0.0
2024,5,28,2,2024-05-28,F9,9646,ORD,DTW,"Chicago, IL",Illinois,"Detroit, MI",Michigan,1300,794,-9,-5,1291,789,18,6,1309,783,2405,294,314,318,0,,0,0.0,0.0,0.0,0.0,0.0
2024,6,12,3,2024-06-12,UA,3376,SAN,LAS,"San Diego, CA",California,"Las Vegas, NV",Nevada,1187,2106,-14,-5,1173,2101,12,19,1185,2082,2177,272,292,303,0,,0,0.0,0.0,0.0,0.0,0.0
2024,5,19,7,2024-05-19,OO,548,SLC,PHL,"Salt Lake City, UT",Utah,"Philadelphia, PA",Pennsylvania,1695,2260,5,10,1700,2270,15,11,1715,2259,1481,176,196,202,0,,0,0.0,0.0,0.0,0.0,0.0
2024,12,12,4,2024-12-12,B6,5637,SEA,SAN,"Seattle, WA",Washington,"San Diego, CA",California,1919,2098,-18,-15,1901,2083,23,8,1924,2075,1656,204,224,235,0,,0,0.0,0.0,0.0,0.0,0.0
2024,9,14,6,2024-09-14,MQ,4272,DTW,DFW,"Detroit, MI",Michigan,"Dallas/Fort Worth, TX",Texas,2118,2211,-23,-15,2095,2196,19,10,2114,2186,1676,217,237,246,0,,0,0.0,0.0,0.0,0.0,0.0
2024,9,25,3,2024-09-25,AA,9089,PHX,SAN,"Phoenix, AZ",Arizona,"San Diego, CA",California,1437,1417,23,15,1460,1432,24,10,1484,1422,979,121,141,155,0,,0,0.0,0.0,0.0,0.0,0.0
2024,6,29,6,2024-06-29,MQ,3596,DTW,LAX,"Detroit, MI",Michigan,"Los Angeles, CA",California,1479,1792,-12,-10,1467,1782,24,10,1491,1772,2508,322,342,356,0,,0,0.0,0.0,0.0,0.0,0.0
2024,6,8,6,2024-06-08,HA,2282,ORD,LGA,"Chicago, IL",Illinois,"New York, NY",New York,1234,1328,-25,-15,1209,1313,24,10,1233,1303,1961,253,273,287,0,,0,0.0,0.0,0.0,0.0,0.0
2024,12,16,1,2024-12-16,AS,3426,IAH,SAN,"Houston, TX",Texas,"San Diego, CA",California,1558,1806,-3,0,1555,1806,27,17,1582,1789,2773,338,358,382,0,,0,0.0,0.0,0.0,0.0,0.0
2024,10,14,1,2024-10-14,OO,8937,SFO,JFK,"San Francisco, CA",California,"New York, NY",New York,796,1736,-25,-20,771,1716,24,16,795,1700,403,41,61,81,0,,0,0.0,0.0,0.0,0.0,0.0
2024,10,14,1,2024-10-14,B6,819,PHX,ATL,"Phoenix, AZ",Arizona,"Atlanta, GA",Georgia,1992,1899,-9,0,1983,1899,18,8,2001,1891,2825,361,381,387,0,,0,0.0,0.0,0.0,0.0,0.0
2024,8,13,2,2024-08-13,F9,1622,MCO,DTW,"Orlando, FL",Florida,"Detroit, MI",Michigan,2018,1075,3,0,2021,1075,27,12,2048,1063,2804,350,370,389,0,,0,0.0,0.0,0.0,0.0,0.0
2024,1,11,4,2024-01-11,G4,6856,ATL,MSP,"Atlanta, GA",Georgia,"Minneapolis, MN",Minnesota,1121,1801,-10,0,1111,1801,8,10,1119,1791,1674,202,222,220,0,,0,0.0,0.0,0.0,0.0,0.0
2024,1,10,3,2024-01-10,F9,6727,LAX,SFO,"Los Angeles, CA",California,"San Francisco, CA",California,1758,2260,-14,-10,1744,2250,14,12,1758,2238,2561,321,341,347,0,,0,0.0,0.0,0.0,0.0,0.0
2024,9,27,5,2024-09-27,F9,1169,LAS,IAH,"Las Vegas, NV",Nevada,"Houston, TX",Texas,1408,1914,15,15,1423,1929,12,10,1435,1919,2864,356,376,378,0,,0,0.0,0.0,0.0,0.0,0.0
2024,9,29,7,2024-09-29,YX,5662,MCO,DFW,"Orlando, FL",Florida,"Dallas/Fort Worth, TX",Texas,1562,1033,-5,-10,1557,1023,9,5,1566,1018,2865,363,383,377,0,,0,0.0,0.0,0.0,0.0,0.0
2024,7,1,1,2024-07-01,OH,7849,SFO,MDW,"San Francisco, CA",California,"Chicago, IL",Illinois,1742,2086,-9,0,1733,2086,22,6,1755,2080,2228,274,294,302,0,,0,0.0,0.0,0.0,0.0,0.0
2024,6,1,6,2024-06-01,MQ,4987,TPA,DCA,"Tampa, FL",Florida,"Washington, DC",District of Columbia,1740,1016,22,15,1762,1031,29,13,1791,1018,2080,253,273,295,0,,0,0.0,0.0,0.0,0.0,0.0
2024,11,10,7,2024-11-10,UA,4774,MCO,PDX,"Orlando, FL",Florida,"Portland, OR",Oregon,1205,1310,3,-5,1208,1305,29,15,1237,1290,2488,305,325,349,0,,0,0.0,0.0,0.0,0.0,0.0
2024,11,29,5,2024-11-29,WN,2256,DEN,SFO,"Denver, CO",Colorado,"San Francisco, CA",California,2198,737,-11,-10,2187,727,21,5,2208,722,706,94,114,120,0,,0,0.0,0.0,0.0,0.0,0.0
2024,5,3,5,2024-05-03,HA,8044,STL,MSP,"St. Louis, MO",Missouri,"Minneapolis, MN",Minnesota,1127,2112,-22,-15,1105,2097,9,7,1114,2090,2251,281,301,297,0,,0,0.0,0.0,0.0,0.0,0.0
2024,4,23,2,2024-04-23,OO,4239,BWI,IAD,"Baltimore, MD",Maryland,"Washington, DC",District of Columbia,1172,2353,12,20,1184,2373,7,14,1191,2359,2686,328,348,349,0,,0,3.0,3.0,3.0,0.0,11.0
2024,10,4,5,2024-10-04,WN,5729,BOS,ATL,"Boston, MA",Massachusetts,"Atlanta, GA",Georgia,2124,1408,7,5,2131,1413,14,14,2145,1399,1873,241,261,269,1,,0,0.0,0.0,0.0,0.0,0.0
2024,7,31,3,2024-07-31,HA,7187,DEN,ATL,"Denver, CO",Colorado,"Atlanta, GA",Georgia,919,1791,10,15,929,1806,25,14,954,1792,2624,326,346,365,0,,0,0.0,0.0,0.0,0.0,0.0
2024,6,20,4,2024-06-20,HA,5178,DFW,STL,"Dallas/Fort Worth, TX",Texas,"St. Louis, MO",Missouri,1152,733,4,5,1156,738,8,12,1164,726,1267,155,175,175,0,,0,0.0,0.0,0.0,0.0,0.0
2024,10,14,1,2024-10-14,OH,6505,IAD,MSP,"Washington, DC",District of Columbia,"Minneapolis, MN",Minnesota,1323,1784,-8,-5,1315,1779,23,9,1338,1770,1944,239,259,271,0,,0,0.0,0.0,0.0,0.0,0.0
2024,6,22,6,2024-06-22,OO,6971,PHL,ORD,"Philadelphia, PA",Pennsylvania,"Chicago, IL",Illinois,1697,1383,-16,-15,1681,1368,27,5,1708,1363,1160,152,172,184,0,,0,0.0,0.0,0.0,0.0,0.0
2024,4,22,1,2024-04-22,B6,732,DCA,JFK,"Washington, DC",District of Columbia,"New York, NY",New York,1212,1391,6,15,1218,1406,9,7,1227,1399,261,23,43,39,0,,0,0.0,0.0,0.0,0.0,0.0
2024,5,1,3,2024-05-01,MQ,2299,SAN,PDX,"San Diego, CA",California,"Portland, OR",Oregon,1366,1333,9,0,1375,1333,5,14,1380,1319,2221,277,297,296,0,,0,0.0,0.0,0.0,0.0,0.0
2024,2,1,4,2024-02-01,G4,5453,SLC,PHL,"Salt Lake City, UT",Utah,"Philadelphia, PA",Pennsylvania,1313,976,-1,-5,1312,971,8,16,1320,955,549,66,86,90,0,,0,0.0,0.0,0.0,0.0,0.0
2024,8,9,5,2024-08-09,YX,3010,SFO,SAN,"San Francisco, CA",California,"San Diego, CA",California,1367,1953,-10,0,1357,1953,5,15,1362,1938,204,27,47,47,0,,0,0.0,0.0,0.0,0.0,0.0
2024,4,28,7,2024-04-28,G4,722,MCO,IAD,"Orlando, FL",Florida,"Washington, DC",District of Columbia,612,994,-15,-15,597,979,19,11,616,968,2291,292,312,322,0,,0,0.0,0.0,0.0,0.0,0.0
2024,2,8,4,2024-02-08,9E,6173,HNL,JFK,"Honolulu, HI",Hawaii,"New York, NY",New York,1439,1795,-15,-5,1424,1790,7,12,1431,1778,2642,336,356,355,0,,0,0.0,0.0,0.0,0.0,0.0
2024,9,24,2,2024-09-24,MQ,460,LGA,LAX,"New York, NY",New York,"Los Angeles, CA",California,673,1069,5,0,678,1069,14,3,692,1066,1724,214,234,231,0,,0,0.0,0.0,0.0,0.0,0.0
2024,8,20,2,2024-08-20,YX,6465,PHX,LAX,"Phoenix, AZ",Arizona,"Los Angeles, CA",California,1510,1370,-14,-15,1496,1355,9,8,1505,1347,1296,157,177,174,0,,1,0.0,0.0,0.0,0.0,0.0
2024,1,18,4,2024-01-18,OH,8501,DFW,MCO,"Dallas/Fort Worth, TX",Texas,"Orlando, FL",Florida,573,2045,-14,-15,559,2030,26,8,585,2022,374,41,61,75,0,,0,0.0,0.0,0.0,0.0,0.0
2024,5,28,2,2024-05-28,AA,9222,JFK,MCO,"New York, NY",New York,"Orlando, FL",Florida,1136,1879,8,0,1144,1879,15,4,1159,1875,213,30,50,49,0,,0,0.0,0.0,0.0,0.0,0.0
2024,5,28,2,2024-05-28,OH,4043,MSP,MDW,"Minneapolis, MN",Minnesota,"Chicago, IL",Illinois,2059,2303,2,0,2061,2303,21,18,2082,2285,1242,155,175,194,0,,0,0.0,0.0,0.0,0.0,0.0
2024,5,5,7,2024-05-05,OH,4969,DFW,BOS,"Dallas/Fort Worth, TX",Texas,"Boston, MA",Massachusetts,531,1743,-13,-10,518,1733,13,7,531,1726,1748,227,247,247,0,,0,0.0,0.0,0.0,0.0,0.0
2024,10,28,1,2024-10-28,F9,8228,ORD,SFO,"Chicago, IL",Illinois,"San Francisco, CA",California,1777,618,-29,-20,1748,598,17,16,1765,582,777,100,120,133,0,,0,0.0,0.0,0.0,0.0,0.0
2024,12,25,3,2024-12-25,OH,977,ORD,LGA,"Chicago, IL",Illinois,"New York, NY",New York,996,1407,28,20,1024,1427,18,18,1042,1409,2439,298,318,334,0,,0,2.0,3.0,2.0,0.0,13.0
2024,8,25,7,2024-08-25,AA,4895,SAN,DEN,"San Diego, CA",California,"Denver, CO",Colorado,1636,846,-17,-20,1619,826,13,11,1632,815,1890,230,250,254,0,,0,0.0,0.0,0.0,0.0,0.0
2024,5,14,2,2024-05-14,DL,7891,TPA,JFK,"Tampa, FL",Florida,"New York, NY",New York,694,1828,-30,-20,664,1808,21,13,685,1795,526,55,75,89,0,,0,0.0,0.0,0.0,0.0,0.0
2024,5,30,4,2024-05-30,NK,2623,DCA,SLC,"Washington, DC",District of Columbia,"Salt Lake City, UT",Utah,1027,2043,-7,-5,1020,2038,11,18,1031,2020,806,109,129,138,0,,0,0.0,0.0,0.0,0.0,0.0
2024,8,23,5,2024-08-23,HA,6370,CLT,PHL,"Charlotte, NC",North Carolina,"Philadelphia, PA",Pennsylvania,940,1690,-2,-10,938,1680,20,14,958,1666,2618,335,355,369,0,,0,0.0,0.0,0.0,0.0,0.0
2024,8,11,7,2024-08-11,F9,8683,BOS,MSP,"Boston, MA",Massachusetts,"Minneapolis, MN",Minnesota,2012,941,3,0,2015,941,24,17,2039,924,868,112,132,153,0,,0,0.0,0.0,0.0,0.0,0.0
2024,7,21,7,2024-07-21,AA,6723,DFW,IAH,"Dallas/Fort Worth, TX",Texas,"Houston, TX",Texas,2020,944,3,10,2023,954,17,7,2040,947,2051,256,276,280,0,,0,0.0,0.0,0.0,0.0,0.0
2024,9,12,4,2024-09-12,HA,5188,IAH,SFO,"Houston, TX",Texas,"San Francisco, CA",California,1223,1523,-9,0,1214,1523,18,19,1232,1504,1138,148,168,185,0,,0,0.0,0.0,0.0,0.0,0.0
2024,3,26,2,2024-03-26,UA,7664,STL,ORD,"St. Louis, MO",Missouri,"Chicago, IL",Illinois,2143,2320,4,5,2147,2325,22,10,2169,2315,2252,272,292,304,0,,0,0.0,0.0,0.0,0.0,0.0
2024,5,29,3,2024-05-29,NK,7166,JFK,MCO,"New York, NY",New York,"Orlando, FL",Florida,523,986,19,15,542,1001,15,3,557,998,2706,329,349,347,0,,0,0.0,0.0,0.0,0.0,0.0
2024,8,22,4,2024-08-22,MQ,6645,TPA,LAX,"Tampa, FL",Florida,"Los Angeles, CA",California,789,941,-20,-10,769,931,6,4,775,927,688,84,104,94,0,,0,0.0,0.0,0.0,0.0,0.0
2024,12,10,2,2024-12-10,G4,2421,MIA,ATL,"Miami, FL",Florida,"Atlanta, GA",Georgia,1395,707,0,0,1395,707,26,3,1421,704,1256,166,186,195,0,,0,0.0,0.0,0.0,0.0,0.0
2024,1,22,1,2024-01-22,F9,8249,LAS,STL,"Las Vegas, NV",Nevada,"St. Louis, MO",Missouri,807,1276,5,0,812,1276,10,11,822,1265,1230,161,181,182,0,,0,0.0,0.0,0.0,0.0,0.0
2024,12,13,5,2024-12-13,F9,8225,LGA,PDX,"New York, NY",New York,"Portland, OR",Oregon,803,1232,-3,-5,800,1227,9,3,809,1224,2001,243,263,255,0,,0,0.0,0.0,0.0,0.0,0.0
2024,10,11,5,2024-10-11,HA,8430,MDW,LGA,"Chicago, IL",Illinois,"New York, NY",New York,1130,1597,2,5,1132,1602,7,5,1139,1597,1472,184,204,196,0,,0,0.0,0.0,0.0,0.0,0.0
2024,9,25,3,2024-09-25,G4,8394,LAS,PHL,"Las Vegas, NV",Nevada,"Philadelphia, PA",Pennsylvania,2216,2025,3,5,2219,2030,11,18,2230,2012,2203,284,304,313,0,,0,0.0,0.0,0.0,0.0,0.0
2024,9,14,6,2024-09-14,9E,5433,MDW,LGA,"Chicago, IL",Illinois,"New York, NY",New York,1450,1195,-1,-5,1449,1190,7,13,1456,1177,1296,158,178,178,0,,1,0.0,0.0,0.0,0.0,0.0
2024,1,29,1,2024-01-29,UA,8775,ORD,DCA,"Chicago, IL",Illinois,"Washington, DC",District of Columbia,537,1925,-21,-15,516,1910,17,9,533,1901,2904,360,380,386,0,,0,0.0,0.0,0.0,0.0,0.0
2024,7,31,3,2024-07-31,F9,7958,PHX,HNL,"Phoenix, AZ",Arizona,"Honolulu, HI",Hawaii,885,1730,-11,-20,874,1710,27,15,901,1695,2229,280,300,322,0,,0,0.0,0.0,0.0,0.0,0.0
2024,10,9,3,2024-10-09,AA,4419,LAX,SFO,"Los Angeles, CA",California,"San Francisco, CA",California,1244,2258,2,-5,1246,2253,6,8,1252,2245,2302,288,308,302,0,,0,0.0,0.0,0.0,0.0,0.0
2024,2,19,1,2024-02-19,F9,5489,SFO,PHX,"San Francisco, CA",California,"Phoenix, AZ",Arizona,2104,1184,-24,-15,2080,1169,28,14,2108,1155,2632,335,355,377,0,,0,0.0,0.0,0.0,0.0,0.0
2024,4,4,4,2024-04-04,MQ,1948,JFK,CLT,"New York, NY",New York,"Charlotte, NC",North Carolina,581,1076,-1,5,580,1081,6,8,586,1073,2514,313,333,327,0,,0,0.0,0.0,0.0,0.0,0.0
2024,3,28,4,2024-03-28,NK,3305,DEN,HNL,"Denver, CO",Colorado,"Honolulu, HI",Hawaii,1641,936,4,-5,1645,931,22,4,1667,927,1624,208,228,234,0,,0,0.0,0.0,0.0,0.0,0.0
2024,2,13,2,2024-02-13,MQ,2261,DEN,SEA,"Denver, CO",Colorado,"Seattle, WA",Washington,549,2083,10,5,559,2088,8,3,567,2085,2048,259,279,270,0,,0,0.0,0.0,0.0,0.0,0.0
2024,10,4,5,2024-10-04,HA,1564,IAD,DCA,"Washington, DC",District of Columbia,"Washington, DC",District of Columbia,1168,912,0,-5,1168,907,21,9,1189,898,2499,304,324,334,0,,0,0.0,0.0,0.0,0.0,0.0
2024,6,19,3,2024-06-19,F9,743,EWR,SAN,"Newark, NJ",New Jersey,"San Diego, CA",California,573,1777,-2,5,571,1782,15,16,586,1766,2448,296,316,327,0,,0,0.0,0.0,0.0,0.0,0.0
2024,7,7,7,2024-07-07,AA,5451,DCA,MSP,"Washington, DC",District of Columbia,"Minneapolis, MN",Minnesota,1501,1208,19,10,1520,1218,11,6,1531,1212,764,86,106,103,0,,0,0.0,0.0,0.0,0.0,0.0
2024,12,18,3,2024-12-18,AS,4653,STL,SAN,"St. Louis, MO",Missouri,"San Diego, CA",California,1194,1972,10,10,1204,1982,6,18,1210,1964,290,26,46,50,0,,0,0.0,0.0,0.0,0.0,0.0
2024,7,2,2,2024-07-02,NK,6618,PHL,SAN,"Philadelphia, PA",Pennsylvania,"San Diego, CA",California,1629,1389,9,0,1638,1389,19,16,1657,1373,972,120,140,155,0,,0,0.0,0.0,0.0,0.0,0.0
2024,1,3,3,2024-01-03,OH,5823,MDW,DCA,"Chicago, IL",Illinois,"Washington, DC",District of Columbia,2224,1193,-10,-15,2214,1178,18,9,2232,1169,557,61,81,88,0,,0,0.0,0.0,0.0,0.0,0.0
2024,7,9,2,2024-07-09,OO,8046,ATL,PDX,"Atlanta, GA",Georgia,"Portland, OR",Oregon,2122,2152,-4,-5,2118,2147,18,6,2136,2141,2511,320,340,344,0,,0,0.0,0.0,0.0,0.0,0.0
2024,4,27,6,2024-04-27,B6,710,BWI,ATL,"Baltimore, MD",Maryland,"Atlanta, GA",Georgia,1849,899,-10,-5,1839,894,10,3,1849,891,2177,267,287,280,0,,0,0.0,0.0,0.0,0.0,0.0
2024,1,19,5,2024-01-19,OH,4402,LAX,BWI,"Los Angeles, CA",California,"Baltimore, MD",Maryland,1183,1291,25,20,1208,1311,9,9,1217,1302,1108,133,153,151,0,,0,6.0,0.0,2.0,0.0,12.0
2024,1,23,2,2024-01-23,B6,1643,IAD,LAX,"Washington, DC",District of Columbia,"Los Angeles, CA",California,2287,1327,8,0,2295,1327,18,18,2313,1309,1226,149,169,185,0,,0,0.0,0.0,0.0,0.0,0.0
2024,1,30,2,2024-01-30,NK,1566,DFW,TPA,"Dallas/Fort Worth, TX",Texas,"Tampa, FL",Florida,855,2157,0,0,855,2157,25,19,880,2138,1250,164,184,208,0,,0,0.0,0.0,0.0,0.0,0.0
2024,10,21,1,2024-10-21,HA,9208,HNL,PDX,"Honolulu, HI",Hawaii,"Portland, OR",Oregon,1991,835,6,5,1997,840,8,3,2005,837,249,26,46,37,0,,0,0.0,0.0,0.0,0.0,0.0
2024,4,17,3,2024-04-17,OO,6336,PDX,TPA,"Portland, OR",Oregon,"Tampa, FL",Florida,2179,1564,-7,0,2172,1564,18,18,2190,1546,2092,253,273,289,1,,0,0.0,0.0,0.0,0.0,0.0
2024,10,7,1,2024-10-07,HA,1281,PHL,PHX,"Philadelphia, PA",Pennsylvania,"Phoenix, AZ",Arizona,1807,1496,2,0,1809,1496,9,9,1818,1487,509,71,91,89,0,,0,0.0,0.0,0.0,0.0,0.0
2024,5,7,2,2024-05-07,UA,2246,LGA,PHX,"New York, NY",New York,"Phoenix, AZ",Arizona,1513,810,-19,-10,1494,800,16,9,1510,791,1092,131,151,156,0,,0,0.0,0.0,0.0,0.0,0.0
2024,8,16,5,2024-08-16,AS,2372,EWR,LAX,"Newark, NJ",New Jersey,"Los Angeles, CA",California,684,885,-7,-15,677,870,29,17,706,853,767,104,124,150,0,,0,0.0,0.0,0.0,0.0,0.0
2024,4,20,6,2024-04-20,NK,9143,LAS,PHX,"Las Vegas, NV",Nevada,"Phoenix, AZ",Arizona,653,1022,5,5,658,1027,17,4,675,1023,2395,290,310,311,0,,0,0.0,0.0,0.0,0.0,0.0
2024,5,15,3,2024-05-15,AA,4636,CLT,SAN,"Charlotte, NC",North Carolina,"San Diego, CA",California,1353,2342,0,10,1353,2352,16,15,1369,2337,2132,262,282,293,0,,0,0.0,0.0,0.0,0.0,0.0
2024,12,27,5,2024-12-27,YX,819,DFW,SFO,"Dallas/Fort Worth, TX",Texas,"San Francisco, CA",California,617,1093,-7,-5,610,1088,21,4,631,1084,827,97,117,122,0,,0,0.0,0.0,0.0,0.0,0.0
2024,7,4,4,2024-07-04,DL,4780,DCA,ATL,"Washington, DC",District of Columbia,"Atlanta, GA",Georgia,766,1617,-1,0,765,1617,22,19,787,1598,1857,231,251,272,0,,0,0.0,0.0,0.0,0.0,0.0
2024,5,23,4,2024-05-23,YX,3572,HNL,ATL,"Honolulu, HI",Hawaii,"Atlanta, GA",Georgia,1908,2042,-13,-5,1895,2037,16,4,1911,2033,1785,225,245,245,0,,0,0.0,0.0,0.0,0.0,0.0
2024,3,12,2,2024-03-12,WN,3742,ORD,SAN,"Chicago, IL",Illinois,"San Diego, CA",California,1336,1436,-3,0,1333,1436,27,17,1360,1419,305,39,59,83,0,,0,0.0,0.0,0.0,0.0,0.0
2024,5,8,3,2024-05-08,MQ,163,LAS,BOS,"Las Vegas, NV",Nevada,"Boston, MA",Massachusetts,754,1366,-5,-10,749,1356,13,16,762,1340,1563,189,209,218,0,,0,0.0,0.0,0.0,0.0,0.0
2024,12,29,7,2024-12-29,F9,659,MCO,IAH,"Orlando, FL",Florida,"Houston, TX",Texas,1764,944,-2,5,1762,949,23,18,1785,931,2530,317,337,358,0,,0,0.0,0.0,0.0,0.0,0.0
2024,9,17,2,2024-09-17,OO,7546,PDX,MCO,"Portland, OR",Oregon,"Orlando, FL",Florida,670,1122,0,0,670,1122,26,13,696,1109,2265,290,310,329,0,,0,0.0,0.0,0.0,0.0,0.0
2024,1,3,3,2024-01-03,MQ,1833,PHL,IAD,"Philadelphia, PA",Pennsylvania,"Washington, DC",District of Columbia,1116,1418,-3,0,1113,1418,25,14,1138,1404,2689,328,348,367,0,,0,0.0,0.0,0.0,0.0,0.0
2024,4,13,6,2024-04-13,OH,8961,SEA,CLT,"Seattle, WA",Washington,"Charlotte, NC",North Carolina,1501,918,-24,-20,1477,898,29,11,1506,887,2279,277,297,317,0,,0,0.0,0.0,0.0,0.0,0.0
2024,8,11,7,2024-08-11,9E,3994,SLC,PHX,"Salt Lake City, UT",Utah,"Phoenix, AZ",Arizona,1047,1965,9,0,1056,1965,19,9,1075,1956,1742,217,237,245,0,,0,0.0,0.0,0.0,0.0,0.0
2024,11,15,5,2024-11-15,AS,1642,STL,MCO,"St. Louis, MO",Missouri,"Orlando, FL",Florida,2101,2002,-6,-10,2095,1992,13,13,2108,1979,1642,213,233,239,0,,0,0.0,0.0,0.0,0.0,0.0
2024,12,27,5,2024-12-27,AA,9563,CLT,LGA,"Charlotte, NC",North Carolina,"New York, NY",New York,1708,2169,-8,-5,1700,2164,17,6,1717,2158,2427,295,315,318,0,,0,0.0,0.0,0.0,0.0,0.0
2024,12,19,4,2024-12-19,9E,2515,TPA,BOS,"Tampa, FL",Florida,"Boston, MA",Massachusetts,1201,2256,-6,-5,1195,2251,19,7,1214,2244,954,115,135,141,0,,0,0.0,0.0,0.0,0.0,0.0
2024,1,10,3,2024-01-10,B6,6190,LGA,DEN,"New York, NY",New York,"Denver, CO",Colorado,1166,1616,3,-5,1169,1611,16,4,1185,1607,1446,178,198,198,0,,0,0.0,0.0,0.0,0.0,0.0
2024,10,28,1,2024-10-28,NK,5317,EWR,ORD,"Newark, NJ",New Jersey,"Chicago, IL",Illinois,1392,1294,-16,-10,1376,1284,14,18,1390,1266,2106,256,276,288,0,,0,0.0,0.0,0.0,0.0,0.0
2024,8,18,7,2024-08-18,HA,5487,CLT,PHX,"Charlotte, NC",North Carolina,"Phoenix, AZ",Arizona,909,1189,2,10,911,1199,7,11,918,1188,1062,132,152,150,0,,0,0.0,0.0,0.0,0.0,0.0
2024,8,6,2,2024-08-06,MQ,5279,LAX,JFK,"Los Angeles, CA",California,"New York, NY",New York,1238,1234,-9,-5,1229,1229,14,17,1243,1212,1313,172,192,203,0,,0,0.0,0.0,0.0,0.0,0.0
2024,3,6,3,2024-03-06,AS,8287,STL,LAS,"St. Louis, MO",Missouri,"Las Vegas, NV",Nevada,2176,807,-5,0,2171,807,22,16,2193,791,397,39,59,77,0,,0,0.0,0.0,0.0,0.0,0.0
2024,4,21,7,2024-04-21,MQ,6743,BOS,IAD,"Boston, MA",Massachusetts,"Washington, DC",District of Columbia,2111,785,6,0,2117,785,14,18,2131,767,1466,176,196,208,0,,0,0.0,0.0,0.0,0.0,0.0
2024,1,13,6,2024-01-13,MQ,7760,PHL,IAD,"Philadelphia, PA",Pennsylvania,"Washington, DC",District of Columbia,645,1576,-1,0,644,1576,8,8,652,1568,1634,202,222,218,0,,0,0.0,0.0,0.0,0.0,0.0
2024,3,26,2,2024-03-26,YX,2558,DFW,PHL,"Dallas/Fort Worth, TX",Texas,"Philadelphia, PA",Pennsylvania,1561,616,9,0,1570,616,29,3,1599,613,1411,175,195,207,0,,0,0.0,0.0,0.0,0.0,0.0
2024,8,21,3,2024-08-21,G4,9455,IAH,MSP,"Houston, TX",Texas,"Minneapolis, MN",Minnesota,989,1913,14,10,1003,1923,7,17,1010,1906,822,98,118,122,0,,0,0.0,0.0,0.0,0.0,0.0
2024,3,30,6,2024-03-30,F9,6128,PHX,MDW,"Phoenix, AZ",Arizona,"Chicago, IL",Illinois,761,853,1,10,762,863,24,14,786,849,2143,272,292,310,0,,0,0.0,0.0,0.0,0.0,0.0
2024,11,9,6,2024-11-09,HA,5547,STL,PHL,"St. Louis, MO",Missouri,"Philadelphia, PA",Pennsylvania,1649,1570,-15,-5,1634,1565,22,10,1656,1555,1823,226,246,258,0,,0,0.0,0.0,0.0,0.0,0.0
2024,2,23,5,2024-02-23,WN,4659,LGA,ORD,"New York, NY",New York,"Chicago, IL",Illinois,2127,1210,1,0,2128,1210,21,11,2149,1199,2764,344,364,376,0,,0,0.0,0.0,0.0,0.0,0.0
2024,1,12,5,2024-01-12,MQ,2849,DTW,SLC,"Detroit, MI",Michigan,"Salt Lake City, UT",Utah,844,1045,-13,-15,831,1030,9,3,840,1027,587,63,83,75,0,,0,0.0,0.0,0.0,0.0,0.0
2024,7,27,6,2024-07-27,OO,2048,CLT,EWR,"Charlotte, NC",North Carolina,"Newark, NJ",New Jersey,1784,1595,-14,-15,1770,1580,24,18,1794,1562,676,77,97,119,0,,0,0.0,0.0,0.0,0.0,0.0
2024,1,14,7,2024-01-14,YX,6406,ATL,MIA,"Atlanta, GA",Georgia,"Miami, FL",Florida,1966,2079,1,0,1967,2079,14,16,1981,2063,336,34,54,64,0,,0,0.0,0.0,0.0,0.0,0.0
2024,4,30,2,2024-04-30,B6,8351,EWR,SAN,"Newark, NJ",New Jersey,"San Diego, CA",California,1378,1770,11,15,1389,1785,6,14,1395,1771,1854,223,243,243,0,,0,0.0,0.0,0.0,0.0,0.0
2024,1,20,6,2024-01-20,NK,8192,TPA,SAN,"Tampa, FL",Florida,"San Diego, CA",California,1631,1483,-4,0,1627,1483,26,17,1653,1466,2810,353,373,396,0,,0,0.0,0.0,0.0,0.0,0.0
2024,3,15,5,2024-03-15,F9,8624,CLT,JFK,"Charlotte, NC",North Carolina,"New York, NY",New York,2080,1737,0,5,2080,1742,25,10,2105,1732,2733,342,362,377,0,,0,0.0,0.0,0.0,0.0,0.0
2024,8,30,5,2024-08-30,B6,289,SEA,PDX,"Seattle, WA",Washington,"Portland, OR",Oregon,1960,1720,-8,-10,1952,1710,5,6,1957,1704,1135,147,167,158,0,,0,0.0,0.0,0.0,0.0,0.0
2024,8,10,6,2024-08-10,G4,6108,ORD,LGA,"Chicago, IL",Illinois,"New York, NY",New York,1013,2005,-2,0,1011,2005,20,7,1031,1998,252,39,59,66,0,,0,0.0,0.0,0.0,0.0,0.0
2024,3,10,7,2024-03-10,OH,7582,CLT,DTW,"Charlotte, NC",North Carolina,"Detroit, MI",Michigan,1444,1999,0,-5,1444,1994,14,16,1458,1978,1170,145,165,175,0,,0,0.0,0.0,0.0,0.0,0.0
2024,11,7,4,2024-11-07,9E,395,PHL,CLT,"Philadelphia, PA",Pennsylvania,"Charlotte, NC",North Carolina,1212,1582,-4,5,1208,1587,7,9,1215,1578,2217,277,297,293,0,,0,0.0,0.0,0.0,0.0,0.0
2024,7,29,1,2024-07-29,YX,8468,DCA,IAH,"Washington, DC",District of Columbia,"Houston, TX",Texas,1613,1105,-15,-15,1598,1090,8,17,1606,1073,615,73,93,98,0,,0,0.0,0.0,0.0,0.0,0.0
2024,4,10,3,2024-04-10,WN,8268,ATL,HNL,"Atlanta, GA",Georgia,"Honolulu, HI",Hawaii,714,1945,-8,0,706,1945,5,16,711,1929,2936,376,396,397,0,,0,0.0,0.0,0.0,0.0,0.0
2024,7,4,4,2024-07-04,WN,899,ATL,SLC,"Atlanta, GA",Georgia,"Salt Lake City, UT",Utah,2150,927,13,15,2163,942,16,9,2179,933,2380,293,313,318,0,,0,0.0,0.0,0.0,0.0,0.0
2024,5,11,6,2024-05-11,MQ,9097,BWI,STL,"Baltimore, MD",Maryland,"St. Louis, MO",Missouri,1842,948,11,10,1853,958,17,8,1870,950,2727,331,351,356,0,,0,0.0,0.0,0.0,0.0,0.0
2024,4,20,6,2024-04-20,F9,7103,STL,MDW,"St. Louis, MO",Missouri,"Chicago, IL",Illinois,1103,1793,1,10,1104,1803,12,4,1116,1799,1933,242,262,258,0,,0,0.0,0.0,0.0,0.0,0.0
2024,5,11,6,2024-05-11,AA,8506,SAN,SLC,"San Diego, CA",California,"Salt Lake City, UT",Utah,1337,906,3,-5,1340,901,23,11,1363,890,2222,273,293,307,0,,0,0.0,0.0,0.0,0.0,0.0
2024,1,20,6,2024-01-20,F9,2800,BOS,EWR,"Boston, MA",Massachusetts,"Newark, NJ",New Jersey,2221,798,10,15,2231,813,9,17,2240,796,352,41,61,67,0,,0,0.0,0.0,0.0,0.0,0.0
2024,1,24,3,2024-01-24,B6,8888,SLC,MSP,"Salt Lake City, UT",Utah,"Minneapolis, MN",Minnesota,1271,1800,17,10,1288,1810,16,17,1304,1793,2613,323,343,356,0,,0,0.0,0.0,0.0,0.0,0.0
2024,8,14,3,2024-08-14,MQ,9647,MDW,IAH,"Chicago, IL",Illinois,"Houston, TX",Texas,1169,1747,12,10,1181,1757,23,12,1204,1745,277,38,58,73,0,,0,0.0,0.0,0.0,0.0,0.0
2024,6,2,7,2024-06-02,OH,9584,ATL,EWR,"Atlanta, GA",Georgia,"Newark, NJ",New Jersey,1580,1780,18,15,1598,1795,8,5,1606,1790,823,107,127,120,0,,0,0.0,0.0,0.0,0.0,0.0
2024,10,19,6,2024-10-19,OO,5973,TPA,DTW,"Tampa, FL",Florida,"Detroit, MI",Michigan,1058,1206,12,15,1070,1221,19,6,1089,1215,2320,283,303,308,0,,0,0.0,0.0,0.0,0.0,0.0
2024,8,17,6,2024-08-17,AA,4814,SAN,MSP,"San Diego, CA",California,"Minneapolis, MN",Minnesota,1925,1909,-12,-10,1913,1899,29,4,1942,1895,1763,218,238,251,0,,0,0.0,0.0,0.0,0.0,0.0
2024,11,5,2,2024-11-05,WN,6591,PHL,MCO,"Philadelphia, PA",Pennsylvania,"Orlando, FL",Florida,721,1210,-13,-15,708,1195,17,9,725,1186,697,80,100,106,0,,0,0.0,0.0,0.0,0.0,0.0
2024,12,24,2,2024-12-24,DL,8433,MCO,SAN,"Orlando, FL",Florida,"San Diego, CA",California,974,1520,11,5,985,1525,17,3,1002,1522,799,106,126,126,0,,0,0.0,0.0,0.0,0.0,0.0
2024,7,20,6,2024-07-20,WN,2939,IAD,LGA,"Washington, DC",District of Columbia,"New York, NY",New York,1631,834,-5,0,1626,834,7,14,1633,820,902,102,122,123,0,,0,0.0,0.0,0.0,0.0,0.0
2024,2,7,3,2024-02-07,F9,3613,LAS,JFK,"Las Vegas, NV",Nevada,"New York, NY",New York,1362,2325,4,-5,1366,2320,12,7,1378,2313,2192,275,295,294,0,,0,0.0,0.0,0.0,0.0,0.0
2024,9,16,1,2024-09-16,B6,1235,MSP,MDW,"Minneapolis, MN",Minnesota,"Chicago, IL",Illinois,1311,1917,4,5,1315,1922,26,18,1341,1904,235,36,56,80,0,,0,0.0,0.0,0.0,0.0,0.0
2024,7,6,6,2024-07-06,AA,6457,MSP,IAH,"Minneapolis, MN",Minnesota,"Houston, TX",Texas,679,1384,-15,-15,664,1369,10,5,674,1364,1454,181,201,196,0,,0,0.0,0.0,0.0,0.0,0.0
2024,2,26,1,2024-02-26,NK,2347,EWR,SEA,"Newark, NJ",New Jersey,"Seattle, WA",Washington,676,1441,-21,-20,655,1421,21,13,676,1408,952,121,141,155,0,,0,0.0,0.0,0.0,0.0,0.0
2024,1,20,6,2024-01-20,AA,6648,CLT,MCO,"Charlotte, NC",North Carolina,"Orlando, FL",Florida,986,1641,-10,-5,976,1636,15,17,991,1619,689,93,113,125,0,,0,0.0,0.0,0.0,0.0,0.0
2024,9,29,7,2024-09-29,G4,4616,JFK,PHX,"New York, NY",New York,"Phoenix, AZ",Arizona,913,1558,-15,-10,898,1548,11,7,909,1541,2047,248,268,266,0,,0,0.0,0.0,0.0,0.0,0.0
2024,4,28,7,2024-04-28,UA,4202,MCO,SAN,"Orlando, FL",Florida,"San Diego, CA",California,1191,1797,9,5,1200,1802,19,8,1219,1794,778,87,107,114,0,,0,0.0,0.0,0.0,0.0,0.0
2024,3,11,1,2024-03-11,YX,1648,SEA,STL,"Seattle, WA",Washington,"St. Louis, MO",Missouri,1560,2026,11,15,1571,2041,8,6,1579,2035,1518,191,211,205,0,,0,0.0,0.0,0.0,0.0,0.0
2024,1,4,4,2024-01-04,UA,6632,STL,CLT,"St. Louis, MO",Missouri,"Charlotte, NC",North Carolina,1074,980,6,5,1080,985,12,14,1092,971,1132,132,152,158,0,,0,0.0,0.0,0.0,0.0,0.0
2024,8,8,4,2024-08-08,HA,4611,IAD,MCO,"Washington, DC",District of Columbia,"Orlando, FL",Florida,767,1743,14,5,781,1748,29,12,810,1736,1899,241,261,282,0,,0,0.0,0.0,0.0,0.0,0.0
2024,1,14,7,2024-01-14,HA,2931,EWR,STL,"Newark, NJ",New Jersey,"St. Louis, MO",Missouri,1284,1367,-22,-20,1262,1347,6,11,1268,1336,728,82,102,99,0,,0,0.0,0.0,0.0,0.0,0.0
2024,1,3,3,2024-01-03,AS,9298,MIA,HNL,"Miami, FL",Florida,"Honolulu, HI",Hawaii,1423,695,-10,0,1413,695,28,3,1441,692,765,96,116,127,0,,0,0.0,0.0,0.0,0.0,0.0
2024,8,3,6,2024-08-03,9E,3162,BOS,DEN,"Boston, MA",Massachusetts,"Denver, CO",Colorado,887,630,15,10,902,640,15,12,917,628,2352,301,321,328,0,,0,0.0,0.0,0.0,0.0,0.0
2024,8,16,5,2024-08-16,AS,8075,CLT,SEA,"Charlotte, NC",North Carolina,"Seattle, WA",Washington,853,696,12,5,865,701,12,8,877,693,352,41,61,61,0,,0,0.0,0.0,0.0,0.0,0.0
2024,12,1,7,2024-12-01,MQ,3152,CLT,SLC,"Charlotte, NC",North Carolina,"Salt Lake City, UT",Utah,1313,2093,-14,-10,1299,2083,26,16,1325,2067,1628,195,215,237,0,,0,0.0,0.0,0.0,0.0,0.0
2024,7,4,4,2024-07-04,OO,7310,MCO,DCA,"Orlando, FL",Florida,"Washington, DC",District of Columbia,1793,1304,17,10,1810,1314,23,13,1833,1301,2266,275,295,311,0,,0,0.0,0.0,0.0,0.0,0.0
2024,2,24,6,2024-02-24,OO,3639,MDW,PHX,"Chicago, IL",Illinois,"Phoenix, AZ",Arizona,1523,1669,17,20,1540,1689,9,16,1549,1673,2660,322,342,347,0,,0,0.0,1.0,2.0,0.0,17.0
2024,9,10,2,2024-09-10,AS,626,MDW,TPA,"Chicago, IL",Illinois,"Tampa, FL",Florida,768,835,-6,-10,762,825,22,13,784,812,2222,270,290,305,0,,0,0.0,0.0,0.0,0.0,0.0
2024,1,24,3,2024-01-24,MQ,2907,DFW,LGA,"Dallas/Fort Worth, TX",Texas,"New York, NY",New York,1965,2184,-15,-10,1950,2174,10,4,1960,2170,2067,252,272,266,0,,0,0.0,0.0,0.0,0.0,0.0
2024,6,10,1,2024-06-10,AA,9487,DCA,DEN,"Washington, DC",District of Columbia,"Denver, CO",Colorado,1828,936,-4,-5,1824,931,23,17,1847,914,2302,289,309,329,0,,0,0.0,0.0,0.0,0.0,0.0
2024,6,6,4,2024-06-06,B6,1853,MSP,SEA,"Minneapolis, MN",Minnesota,"Seattle, WA",Washington,1769,1273,-11,-15,1758,1258,24,12,1782,1246,1402,177,197,213,0,,0,0.0,0.0,0.0,0.0,0.0
2024,3,22,5,2024-03-22,YX,9964,SEA,MCO,"Seattle, WA",Washington,"Orlando, FL",Florida,1701,884,14,10,1715,894,29,13,1744,881,2081,252,272,294,0,,0,0.0,0.0,0.0,0.0,0.0
2024,6,7,5,2024-06-07,AS,6982,DTW,BOS,"Detroit, MI",Michigan,"Boston, MA",Massachusetts,1590,733,14,15,1604,748,9,10,1613,738,1006,122,142,141,0,,0,0.0,0.0,0.0,0.0,0.0
2024,7,6,6,2024-07-06,F9,1754,MDW,DCA,"Chicago, IL",Illinois,"Washington, DC",District of Columbia,776,1368,-2,0,774,1368,17,10,791,1358,2410,296,316,323,0,,0,0.0,0.0,0.0,0.0,0.0
2024,2,29,4,2024-02-29,MQ,4941,HNL,MCO,"Honolulu, HI",Hawaii,"Orlando, FL",Florida,1731,1294,8,5,1739,1299,27,7,1766,1292,524,55,75,89,0,,0,0.0,0.0,0.0,0.0,0.0
2024,10,31,4,2024-10-31,AA,4141,BOS,PHX,"Boston, MA",Massachusetts,"Phoenix, AZ",Arizona,806,1138,8,5,814,1143,16,16,830,1127,2371,288,308,320,0,,0,0.0,0.0,0.0,0.0,0.0
2024,11,14,4,2024-11-14,B6,5124,MDW,MIA,"Chicago, IL",Illinois,"Miami, FL",Florida,2073,2275,1,-5,2074,2270,13,18,2087,2252,1731,215,235,246,0,,0,0.0,0.0,0.0,0.0,0.0
2024,7,29,1,2024-07-29,UA,9139,DFW,IAH,"Dallas/Fort Worth, TX",Texas,"Houston, TX",Texas,1130,859,0,0,1130,859,9,15,1139,844,994,133,153,157,0,,0,0.0,0.0,0.0,0.0,0.0
2024,5,31,5,2024-05-31,DL,9159,LAX,SAN,"Los Angeles, CA",California,"San Diego, CA",California,1037,1102,5,10,1042,1112,21,9,1063,1103,2657,337,357,367,0,,0,0.0,0.0,0.0,0.0,0.0
2024,4,18,4,2024-04-18,OO,9065,PDX,SFO,"Portland, OR",Oregon,"San Francisco, CA",California,1017,1191,11,10,1028,1201,22,7,1050,1194,866,101,121,130,0,,0,0.0,0.0,0.0,0.0,0.0
2024,3,16,6,2024-03-16,F9,8834,EWR,STL,"Newark, NJ",New Jersey,"St. Louis, MO",Missouri,1797,1803,-9,-15,1788,1788,7,17,1795,1771,980,127,147,151,0,,0,0.0,0.0,0.0,0.0,0.0
2024,1,30,2,2024-01-30,NK,4517,IAD,MSP,"Washington, DC",District of Columbia,"Minneapolis, MN",Minnesota,1756,1495,-6,0,1750,1495,23,13,1773,1482,478,61,81,97,0,,0,0.0,0.0,0.0,0.0,0.0
2024,11,9,6,2024-11-09,9E,9077,PHX,MSP,"Phoenix, AZ",Arizona,"Minneapolis, MN",Minnesota,1637,1890,-10,-5,1627,1885,19,19,1646,1866,2873,352,372,390,0,,0,0.0,0.0,0.0,0.0,0.0
2024,4,26,5,2024-04-26,NK,4735,SAN,BWI,"San Diego, CA",California,"Baltimore, MD",Maryland,633,2187,-3,5,630,2192,21,10,651,2182,1443,177,197,208,0,,0,0.0,0.0,0.0,0.0,0.0
2024,12,21,6,2024-12-21,B6,2983,SAN,MCO,"San Diego, CA",California,"Orlando, FL",Florida,1948,1621,-10,0,1938,1621,13,12,1951,1609,2838,361,381,386,0,,0,0.0,0.0,0.0,0.0,0.0
2024,7,10,3,2024-07-10,YX,5984,MCO,BWI,"Orlando, FL",Florida,"Baltimore, MD",Maryland,1324,683,2,-5,1326,678,29,8,1355,670,1199,153,173,190,0,,0,0.0,0.0,0.0,0.0,0.0
2024,1,19,5,2024-01-19,MQ,548,HNL,SEA,"Honolulu, HI",Hawaii,"Seattle, WA",Washington,2213,1009,8,5,2221,1014,8,12,2229,1002,694,88,108,108,1,,0,0.0,0.0,0.0,0.0,0.0
2024,6,21,5,2024-06-21,G4,3410,STL,MIA,"St. Louis, MO",Missouri,"Miami, FL",Florida,1548,1779,1,0,1549,1779,13,9,1562,1770,1934,231,251,253,0,,0,0.0,0.0,0.0,0.0,0.0
2024,8,15,4,2024-08-15,B6,4685,LGA,STL,"New York, NY",New York,"St. Louis, MO",Missouri,2083,2113,-9,-10,2074,2103,8,7,2082,2096,2986,367,387,382,0,,0,0.0,0.0,0.0,0.0,0.0
2024,12,15,7,2024-12-15,DL,8208,PDX,IAH,"Portland, OR",Oregon,"Houston, TX",Texas,1803,927,10,10,1813,937,28,15,1841,922,1080,136,156,179,0,,0,0.0,0.0,0.0,0.0,0.0
2024,7,1,1,2024-07-01,UA,4509,LAS,DFW,"Las Vegas, NV",Nevada,"Dallas/Fort Worth, TX",Texas,1866,2239,-7,-15,1859,2224,7,5,1866,2219,1885,225,245,237,0,,0,0.0,0.0,0.0,0.0,0.0
2024,4,22,1,2024-04-22,WN,7973,EWR,BWI,"Newark, NJ",New Jersey,"Baltimore, MD",Maryland,1312,945,-28,-20,1284,925,13,18,1297,907,1980,249,269,280,0,,0,0.0,0.0,0.0,0.0,0.0
2024,7,1,1,2024-07-01,HA,6151,SLC,DFW,"Salt Lake City, UT",Utah,"Dallas/Fort Worth, TX",Texas,571,1522,-24,-15,547,1507,15,8,562,1499,1168,153,173,176,0,,0,0.0,0.0,0.0,0.0,0.0
2024,5,25,6,2024-05-25,B6,8676,HNL,MDW,"Honolulu, HI",Hawaii,"Chicago, IL",Illinois,1517,696,-14,-10,1503,686,15,10,1518,676,579,74,94,99,0,,0,0.0,0.0,0.0,0.0,0.0
2024,11,14,4,2024-11-14,MQ,394,LAX,TPA,"Los Angeles, CA",California,"Tampa, FL",Florida,1451,1236,1,0,1452,1236,24,18,1476,1218,2248,283,303,325,0,,0,0.0,0.0,0.0,0.0,0.0
2024,4,25,4,2024-04-25,UA,1338,MSP,DFW,"Minneapolis, MN",Minnesota,"Dallas/Fort Worth, TX",Texas,1724,782,8,0,1732,782,12,19,1744,763,1317,159,179,190,0,,0,0.0,0.0,0.0,0.0,0.0
2024,4,22,1,2024-04-22,YX,8141,DEN,LAS,"Denver, CO",Colorado,"Las Vegas, NV",Nevada,1849,1950,-3,-5,1846,1945,6,12,1852,1933,266,39,59,57,0,,0,0.0,0.0,0.0,0.0,0.0
2024,9,7,6,2024-09-07,OH,2916,LAX,SEA,"Los Angeles, CA",California,"Seattle, WA",Washington,532,2189,-2,-10,530,2179,20,19,550,2160,653,89,109,128,0,,0,0.0,0.0,0.0,0.0,0.0
2024,9,7,6,2024-09-07,NK,1198,STL,BWI,"St. Louis, MO",Missouri,"Baltimore, MD",Maryland,596,1413,-22,-15,574,1398,27,12,601,1386,1190,157,177,196,0,,0,0.0,0.0,0.0,0.0,0.0
2024,10,29,2,2024-10-29,B6,1837,BWI,SFO,"Baltimore, MD",Maryland,"San Francisco, CA",California,2080,2299,1,0,2081,2299,6,9,2087,2290,1228,152,172,167,0,,0,0.0,0.0,0.0,0.0,0.0
2024,11,8,5,2024-11-08,B6,2289,LGA,ORD,"New York, NY",New York,"Chicago, IL",Illinois,762,1495,-7,0,755,1495,25,13,780,1482,2955,363,383,401,0,,0,0.0,0.0,0.0,0.0,0.0
2024,4,27,6,2024-04-27,AS,2865,DCA,SEA,"Washington, DC",District of Columbia,"Seattle, WA",Washington,1373,1260,-3,-5,1370,1255,29,5,1399,1250,895,109,129,143,0,,0,0.0,0.0,0.0,0.0,0.0
2024,10,27,7,2024-10-27,NK,1322,PHX,DTW,"Phoenix, AZ",Arizona,"Detroit, MI",Michigan,1413,1544,-1,-10,1412,1534,25,10,1437,1524,1554,188,208,223,0,,0,0.0,0.0,0.0,0.0,0.0
2024,6,9,7,2024-06-09,9E,6649,DEN,STL,"Denver, CO",Colorado,"St. Louis, MO",Missouri,1593,1401,-19,-15,1574,1386,24,5,1598,1381,261,35,55,64,0,,0,0.0,0.0,0.0,0.0,0.0
2024,7,16,2,2024-07-16,9E,510,MDW,DFW,"Chicago, IL",Illinois,"Dallas/Fort Worth, TX",Texas,792,977,-25,-20,767,957,28,15,795,942,1138,136,156,179,0,,0,0.0,0.0,0.0,0.0,0.0
2024,9,16,1,2024-09-16,F9,3045,ATL,SLC,"Atlanta, GA",Georgia,"Salt Lake City, UT",Utah,1416,1710,-14,-15,1402,1695,9,8,1411,1687,2389,303,323,320,0,,0,0.0,0.0,0.0,0.0,0.0
2024,5,27,1,2024-05-27,G4,8202,DTW,MSP,"Detroit, MI",Michigan,"Minneapolis, MN",Minnesota,1229,2297,6,5,1235,2302,13,19,1248,2283,568,62,82,94,0,,0,0.0,0.0,0.0,0.0,0.0
2024,8,27,2,2024-08-27,OO,4886,MCO,MIA,"Orlando, FL",Florida,"Miami, FL",Florida,1730,1279,0,-5,1730,1274,29,4,1759,1270,932,119,139,152,0,,0,0.0,0.0,0.0,0.0,0.0
2024,2,16,5,2024-02-16,WN,9169,MSP,PHL,"Minneapolis, MN",Minnesota,"Philadelphia, PA",Pennsylvania,671,1758,-18,-20,653,1738,6,9,659,1729,967,127,147,142,0,,0,0.0,0.0,0.0,0.0,0.0
2024,7,16,2,2024-07-16,B6,886,DCA,LAX,"Washington, DC",District of Columbia,"Los Angeles, CA",California,1257,689,6,0,1263,689,13,8,1276,681,200,20,40,41,0,,0,0.0,0.0,0.0,0.0,0.0
2024,2,16,5,2024-02-16,HA,2209,ORD,SFO,"Chicago, IL",Illinois,"San Francisco, CA",California,1425,1087,-3,0,1422,1087,15,3,1437,1084,1612,200,220,218,0,,0,0.0,0.0,0.0,0.0,0.0
2024,3,18,1,2024-03-18,B6,5546,MIA,EWR,"Miami, FL",Florida,"Newark, NJ",New Jersey,1918,1419,-15,-5,1903,1414,12,12,1915,1402,2439,299,319,323,0,,0,0.0,0.0,0.0,0.0,0.0
2024,5,3,5,2024-05-03,F9,5935,SAN,PDX,"San Diego, CA",California,"Portland, OR",Oregon,1779,2216,-14,-15,1765,2201,11,3,1776,2198,2863,356,376,370,0,,0,0.0,0.0,0.0,0.0,0.0
2024,3,15,5,2024-03-15,G4,2086,LAX,ATL,"Los Angeles, CA",California,"Atlanta, GA",Georgia,1787,1462,14,5,1801,1467,10,16,1811,1451,300,32,52,58,0,,0,0.0,0.0,0.0,0.0,0.0
2024,12,24,2,2024-12-24,NK,8226,EWR,PHL,"Newark, NJ",New Jersey,"Philadelphia, PA",Pennsylvania,1400,1342,1,5,1401,1347,24,5,1425,1342,579,64,84,93,0,,0,0.0,0.0,0.0,0.0,0.0
2024,5,16,4,2024-05-16,HA,9170,BWI,MIA,"Baltimore, MD",Maryland,"Miami, FL",Florida,1787,1712,-4,-5,1783,1707,19,11,1802,1696,1033,130,150,160,0,,0,0.0,0.0,0.0,0.0,0.0
2024,3,30,6,2024-03-30,B6,7400,DTW,TPA,"Detroit, MI",Michigan,"Tampa, FL",Florida,1016,1916,3,-5,1019,1911,19,9,1038,1902,1727,224,244,252,0,,0,0.0,0.0,0.0,0.0,0.0
2024,11,20,3,2024-11-20,UA,9899,PDX,LGA,"Portland, OR",Oregon,"New York, NY",New York,1533,1045,-8,-10,1525,1035,11,10,1536,1025,2676,343,363,364,0,,0,0.0,0.0,0.0,0.0,0.0
2024,3,1,5,2024-03-01,AA,5809,STL,HNL,"St. Louis, MO",Missouri,"Honolulu, HI",Hawaii,770,2022,4,5,774,2027,26,9,800,2018,2618,319,339,354,0,,0,0.0,0.0,0.0,0.0,0.0
2024,5,17,5,2024-05-17,OO,2503,MDW,BOS,"Chicago, IL",Illinois,"Boston, MA",Massachusetts,1241,2137,-9,0,1232,2137,12,12,1244,2125,1155,134,154,158,0,,0,0.0,0.0,0.0,0.0,0.0
2024,2,19,1,2024-02-19,G4,8362,BOS,LGA,"Boston, MA",Massachusetts,"New York, NY",New York,1835,2018,-23,-15,1812,2003,21,17,1833,1986,217,36,56,74,0,,0,0.0,0.0,0.0,0.0,0.0
2024,9,15,7,2024-09-15,B6,4501,SLC,MSP,"Salt Lake City, UT",Utah,"Minneapolis, MN",Minnesota,1893,1463,-4,-5,1889,1458,23,4,1912,1454,2933,369,389,396,0,,0,0.0,0.0,0.0,0.0,0.0
2024,4,16,2,2024-04-16,G4,6801,TPA,LAS,"Tampa, FL",Florida,"Las Vegas, NV",Nevada,1066,2357,9,15,1075,2372,28,12,1103,2360,1733,208,228,248,0,,0,0.0,0.0,0.0,0.0,0.0
2024,4,22,1,2024-04-22,9E,3395,STL,CLT,"St. Louis, MO",Missouri,"Charlotte, NC",North Carolina,1052,1640,-6,0,1046,1640,6,6,1052,1634,2280,290,310,302,0,,0,0.0,0.0,0.0,0.0,0.0
2024,12,15,7,2024-12-15,HA,9053,HNL,MDW,"Honolulu, HI",Hawaii,"Chicago, IL",Illinois,1149,2331,-11,-5,1138,2326,13,17,1151,2309,443,58,78,88,0,,0,0.0,0.0,0.0,0.0,0.0
2024,9,10,2,2024-09-10,YX,2221,SEA,DTW,"Seattle, WA",Washington,"Detroit, MI",Michigan,890,2255,-4,0,886,2255,6,8,892,2247,1490,178,198,192,0,,0,0.0,0.0,0.0,0.0,0.0
2024,4,27,6,2024-04-27,MQ,3682,PHX,JFK,"Phoenix, AZ",Arizona,"New York, NY",New York,1458,1865,-13,-10,1445,1855,17,5,1462,1850,932,111,131,133,0,,0,0.0,0.0,0.0,0.0,0.0
2024,7,16,2,2024-07-16,OH,4297,BWI,STL,"Baltimore, MD",Maryland,"St. Louis, MO",Missouri,1638,1285,8,0,1646,1285,29,14,1675,1271,2788,346,366,389,0,,0,0.0,0.0,0.0,0.0,0.0
2024,12,2,1,2024-12-02,WN,9921,EWR,LAS,"Newark, NJ",New Jersey,"Las Vegas, NV",Nevada,1074,2167,10,5,1084,2172,16,3,1100,2169,2767,335,355,354,0,,0,0.0,0.0,0.0,0.0,0.0
2024,12,30,1,2024-12-30,B6,5800,JFK,MIA,"New York, NY",New York,"Miami, FL",Florida,843,2330,9,10,852,2340,27,11,879,2329,1765,218,238,256,0,,0,0.0,0.0,0.0,0.0,0.0
2024,2,20,2,2024-02-20,WN,7332,IAD,STL,"Washington, DC",District of Columbia,"St. Louis, MO",Missouri,1933,1627,7,5,1940,1632,8,11,1948,1621,2098,263,283,282,0,,0,0.0,0.0,0.0,0.0,0.0
2024,9,1,7,2024-09-01,DL,4388,BOS,JFK,"Boston, MA",Massachusetts,"New York, NY",New York,2069,880,-14,-5,2055,875,23,8,2078,867,2044,246,266,277,0,,0,0.0,0.0,0.0,0.0,0.0
2024,2,4,7,2024-02-04,YX,1185,BOS,LAX,"Boston, MA",Massachusetts,"Los Angeles, CA",California,1901,1568,-2,5,1899,1573,12,5,1911,1568,785,98,118,115,0,,0,0.0,0.0,0.0,0.0,0.0
2024,10,28,1,2024-10-28,AA,8745,IAH,ATL,"Houston, TX",Texas,"Atlanta, GA",Georgia,2287,1132,1,10,2288,1142,17,11,2305,1131,973,124,144,152,0,,0,0.0,0.0,0.0,0.0,0.0
2024,3,9,6,2024-03-09,F9,2721,LGA,DFW,"New York, NY",New York,"Dallas/Fort Worth, TX",Texas,955,2094,-8,0,947,2094,18,16,965,2078,774,88,108,122,0,,0,0.0,0.0,0.0,0.0,0.0
2024,12,14,6,2024-12-14,WN,8910,DCA,MSP,"Washington, DC",District of Columbia,"Minneapolis, MN",Minnesota,1946,1861,-21,-20,1925,1841,11,19,1936,1822,1352,171,191,201,0,,0,0.0,0.0,0.0,0.0,0.0
2024,11,15,5,2024-11-15,B6,8928,SFO,MDW,"San Francisco, CA",California,"Chicago, IL",Illinois,943,1204,10,10,953,1214,5,19,958,1195,2768,344,364,368,0,,0,0.0,0.0,0.0,0.0,0.0
2024,2,18,7,2024-02-18,AS,2448,LAS,HNL,"Las Vegas, NV",Nevada,"Honolulu, HI",Hawaii,696,1077,-18,-10,678,1067,15,13,693,1054,1017,124,144,152,0,,0,0.0,0.0,0.0,0.0,0.0
2024,3,14,4,2024-03-14,OH,4974,SFO,MSP,"San Francisco, CA",California,"Minneapolis, MN",Minnesota,1367,688,-21,-15,1346,673,27,19,1373,654,1915,237,257,283,0,,0,0.0,0.0,0.0,0.0,0.0
2024,7,10,3,2024-07-10,F9,3136,LAX,DEN,"Los Angeles, CA",California,"Denver, CO",Colorado,862,1736,4,-5,866,1731,21,16,887,1715,510,60,80,97,0,,0,0.0,0.0,0.0,0.0,0.0
2024,9,17,2,2024-09-17,OO,2449,BOS,SEA,"Boston, MA",Massachusetts,"Seattle, WA",Washington,1933,2356,-10,-5,1923,2351,21,18,1944,2333,1714,219,239,258,0,,0,0.0,0.0,0.0,0.0,0.0
2024,12,21,6,2024-12-21,F9,5843,PHL,ATL,"Philadelphia, PA",Pennsylvania,"Atlanta, GA",Georgia,2287,1209,7,5,2294,1214,19,18,2313,1196,1600,192,212,229,0,,0,0.0,0.0,0.0,0.0,0.0
2024,3,10,7,2024-03-10,NK,4532,BOS,JFK,"Boston, MA",Massachusetts,"New York, NY",New York,2097,741,-11,-5,2086,736,25,13,2111,723,2250,274,294,312,0,,0,0.0,0.0,0.0,0.0,0.0
2024,3,30,6,2024-03-30,WN,6275,IAD,MDW,"Washington, DC",District of Columbia,"Chicago, IL",Illinois,1917,1261,-28,-20,1889,1241,14,3,1903,1238,2161,260,280,277,0,,0,0.0,0.0,0.0,0.0,0.0
2024,9,16,1,2024-09-16,AS,7365,DEN,MSP,"Denver, CO",Colorado,"Minneapolis, MN",Minnesota,2260,1159,9,0,2269,1159,20,18,2289,1141,1737,213,233,251,0,,0,0.0,0.0,0.0,0.0,0.0
2024,5,5,7,2024-05-05,WN,6203,ATL,MDW,"Atlanta, GA",Georgia,"Chicago, IL",Illinois,2032,650,6,5,2038,655,9,8,2047,647,2691,343,363,360,0,,0,0.0,0.0,0.0,0.0,0.0
2024,8,18,7,2024-08-18,HA,7458,DTW,PHL,"Detroit, MI",Michigan,"Philadelphia, PA",Pennsylvania,1367,807,2,10,1369,817,6,17,1375,800,2703,343,363,366,0,,0,0.0,0.0,0.0,0.0,0.0
2024,10,21,1,2024-10-21,OH,9363,MDW,BWI,"Chicago, IL",Illinois,"Baltimore, MD",Maryland,1065,1122,3,-5,1068,1117,11,3,1079,1114,2853,353,373,367,0,,0,0.0,0.0,0.0,0.0,0.0
2024,5,8,3,2024-05-08,NK,2131,BWI,CLT,"Baltimore, MD",Maryland,"Charlotte, NC",North Carolina,1170,2131,-11,-15,1159,2116,7,9,1166,2107,1984,247,267,263,0,,0,0.0,0.0,0.0,0.0,0.0
2024,10,6,7,2024-10-06,YX,1349,ATL,SEA,"Atlanta, GA",Georgia,"Seattle, WA",Washington,1817,1893,-1,0,1816,1893,19,10,1835,1883,857,112,132,141,0,,0,0.0,0.0,0.0,0.0,0.0
2024,11,8,5,2024-11-08,MQ,9587,MSP,LGA,"Minneapolis, MN",Minnesota,"New York, NY",New York,524,1886,-20,-15,504,1871,15,12,519,1859,1028,128,148,155,0,,0,0.0,0.0,0.0,0.0,0.0
2024,4,9,2,2024-04-09,YX,6908,EWR,ORD,"Newark, NJ",New Jersey,"Chicago, IL",Illinois,736,1308,-15,-20,721,1288,5,9,726,1279,1738,217,237,231,0,,0,0.0,0.0,0.0,0.0,0.0
2024,11,21,4,2024-11-21,HA,3656,JFK,STL,"New York, NY",New York,"St. Louis, MO",Missouri,960,1809,9,5,969,1814,27,10,996,1804,2765,347,367,384,0,,0,0.0,0.0,0.0,0.0,0.0
2024,10,23,3,2024-10-23,MQ,8619,CLT,PHX,"Charlotte, NC",North Carolina,"Phoenix, AZ",Arizona,1844,1407,-14,-5,1830,1402,20,15,1850,1387,826,101,121,136,0,,0,0.0,0.0,0.0,0.0,0.0
2024,6,30,7,2024-06-30,MQ,9088,DCA,MSP,"Washington, DC",District of Columbia,"Minneapolis, MN",Minnesota,599,1844,6,0,605,1844,15,16,620,1828,1213,144,164,175,0,,0,0.0,0.0,0.0,0.0,0.0
2024,6,22,6,2024-06-22,OO,5399,JFK,MDW,"New York, NY",New York,"Chicago, IL",Illinois,1239,680,10,5,1249,685,24,5,1273,680,980,114,134,143,0,,0,0.0,0.0,0.0,0.0,0.0
2024,11,11,1,2024-11-11,OH,3194,DTW,LAS,"Detroit, MI",Michigan,"Las Vegas, NV",Nevada,2213,2357,-13,-5,2200,2352,24,14,2224,2338,2774,345,365,383,0,,0,0.0,0.0,0.0,0.0,0.0
2024,12,29,7,2024-12-29,AA,3077,SAN,DCA,"San Diego, CA",California,"Washington, DC",District of Columbia,907,1008,-7,-15,900,993,23,4,923,989,2845,349,369,376,0,,0,0.0,0.0,0.0,0.0,0.0
2024,7,6,6,2024-07-06,B6,1062,HNL,LGA,"Honolulu, HI",Hawaii,"New York, NY",New York,1678,1573,-17,-10,1661,1563,11,7,1672,1556,282,36,56,54,0,,0,0.0,0.0,0.0,0.0,0.0
2024,2,26,1,2024-02-26,HA,5825,MCO,EWR,"Orlando, FL",Florida,"Newark, NJ",New Jersey,1477,1490,-1,-10,1476,1480,22,14,1498,1466,2489,302,322,338,0,,0,0.0,0.0,0.0,0.0,0.0
2024,1,31,3,2024-01-31,OH,5589,SFO,LGA,"San Francisco, CA",California,"New York, NY",New York,1957,1281,14,20,1971,1301,27,6,1998,1295,1139,143,163,176,0,,0,0.0,5.0,2.0,0.0,13.0
2024,3,24,7,2024-03-24,9E,1368,PHL,CLT,"Philadelphia, PA",Pennsylvania,"Charlotte, NC",North Carolina,1250,685,7,5,1257,690,14,3,1271,687,2453,301,321,318,0,,0,0.0,0.0,0.0,0.0,0.0
2024,5,31,5,2024-05-31,YX,5379,HNL,LAS,"Honolulu, HI",Hawaii,"Las Vegas, NV",Nevada,1957,2179,9,0,1966,2179,12,10,1978,2169,2846,359,379,381,0,,0,0.0,0.0,0.0,0.0,0.0
2024,2,5,1,2024-02-05,HA,472,EWR,DEN,"Newark, NJ",New Jersey,"Denver, CO",Colorado,642,703,-24,-15,618,688,6,4,624,684,1248,149,169,159,0,,0,0.0,0.0,0.0,0.0,0.0
2024,7,31,3,2024-07-31,9E,4480,BWI,DTW,"Baltimore, MD",Maryland,"Detroit, MI",Michigan,1028,1907,-14,-15,1014,1892,28,19,1042,1873,360,45,65,92,0,,0,0.0,0.0,0.0,0.0,0.0
2024,12,29,7,2024-12-29,HA,7717,BWI,DTW,"Baltimore, MD",Maryland,"Detroit, MI",Michigan,1808,1059,16,10,1824,1069,11,11,1835,1058,2440,304,324,326,0,,0,0.0,0.0,0.0,0.0,0.0
2024,4,15,1,2024-04-15,WN,9896,SFO,DEN,"San Francisco, CA",California,"Denver, CO",Colorado,1528,1339,14,15,1542,1354,12,13,1554,1341,2056,253,273,278,0,,0,0.0,0.0,0.0,0.0,0.0
2024,12,7,6,2024-12-07,OO,6379,MIA,SLC,"Miami, FL",Florida,"Salt Lake City, UT",Utah,1022,2323,-22,-20,1000,2303,23,19,1023,2284,1689,209,229,251,0,,0,0.0,0.0,0.0,0.0,0.0
2024,8,7,3,2024-08-07,NK,195,EWR,LAX,"Newark, NJ",New Jersey,"Los Angeles, CA",California,1219,1060,13,15,1232,1075,10,7,1242,1068,2811,358,378,375,0,,0,0.0,0.0,0.0,0.0,0.0
2024,6,11,2,2024-06-11,MQ,4469,DTW,ATL,"Detroit, MI",Michigan,"Atlanta, GA",Georgia,1959,1744,1,-5,1960,1739,5,11,1965,1728,2720,344,364,360,0,,0,0.0,0.0,0.0,0.0,0.0
2024,8,7,3,2024-08-07,G4,4041,DFW,BWI,"Dallas/Fort Worth, TX",Texas,"Baltimore, MD",Maryland,917,2284,-12,-10,905,2274,27,9,932,2265,1786,223,243,259,0,,0,0.0,0.0,0.0,0.0,0.0
2024,9,26,4,2024-09-26,B6,7121,STL,SLC,"St. Louis, MO",Missouri,"Salt Lake City, UT",Utah,1604,1975,-12,-15,1592,1960,15,17,1607,1943,2374,295,315,327,0,,0,0.0,0.0,0.0,0.0,0.0
2024,4,29,1,2024-04-29,WN,9492,ATL,TPA,"Atlanta, GA",Georgia,"Tampa, FL",Florida,1044,1039,11,5,1055,1044,24,18,1079,1026,1795,215,235,257,0,,0,0.0,0.0,0.0,0.0,0.0
2024,12,1,7,2024-12-01,HA,4044,PHL,IAD,"Philadelphia, PA",Pennsylvania,"Washington, DC",District of Columbia,1509,1168,6,0,1515,1168,8,18,1523,1150,1151,137,157,163,0,,0,0.0,0.0,0.0,0.0,0.0
2024,6,30,7,2024-06-30,G4,5968,LAX,SEA,"Los Angeles, CA",California,"Seattle, WA",Washington,1316,1812,1,10,1317,1822,16,15,1333,1807,997,133,153,164,0,,0,0.0,0.0,0.0,0.0,0.0
2024,4,15,1,2024-04-15,B6,5496,MDW,ATL,"Chicago, IL",Illinois,"Atlanta, GA",Georgia,1900,1468,-6,-10,1894,1458,13,7,1907,1451,745,83,103,103,0,,0,0.0,0.0,0.0,0.0,0.0
2024,8,4,7,2024-08-04,G4,8141,EWR,IAH,"Newark, NJ",New Jersey,"Houston, TX",Texas,658,1149,5,5,663,1154,27,4,690,1150,2863,365,385,396,0,,0,0.0,0.0,0.0,0.0,0.0
2024,7,23,2,2024-07-23,F9,231,IAD,DEN,"Washington, DC",District of Columbia,"Denver, CO",Colorado,1126,2336,-21,-15,1105,2321,12,7,1117,2314,1746,209,229,228,0,,0,0.0,0.0,0.0,0.0,0.0
2024,3,10,7,2024-03-10,WN,7390,LAX,HNL,"Los Angeles, CA",California,"Honolulu, HI",Hawaii,1740,828,-17,-15,1723,813,10,3,1733,810,1722,222,242,235,0,,0,0.0,0.0,0.0,0.0,0.0
2024,2,13,2,2024-02-13,OO,9682,LAX,SAN,"Los Angeles, CA",California,"San Diego, CA",California,1272,2009,-17,-15,1255,1994,22,3,1277,1991,1508,191,211,216,0,,1,0.0,0.0,0.0,0.0,0.0
2024,11,24,7,2024-11-24,OO,6616,DCA,PDX,"Washington, DC",District of Columbia,"Portland, OR",Oregon,2193,1754,13,10,2206,1764,23,18,2229,1746,2981,366,386,407,0,,0,0.0,0.0,0.0,0.0,0.0
2024,10,27,7,2024-10-27,NK,9441,SEA,PDX,"Seattle, WA",Washington,"Portland, OR",Oregon,1568,770,2,5,1570,775,24,19,1594,756,2770,353,373,396,0,,0,0.0,0.0,0.0,0.0,0.0
2024,8,15,4,2024-08-15,B6,6006,ORD,DCA,"Chicago, IL",Illinois,"Washington, DC",District of Columbia,2155,1953,-10,-10,2145,1943,22,9,2167,1934,584,75,95,106,0,,0,0.0,0.0,0.0,0.0,0.0
2024,7,2,2,2024-07-02,9E,907,STL,BOS,"St. Louis, MO",Missouri,"Boston, MA",Massachusetts,1738,634,-4,-5,1734,629,5,12,1739,617,1688,219,239,236,0,,0,0.0,0.0,0.0,0.0,0.0
2024,4,16,2,2024-04-16,WN,150,DCA,DTW,"Washington, DC",District of Columbia,"Detroit, MI",Michigan,2034,1824,1,5,2035,1829,13,6,2048,1823,1170,150,170,169,0,,0,0.0,0.0,0.0,0.0,0.0
2024,3,24,7,2024-03-24,B6,5377,MSP,LGA,"Minneapolis, MN",Minnesota,"New York, NY",New York,627,1791,-18,-10,609,1781,17,6,626,1775,2660,339,359,362,0,,0,0.0,0.0,0.0,0.0,0.0
2024,12,3,2,2024-12-03,B6,155,DTW,DFW,"Detroit, MI",Michigan,"Dallas/Fort Worth, TX",Texas,1777,2132,7,15,1784,2147,16,15,1800,2132,2438,297,317,328,0,,0,0.0,0.0,0.0,0.0,0.0
2024,9,6,5,2024-09-06,OO,3764,HNL,JFK,"Honolulu, HI",Hawaii,"New York, NY",New York,2073,2134,18,15,2091,2149,22,15,2113,2134,2229,269,289,306,0,,0,0.0,0.0,0.0,0.0,0.0
2024,12,28,6,2024-12-28,HA,843,LAX,TPA,"Los Angeles, CA",California,"Tampa, FL",Florida,1376,1869,-7,0,1369,1869,25,5,1394,1864,933,117,137,147,0,,0,0.0,0.0,0.0,0.0,0.0
2024,1,21,7,2024-01-21,G4,6130,SEA,LAS,"Seattle, WA",Washington,"Las Vegas, NV",Nevada,2245,1847,3,0,2248,1847,11,13,2259,1834,2818,347,367,371,0,,0,0.0,0.0,0.0,0.0,0.0
2024,7,14,7,2024-07-14,YX,8231,BOS,STL,"Boston, MA",Massachusetts,"St. Louis, MO",Missouri,1875,940,8,5,1883,945,15,13,1898,932,1715,218,238,246,0,,0,0.0,0.0,0.0,0.0,0.0
2024,6,26,3,2024-06-26,G4,179,PDX,DTW,"Portland, OR",Oregon,"Detroit, MI",Michigan,1105,1169,-18,-10,1087,1159,22,16,1109,1143,2850,362,382,400,0,,0,0.0,0.0,0.0,0.0,0.0
2024,1,7,7,2024-01-07,AS,3066,PHX,SAN,"Phoenix, AZ",Arizona,"San Diego, CA",California,1040,1136,-3,-5,1037,1131,26,13,1063,1118,854,102,122,141,0,,0,0.0,0.0,0.0,0.0,0.0
2024,3,10,7,2024-03-10,OH,3828,EWR,LGA,"Newark, NJ",New Jersey,"New York, NY",New York,663,2063,-18,-15,645,2048,14,15,659,2033,2960,362,382,391,0,,0,0.0,0.0,0.0,0.0,0.0
2024,5,6,1,2024-05-06,WN,4636,MIA,PHL,"Miami, FL",Florida,"Philadelphia, PA",Pennsylvania,1148,1143,10,15,1158,1158,12,13,1170,1145,806,91,111,116,0,,0,0.0,0.0,0.0,0.0,0.0
2024,6,8,6,2024-06-08,HA,225,HNL,IAH,"Honolulu, HI",Hawaii,"Houston, TX",Texas,2058,2245,-4,5,2054,2250,18,9,2072,2241,259,29,49,56,0,,0,0.0,0.0,0.0,0.0,0.0
2024,9,4,3,2024-09-04,DL,5913,SAN,MIA,"San Diego, CA",California,"Miami, FL",Florida,630,2236,-25,-20,605,2216,18,12,623,2204,1494,178,198,208,0,,0,0.0,0.0,0.0,0.0,0.0
2024,7,21,7,2024-07-21,OH,8510,DTW,DFW,"Detroit, MI",Michigan,"Dallas/Fort Worth, TX",Texas,2121,1773,9,0,2130,1773,17,8,2147,1765,2949,375,395,400,0,,0,0.0,0.0,0.0,0.0,0.0
2024,5,27,1,2024-05-27,UA,1047,MCO,SAN,"Orlando, FL",Florida,"San Diego, CA",California,1195,2328,-2,-5,1193,2323,11,8,1204,2315,215,31,51,50,0,,0,0.0,0.0,0.0,0.0,0.0
2024,5,22,3,2024-05-22,DL,694,MDW,LAS,"Chicago, IL",Illinois,"Las Vegas, NV",Nevada,1003,2244,6,10,1009,2254,19,13,1028,2241,1512,184,204,216,0,,0,0.0,0.0,0.0,0.0,0.0
2024,7,17,3,2024-07-17,B6,5130,MSP,BOS,"Minneapolis, MN",Minnesota,"Boston, MA",Massachusetts,1947,955,1,-5,1948,950,10,17,1958,933,1828,235,255,262,0,,0,0.0,0.0,0.0,0.0,0.0
2024,6,2,7,2024-06-02,AS,240,DTW,CLT,"Detroit, MI",Michigan,"Charlotte, NC",North Carolina,2272,1344,-8,0,2264,1344,16,10,2280,1334,1223,143,163,169,0,,0,0.0,0.0,0.0,0.0,0.0
2024,5,21,2,2024-05-21,OO,3155,BWI,SEA,"Baltimore, MD",Maryland,"Seattle, WA",Washington,683,1619,-7,-10,676,1609,15,11,691,1598,679,74,94,100,0,,0,0.0,0.0,0.0,0.0,0.0
2024,11,8,5,2024-11-08,B6,9922,IAD,SEA,"Washington, DC",District of Columbia,"Seattle, WA",Washington,1325,1132,-10,0,1315,1132,28,5,1343,1127,231,26,46,59,0,,0,0.0,0.0,0.0,0.0,0.0
2024,6,13,4,2024-06-13,DL,9168,JFK,BWI,"New York, NY",New York,"Baltimore, MD",Maryland,1170,972,-9,-10,1161,962,22,17,1183,945,2647,323,343,362,0,,0,0.0,0.0,0.0,0.0,0.0
2024,11,9,6,2024-11-09,YX,4305,EWR,BWI,"Newark, NJ",New Jersey,"Baltimore, MD",Maryland,1481,2035,-18,-10,1463,2025,8,16,1471,2009,1302,163,183,187,0,,0,0.0,0.0,0.0,0.0,0.0
2024,1,21,7,2024-01-21,B6,5271,STL,BOS,"St. Louis, MO",Missouri,"Boston, MA",Massachusetts,2046,1875,8,0,2054,1875,8,4,2062,1871,1948,236,256,248,0,,0,0.0,0.0,0.0,0.0,0.0
2024,3,22,5,2024-03-22,G4,7882,MIA,SLC,"Miami, FL",Florida,"Salt Lake City, UT",Utah,1522,1615,1,0,1523,1615,17,3,1540,1612,739,94,114,114,0,,0,0.0,0.0,0.0,0.0,0.0
2024,3,9,6,2024-03-09,WN,2760,EWR,SLC,"Newark, NJ",New Jersey,"Salt Lake City, UT",Utah,1053,613,33,30,1086,643,11,4,1097,639,1365,179,199,194,0,,0,11.0,2.0,0.0,0.0,17.0
2024,5,10,5,2024-05-10,YX,6956,IAD,TPA,"Washington, DC",District of Columbia,"Tampa, FL",Florida,1758,814,-5,5,1753,819,27,15,1780,804,988,125,145,167,0,,0,0.0,0.0,0.0,0.0,0.0
2024,3,27,3,2024-03-27,9E,6189,SAN,LAX,"San Diego, CA",California,"Los Angeles, CA",California,630,1135,-6,0,624,1135,23,15,647,1120,1439,185,205,223,0,,0,0.0,0.0,0.0,0.0,0.0
2024,8,5,1,2024-08-05,DL,5418,EWR,STL,"Newark, NJ",New Jersey,"St. Louis, MO",Missouri,1196,1643,11,15,1207,1658,8,16,1215,1642,576,73,93,97,0,,0,0.0,0.0,0.0,0.0,0.0
2024,10,31,4,2024-10-31,UA,2652,SEA,SFO,"Seattle, WA",Washington,"San Francisco, CA",California,1537,1527,19,10,1556,1537,5,14,1561,1523,1197,148,168,167,1,,0,0.0,0.0,0.0,0.0,0.0
2024,12,10,2,2024-12-10,UA,3711,SFO,SAN,"San Francisco, CA",California,"San Diego, CA",California,1313,2111,8,0,1321,2111,12,4,1333,2107,1382,175,195,191,0,,0,0.0,0.0,0.0,0.0,0.0
2024,12,6,5,2024-12-06,G4,8162,EWR,MCO,"Newark, NJ",New Jersey,"Orlando, FL",Florida,2289,2337,-5,0,2284,2337,16,4,2300,2333,221,27,47,47,0,,0,0.0,0.0,0.0,0.0,0.0
2024,6,9,7,2024-06-09,WN,1140,MDW,SLC,"Chicago, IL",Illinois,"Salt Lake City, UT",Utah,1158,1035,22,15,1180,1050,16,16,1196,1034,224,25,45,57,0,,0,0.0,0.0,0.0,0.0,0.0
2024,6,26,3,2024-06-26,HA,8606,MCO,PDX,"Orlando, FL",Florida,"Portland, OR",Oregon,879,1944,-5,0,874,1944,24,9,898,1935,1781,224,244,257,0,,0,0.0,0.0,0.0,0.0,0.0
2024,4,26,5,2024-04-26,AA,7703,SFO,PDX,"San Francisco, CA",California,"Portland, OR",Oregon,1583,1590,5,5,1588,1595,15,6,1603,1589,1265,153,173,174,0,,0,0.0,0.0,0.0,0.0,0.0
2024,7,14,7,2024-07-14,AA,4272,ATL,IAD,"Atlanta, GA",Georgia,"Washington, DC",District of Columbia,1426,1675,-23,-15,1403,1660,25,13,1428,1647,2123,266,286,304,0,,0,0.0,0.0,0.0,0.0,0.0
2024,11,22,5,2024-11-22,HA,3046,MCO,MIA,"Orlando, FL",Florida,"Miami, FL",Florida,1815,956,3,5,1818,961,25,9,1843,952,2792,354,374,388,0,,0,0.0,0.0,0.0,0.0,0.0
2024,3,26,2,2024-03-26,NK,3336,DEN,MCO,"Denver, CO",Colorado,"Orlando, FL",Florida,1683,2321,-18,-10,1665,2311,21,3,1686,2308,2754,340,360,364,0,,0,0.0,0.0,0.0,0.0,0.0
2024,10,15,2,2024-10-15,NK,3780,PDX,MCO,"Portland, OR",Oregon,"Orlando, FL",Florida,1970,1318,-20,-15,1950,1303,21,15,1971,1288,1835,219,239,255,0,,0,0.0,0.0,0.0,0.0,0.0
2024,3,21,4,2024-03-21,DL,4907,SEA,PHX,"Seattle, WA",Washington,"Phoenix, AZ",Arizona,1037,1471,8,10,1045,1481,27,10,1072,1471,545,62,82,99,0,,0,0.0,0.0,0.0,0.0,0.0
2024,5,31,5,2024-05-31,G4,1637,IAD,MDW,"Washington, DC",District of Columbia,"Chicago, IL",Illinois,1076,1206,2,5,1078,1211,16,18,1094,1193,2173,276,296,310,0,,0,0.0,0.0,0.0,0.0,0.0
2024,3,1,5,2024-03-01,G4,3972,STL,JFK,"St. Louis, MO",Missouri,"New York, NY",New York,1909,1971,-14,-5,1895,1966,16,18,1911,1948,2148,273,293,307,0,,0,0.0,0.0,0.0,0.0,0.0
2024,3,1,5,2024-03-01,B6,1967,SFO,CLT,"San Francisco, CA",California,"Charlotte, NC",North Carolina,1593,1377,3,-5,1596,1372,21,15,1617,1357,1014,130,150,166,0,,0,0.0,0.0,0.0,0.0,0.0
2024,12,19,4,2024-12-19,HA,1261,MCO,MDW,"Orlando, FL",Florida,"Chicago, IL",Illinois,1905,925,-5,-10,1900,915,13,9,1913,906,2829,358,378,380,0,,0,0.0,0.0,0.0,0.0,0.0
2024,1,28,7,2024-01-28,HA,4020,DFW,MSP,"Dallas/Fort Worth, TX",Texas,"Minneapolis, MN",Minnesota,1184,1126,-26,-20,1158,1106,26,7,1184,1099,666,78,98,111,0,,0,0.0,0.0,0.0,0.0,0.0
2024,2,12,1,2024-02-12,UA,5793,PHX,SFO,"Phoenix, AZ",Arizona,"San Francisco, CA",California,1748,1286,-6,-5,1742,1281,17,4,1759,1277,2745,340,360,361,0,,0,0.0,0.0,0.0,0.0,0.0
2024,6,17,1,2024-06-17,UA,3982,DFW,SEA,"Dallas/Fort Worth, TX",Texas,"Seattle, WA",Washington,2031,818,-6,-15,2025,803,21,11,2046,792,352,50,70,82,0,,0,0.0,0.0,0.0,0.0,0.0
2024,3,26,2,2024-03-26,YX,7838,ATL,DFW,"Atlanta, GA",Georgia,"Dallas/Fort Worth, TX",Texas,2188,1121,-4,-5,2184,1116,5,18,2189,1098,401,47,67,70,0,,0,0.0,0.0,0.0,0.0,0.0
2024,6,25,2,2024-06-25,UA,8556,SAN,IAH,"San Diego, CA",California,"Houston, TX",Texas,539,1004,11,10,550,1014,25,6,575,1008,759,90,110,121,0,,0,0.0,0.0,0.0,0.0,0.0
2024,1,17,3,2024-01-17,AS,6431,SLC,JFK,"Salt Lake City, UT",Utah,"New York, NY",New York,1669,1642,-20,-15,1649,1627,7,12,1656,1615,306,29,49,48,0,,0,0.0,0.0,0.0,0.0,0.0
2024,4,7,7,2024-04-07,WN,5282,PHL,DFW,"Philadelphia, PA",Pennsylvania,"Dallas/Fort Worth, TX",Texas,865,1179,-12,-15,853,1164,12,5,865,1159,2711,340,360,357,0,,0,0.0,0.0,0.0,0.0,0.0
2024,7,16,2,2024-07-16,F9,9594,DFW,IAD,"Dallas/Fort Worth, TX",Texas,"Washington, DC",District of Columbia,2133,1389,11,15,2144,1404,12,3,2156,1401,2616,320,340,335,0,,0,0.0,0.0,0.0,0.0,0.0
2024,4,7,7,2024-04-07,HA,9486,HNL,TPA,"Honolulu, HI",Hawaii,"Tampa, FL",Florida,747,893,-5,5,742,898,12,9,754,889,2473,309,329,330,0,,0,0.0,0.0,0.0,0.0,0.0
2024,3,5,2,2024-03-05,MQ,1626,SFO,SAN,"San Francisco, CA",California,"San Diego, CA",California,511,614,-12,-15,499,599,10,5,509,594,1141,135,155,150,0,,0,0.0,0.0,0.0,0.0,0.0
2024,11,25,1,2024-11-25,OO,8231,BWI,DFW,"Baltimore, MD",Maryland,"Dallas/Fort Worth, TX",Texas,2059,925,-11,-15,2048,910,19,13,2067,897,2351,292,312,324,0,,0,0.0,0.0,0.0,0.0,0.0
2024,12,6,5,2024-12-06,MQ,4494,ORD,SLC,"Chicago, IL",Illinois,"Salt Lake City, UT",Utah,1236,2249,7,5,1243,2254,25,15,1268,2239,2045,260,280,300,0,,0,0.0,0.0,0.0,0.0,0.0
2024,1,5,5,2024-01-05,OO,1258,SEA,SAN,"Seattle, WA",Washington,"San Diego, CA",California,1009,1570,-15,-5,994,1565,9,19,1003,1546,1800,216,236,244,0,,0,0.0,0.0,0.0,0.0,0.0
2024,1,2,2,2024-01-02,OO,4467,SAN,LAS,"San Diego, CA",California,"Las Vegas, NV",Nevada,1768,757,14,5,1782,762,10,12,1792,750,2751,341,361,363,0,,0,0.0,0.0,0.0,0.0,0.0
2024,1,22,1,2024-01-22,B6,4730,CLT,LGA,"Charlotte, NC",North Carolina,"New York, NY",New York,670,1727,3,-5,673,1722,26,10,699,1712,2693,326,346,362,0,,0,0.0,0.0,0.0,0.0,0.0
2024,4,21,7,2024-04-21,AA,3613,EWR,SLC,"Newark, NJ",New Jersey,"Salt Lake City, UT",Utah,1555,2221,28,20,1583,2241,29,10,1612,2231,1019,122,142,161,0,,0,4.0,1.0,1.0,0.0,14.0
2024,2,26,1,2024-02-26,G4,1244,HNL,PHL,"Honolulu, HI",Hawaii,"Philadelphia, PA",Pennsylvania,2149,2229,0,5,2149,2234,27,11,2176,2223,1218,149,169,187,0,,0,0.0,0.0,0.0,0.0,0.0
2024,3,6,3,2024-03-06,AA,168,BWI,MCO,"Baltimore, MD",Maryland,"Orlando, FL",Florida,1220,2309,-26,-20,1194,2289,10,14,1204,2275,346,36,56,60,0,,0,0.0,0.0,0.0,0.0,0.0
2024,11,25,1,2024-11-25,AS,3817,DEN,LGA,"Denver, CO",Colorado,"New York, NY",New York,1494,1499,1,-5,1495,1494,14,15,1509,1479,717,79,99,108,1,,0,0.0,0.0,0.0,0.0,0.0
2024,4,7,7,2024-04-07,AA,9118,LGA,ATL,"New York, NY",New York,"Atlanta, GA",Georgia,1314,1405,4,0,1318,1405,27,7,1345,1398,651,87,107,121,0,,0,0.0,0.0,0.0,0.0,0.0
2024,5,23,4,2024-05-23,UA,9461,SLC,DEN,"Salt Lake City, UT",Utah,"Denver, CO",Colorado,928,1905,-19,-15,909,1890,23,7,932,1883,1873,238,258,268,0,,0,0.0,0.0,0.0,0.0,0.0
2024,5,4,6,2024-05-04,HA,9275,ATL,LAX,"Atlanta, GA",Georgia,"Los Angeles, CA",California,1558,746,-14,-20,1544,726,6,6,1550,720,831,93,113,105,0,,0,0.0,0.0,0.0,0.0,0.0
2024,6,15,6,2024-06-15,9E,9744,MDW,DTW,"Chicago, IL",Illinois,"Detroit, MI",Michigan,704,1113,-14,-15,690,1098,11,4,701,1094,370,54,74,69,0,,0,0.0,0.0,0.0,0.0,0.0
2024,3,26,2,2024-03-26,B6,9331,MIA,TPA,"Miami, FL",Florida,"Tampa, FL",Florida,1389,1691,-4,0,1385,1691,23,17,1408,1674,766,98,118,138,0,,0,0.0,0.0,0.0,0.0,0.0
2024,3,16,6,2024-03-16,HA,4823,SAN,DCA,"San Diego, CA",California,"Washington, DC",District of Columbia,1907,1103,2,0,1909,1103,17,10,1926,1093,580,68,88,95,0,,0,0.0,0.0,0.0,0.0,0.0
2024,12,9,1,2024-12-09,9E,4313,MSP,ORD,"Minneapolis, MN",Minnesota,"Chicago, IL",Illinois,1404,1692,-18,-15,1386,1677,8,16,1394,1661,2878,350,370,374,0,,0,0.0,0.0,0.0,0.0,0.0
2024,10,20,7,2024-10-20,NK,6513,LGA,PDX,"New York, NY",New York,"Portland, OR",Oregon,1789,2182,-2,5,1787,2187,15,6,1802,2181,943,117,137,138,0,,0,0.0,0.0,0.0,0.0,0.0
2024,2,28,3,2024-02-28,OH,3566,LGA,BOS,"New York, NY",New York,"Boston, MA",Massachusetts,2100,1012,-3,0,2097,1012,22,14,2119,998,1872,239,259,275,0,,0,0.0,0.0,0.0,0.0,0.0
2024,5,17,5,2024-05-17,9E,3126,SEA,SFO,"Seattle, WA",Washington,"San Francisco, CA",California,1966,1687,20,15,1986,1702,25,8,2011,1694,1032,133,153,166,0,,0,0.0,0.0,0.0,0.0,0.0
2024,4,8,1,2024-04-08,F9,7098,DFW,CLT,"Dallas/Fort Worth, TX",Texas,"Charlotte, NC",North Carolina,2133,1191,15,10,2148,1201,25,10,2173,1191,890,106,126,141,0,,0,0.0,0.0,0.0,0.0,0.0
2024,7,10,3,2024-07-10,YX,2847,DCA,LAS,"Washington, DC",District of Columbia,"Las Vegas, NV",Nevada,1196,1365,15,15,1211,1380,15,11,1226,1369,1919,237,257,263,0,,0,0.0,0.0,0.0,0.0,0.0
2024,8,30,5,2024-08-30,G4,7371,IAD,HNL,"Washington, DC",District of Columbia,"Honolulu, HI",Hawaii,1249,836,18,20,1267,856,17,11,1284,845,920,108,128,136,0,,0,2.0,1.0,2.0,0.0,15.0
2024,11,14,4,2024-11-14,AS,6271,JFK,HNL,"New York, NY",New York,"Honolulu, HI",Hawaii,2008,995,-5,-5,2003,990,14,18,2017,972,432,56,76,88,0,,0,0.0,0.0,0.0,0.0,0.0
2024,2,18,7,2024-02-18,HA,3955,DTW,SEA,"Detroit, MI",Michigan,"Seattle, WA",Washington,1484,1762,-6,0,1478,1762,21,11,1499,1751,2630,325,345,357,0,,0,0.0,0.0,0.0,0.0,0.0
2024,2,1,4,2024-02-01,OO,8853,LAX,EWR,"Los Angeles, CA",California,"Newark, NJ",New Jersey,1993,1939,-11,-10,1982,1929,8,10,1990,1919,1080,127,147,145,0,,0,0.0,0.0,0.0,0.0,0.0
2024,10,3,4,2024-10-03,G4,2303,MSP,SFO,"Minneapolis, MN",Minnesota,"San Francisco, CA",California,1789,2289,-5,0,1784,2289,7,9,1791,2280,757,87,107,103,0,,0,0.0,0.0,0.0,0.0,0.0
2024,1,20,6,2024-01-20,F9,3519,IAD,DCA,"Washington, DC",District of Columbia,"Washington, DC",District of Columbia,1485,2046,-5,-10,1480,2036,11,15,1491,2021,2608,323,343,349,0,,0,0.0,0.0,0.0,0.0,0.0
2024,6,2,7,2024-06-02,G4,1244,SFO,MSP,"San Francisco, CA",California,"Minneapolis, MN",Minnesota,2267,731,6,5,2273,736,20,7,2293,729,2007,259,279,286,0,,0,0.0,0.0,0.0,0.0,0.0
2024,3,8,5,2024-03-08,9E,2799,LGA,ATL,"New York, NY",New York,"Atlanta, GA",Georgia,1632,825,-23,-20,1609,805,25,9,1634,796,1301,157,177,191,0,,0,0.0,0.0,0.0,0.0,0.0
2024,8,1,4,2024-08-01,WN,9843,PHX,CLT,"Phoenix, AZ",Arizona,"Charlotte, NC",North Carolina,2012,2227,-8,-10,2004,2217,10,8,2014,2209,2806,341,361,359,1,,0,0.0,0.0,0.0,0.0,0.0
2024,5,22,3,2024-05-22,G4,660,DFW,TPA,"Dallas/Fort Worth, TX",Texas,"Tampa, FL",Florida,1701,2096,-8,-10,1693,2086,22,12,1715,2074,643,71,91,105,0,,0,0.0,0.0,0.0,0.0,0.0
2024,8,19,1,2024-08-19,HA,1287,PHX,DTW,"Phoenix, AZ",Arizona,"Detroit, MI",Michigan,748,717,20,15,768,732,5,17,773,715,768,89,109,111,0,,0,0.0,0.0,0.0,0.0,0.0
2024,7,31,3,2024-07-31,NK,3233,SEA,MCO,"Seattle, WA",Washington,"Orlando, FL",Florida,1528,1237,-15,-15,1513,1222,23,19,1536,1203,2310,296,316,338,0,,0,0.0,0.0,0.0,0.0,0.0
2024,3,19,2,2024-03-19,B6,3511,BWI,MSP,"Baltimore, MD",Maryland,"Minneapolis, MN",Minnesota,1680,938,7,10,1687,948,14,15,1701,933,1509,190,210,219,0,,0,0.0,0.0,0.0,0.0,0.0
2024,8,1,4,2024-08-01,B6,1789,HNL,ORD,"Honolulu, HI",Hawaii,"Chicago, IL",Illinois,729,1018,-13,-15,716,1003,7,3,723,1000,673,76,96,86,0,,0,0.0,0.0,0.0,0.0,0.0
2024,4,25,4,2024-04-25,AA,4507,MIA,CLT,"Miami, FL",Florida,"Charlotte, NC",North Carolina,1127,2058,-5,5,1122,2063,27,11,1149,2052,2331,286,306,324,0,,0,0.0,0.0,0.0,0.0,0.0
2024,4,1,1,2024-04-01,DL,2523,LAS,SAN,"Las Vegas, NV",Nevada,"San Diego, CA",California,1784,1802,4,-5,1788,1797,15,8,1803,1789,204,24,44,47,0,,0,0.0,0.0,0.0,0.0,0.0
2024,9,26,4,2024-09-26,9E,1469,TPA,JFK,"Tampa, FL",Florida,"New York, NY",New York,1327,1061,4,-5,1331,1056,11,6,1342,1050,1878,238,258,255,0,,0,0.0,0.0,0.0,0.0,0.0
2024,6,16,7,2024-06-16,UA,6107,SAN,EWR,"San Diego, CA",California,"Newark, NJ",New Jersey,820,2220,98,90,918,2310,10,8,928,2302,2836,349,369,367,0,,0,18.0,1.0,1.0,1.0,69.0
2024,2,27,2,2024-02-27,OH,6828,ATL,DFW,"Atlanta, GA",Georgia,"Dallas/Fort Worth, TX",Texas,1650,1275,-17,-10,1633,1265,18,12,1651,1253,626,75,95,105,0,,0,0.0,0.0,0.0,0.0,0.0
2024,10,10,4,2024-10-10,OH,8872,MSP,HNL,"Minneapolis, MN",Minnesota,"Honolulu, HI",Hawaii,527,1317,-19,-10,508,1307,24,5,532,1302,210,19,39,48,0,,0,0.0,0.0,0.0,0.0,0.0
2024,1,26,5,2024-01-26,F9,1076,MSP,HNL,"Minneapolis, MN",Minnesota,"Honolulu, HI",Hawaii,1350,1727,8,0,1358,1727,12,16,1370,1711,1093,130,150,158,0,,0,0.0,0.0,0.0,0.0,0.0
2024,3,6,3,2024-03-06,AS,4372,DTW,EWR,"Detroit, MI",Michigan,"Newark, NJ",New Jersey,1009,713,13,5,1022,718,15,4,1037,714,2227,286,306,305,0,,0,0.0,0.0,0.0,0.0,0.0
2024,9,4,3,2024-09-04,YX,6597,BOS,MDW,"Boston, MA",Massachusetts,"Chicago, IL",Illinois,727,2323,29,30,756,2353,6,11,762,2342,1991,253,273,270,0,,0,2.0,5.0,5.0,0.0,18.0
2024,9,10,2,2024-09-10,9E,218,PHL,DFW,"Philadelphia, PA",Pennsylvania,"Dallas/Fort Worth, TX",Texas,1140,1894,11,5,1151,1899,11,4,1162,1895,2298,287,307,302,0,,0,0.0,0.0,0.0,0.0,0.0
2024,2,13,2,2024-02-13,OO,1642,MCO,MSP,"Orlando, FL",Florida,"Minneapolis, MN",Minnesota,1040,1162,9,0,1049,1162,21,17,1070,1145,1619,198,218,236,0,,0,0.0,0.0,0.0,0.0,0.0
2024,4,6,6,2024-04-06,MQ,4962,LAX,DFW,"Los Angeles, CA",California,"Dallas/Fort Worth, TX",Texas,1702,905,-8,-5,1694,900,28,15,1722,885,2750,336,356,379,0,,0,0.0,0.0,0.0,0.0,0.0
2024,2,11,7,2024-02-11,HA,3143,BWI,IAD,"Baltimore, MD",Maryland,"Washington, DC",District of Columbia,2199,2357,-2,0,2197,2357,9,14,2206,2343,2620,323,343,346,0,,0,0.0,0.0,0.0,0.0,0.0
2024,8,14,3,2024-08-14,OH,1072,IAH,MIA,"Houston, TX",Texas,"Miami, FL",Florida,1171,1222,7,0,1178,1222,10,19,1188,1203,639,80,100,109,0,,0,0.0,0.0,0.0,0.0,0.0
2024,9,18,3,2024-09-18,B6,1015,STL,PHX,"St. Louis, MO",Missouri,"Phoenix, AZ",Arizona,1409,654,-19,-10,1390,644,26,18,1416,626,1178,139,159,183,0,,0,0.0,0.0,0.0,0.0,0.0
2024,6,15,6,2024-06-15,MQ,6721,PHL,IAD,"Philadelphia, PA",Pennsylvania,"Washington, DC",District of Columbia,1811,1123,12,5,1823,1128,21,5,1844,1123,1626,205,225,231,0,,0,0.0,0.0,0.0,0.0,0.0
2024,10,5,6,2024-10-05,AA,9729,ATL,DCA,"Atlanta, GA",Georgia,"Washington, DC",District of Columbia,2017,1033,-13,-10,2004,1023,27,8,2031,1015,2120,260,280,295,0,,0,0.0,0.0,0.0,0.0,0.0
2024,3,29,5,2024-03-29,YX,686,LAS,BOS,"Las Vegas, NV",Nevada,"Boston, MA",Massachusetts,1788,789,-9,0,1779,789,19,12,1798,777,1877,235,255,266,0,,0,0.0,0.0,0.0,0.0,0.0
2024,6,26,3,2024-06-26,OO,8642,MIA,MCO,"Miami, FL",Florida,"Orlando, FL",Florida,1990,988,-5,-10,1985,978,7,7,1992,971,2825,346,366,360,0,,0,0.0,0.0,0.0,0.0,0.0
2024,7,15,1,2024-07-15,YX,5725,BWI,JFK,"Baltimore, MD",Maryland,"New York, NY",New York,1918,1266,-11,-5,1907,1261,22,16,1929,1245,1838,225,245,263,0,,0,0.0,0.0,0.0,0.0,0.0
2024,11,2,6,2024-11-02,G4,7454,SAN,IAH,"San Diego, CA",California,"Houston, TX",Texas,1955,1958,-1,0,1954,1958,19,10,1973,1948,1728,212,232,241,0,,0,0.0,0.0,0.0,0.0,0.0
2024,9,23,1,2024-09-23,UA,4691,PHL,PDX,"Philadelphia, PA",Pennsylvania,"Portland, OR",Oregon,1958,945,-17,-15,1941,930,27,18,1968,912,621,78,98,123,0,,0,0.0,0.0,0.0,0.0,0.0
2024,9,24,2,2024-09-24,UA,2662,EWR,PHX,"Newark, NJ",New Jersey,"Phoenix, AZ",Arizona,1911,864,-29,-20,1882,844,29,4,1911,840,379,50,70,83,0,,0,0.0,0.0,0.0,0.0,0.0
2024,3,14,4,2024-03-14,DL,6939,SLC,BOS,"Salt Lake City, UT",Utah,"Boston, MA",Massachusetts,1308,1471,-10,-15,1298,1456,8,11,1306,1445,1630,202,222,221,0,,0,0.0,0.0,0.0,0.0,0.0
2024,1,8,1,2024-01-08,WN,8564,EWR,BOS,"Newark, NJ",New Jersey,"Boston, MA",Massachusetts,2060,1727,-5,-10,2055,1717,27,3,2082,1714,2341,288,308,318,0,,0,0.0,0.0,0.0,0.0,0.0
2024,10,23,3,2024-10-23,YX,3027,LAS,MSP,"Las Vegas, NV",Nevada,"Minneapolis, MN",Minnesota,1668,2298,-4,-10,1664,2288,25,11,1689,2277,2824,347,367,383,0,,0,0.0,0.0,0.0,0.0,0.0
2024,6,12,3,2024-06-12,DL,6295,MIA,PHL,"Miami, FL",Florida,"Philadelphia, PA",Pennsylvania,1698,740,-4,5,1694,745,14,9,1708,736,2253,275,295,298,0,,0,0.0,0.0,0.0,0.0,0.0
2024,3,25,1,2024-03-25,MQ,6376,JFK,PHX,"New York, NY",New York,"Phoenix, AZ",Arizona,1019,1348,-11,-5,1008,1343,15,5,1023,1338,1643,213,233,233,0,,0,0.0,0.0,0.0,0.0,0.0
2024,3,12,2,2024-03-12,G4,4390,HNL,SLC,"Honolulu, HI",Hawaii,"Salt Lake City, UT",Utah,1837,1155,-3,0,1834,1155,27,3,1861,1152,2749,344,364,374,0,,0,0.0,0.0,0.0,0.0,0.0
2024,2,24,6,2024-02-24,YX,5982,ATL,EWR,"Atlanta, GA",Georgia,"Newark, NJ",New Jersey,2144,838,-9,0,2135,838,5,15,2140,823,1029,126,146,146,0,,0,0.0,0.0,0.0,0.0,0.0
2024,2,16,5,2024-02-16,9E,6546,SEA,CLT,"Seattle, WA",Washington,"Charlotte, NC",North Carolina,1652,2053,6,5,1658,2058,14,16,1672,2042,2946,358,378,388,0,,0,0.0,0.0,0.0,0.0,0.0
2024,8,25,7,2024-08-25,NK,5267,DFW,BWI,"Dallas/Fort Worth, TX",Texas,"Baltimore, MD",Maryland,1013,2232,-18,-20,995,2212,29,3,1024,2209,2697,346,366,378,0,,0,0.0,0.0,0.0,0.0,0.0
2024,4,13,6,2024-04-13,F9,1622,SAN,IAH,"San Diego, CA",California,"Houston, TX",Texas,1533,1721,15,10,1548,1731,26,9,1574,1722,1207,150,170,185,0,,0,0.0,0.0,0.0,0.0,0.0
2024,7,28,7,2024-07-28,UA,9123,PDX,LAX,"Portland, OR",Oregon,"Los Angeles, CA",California,846,1435,24,30,870,1465,19,17,889,1448,1404,175,195,211,0,,0,6.0,1.0,0.0,0.0,23.0
2024,2,11,7,2024-02-11,AS,661,ATL,PDX,"Atlanta, GA",Georgia,"Portland, OR",Oregon,616,2084,-14,-15,602,2069,12,3,614,2066,2002,258,278,273,0,,0,0.0,0.0,0.0,0.0,0.0
2024,11,11,1,2024-11-11,HA,3640,DEN,MIA,"Denver, CO",Colorado,"Miami, FL",Florida,910,1569,9,5,919,1574,13,9,932,1565,818,106,126,128,0,,0,0.0,0.0,0.0,0.0,0.0
2024,9,24,2,2024-09-24,9E,1579,PHX,SEA,"Phoenix, AZ",Arizona,"Seattle, WA",Washington,1920,1164,-29,-20,1891,1144,5,4,1896,1140,2871,351,371,360,0,,0,0.0,0.0,0.0,0.0,0.0
2024,9,19,4,2024-09-19,AS,6777,LAX,PHL,"Los Angeles, CA",California,"Philadelphia, PA",Pennsylvania,1534,1220,-19,-20,1515,1200,25,16,1540,1184,2385,305,325,346,0,,0,0.0,0.0,0.0,0.0,0.0
2024,12,1,7,2024-12-01,MQ,1305,STL,SFO,"St. Louis, MO",Missouri,"San Francisco, CA",California,1921,856,-11,-10,1910,846,16,9,1926,837,203,21,41,46,0,,0,0.0,0.0,0.0,0.0,0.0
2024,12,30,1,2024-12-30,AA,6760,MIA,BOS,"Miami, FL",Florida,"Boston, MA",Massachusetts,2131,1634,7,10,2138,1644,20,16,2158,1628,2158,274,294,310,0,,0,0.0,0.0,0.0,0.0,0.0
2024,9,15,7,2024-09-15,AS,8948,BWI,HNL,"Baltimore, MD",Maryland,"Honolulu, HI",Hawaii,1616,777,5,5,1621,782,11,17,1632,765,665,78,98,106,1,,0,0.0,0.0,0.0,0.0,0.0
2024,10,9,3,2024-10-09,MQ,689,DCA,ORD,"Washington, DC",District of Columbia,"Chicago, IL",Illinois,1625,2016,-4,-5,1621,2011,16,9,1637,2002,563,72,92,97,0,,0,0.0,0.0,0.0,0.0,0.0
2024,4,23,2,2024-04-23,OH,4426,EWR,TPA,"Newark, NJ",New Jersey,"Tampa, FL",Florida,597,1917,1,-5,598,1912,16,5,614,1907,2845,364,384,385,0,,0,0.0,0.0,0.0,0.0,0.0
2024,12,28,6,2024-12-28,UA,5004,MIA,JFK,"Miami, FL",Florida,"New York, NY",New York,781,1582,-4,0,777,1582,15,12,792,1570,773,99,119,126,0,,0,0.0,0.0,0.0,0.0,0.0
2024,2,9,5,2024-02-09,OO,9663,TPA,BOS,"Tampa, FL",Florida,"Boston, MA",Massachusetts,1306,996,-1,-5,1305,991,20,14,1325,977,1735,207,227,241,0,,0,0.0,0.0,0.0,0.0,0.0
2024,8,7,3,2024-08-07,UA,6521,PHX,HNL,"Phoenix, AZ",Arizona,"Honolulu, HI",Hawaii,1359,2012,18,10,1377,2022,12,11,1389,2011,2673,333,353,356,0,,0,0.0,0.0,0.0,0.0,0.0
2024,5,8,3,2024-05-08,UA,3859,LGA,IAD,"New York, NY",New York,"Washington, DC",District of Columbia,2191,1136,-9,0,2182,1136,23,10,2205,1126,1469,188,208,221,0,,0,0.0,0.0,0.0,0.0,0.0
2024,1,8,1,2024-01-08,9E,9039,MDW,TPA,"Chicago, IL",Illinois,"Tampa, FL",Florida,1156,1237,-5,0,1151,1237,12,12,1163,1225,1594,195,215,219,0,,0,0.0,0.0,0.0,0.0,0.0
2024,4,10,3,2024-04-10,OO,8755,BOS,PDX,"Boston, MA",Massachusetts,"Portland, OR",Oregon,1944,865,-9,0,1935,865,9,19,1944,846,2390,301,321,329,0,,0,0.0,0.0,0.0,0.0,0.0
2024,6,24,1,2024-06-24,HA,9045,PHL,DFW,"Philadelphia, PA",Pennsylvania,"Dallas/Fort Worth, TX",Texas,1887,1756,18,15,1905,1771,21,11,1926,1760,2890,351,371,383,0,,0,0.0,0.0,0.0,0.0,0.0
2024,4,16,2,2024-04-16,OO,6036,EWR,DFW,"Newark, NJ",New Jersey,"Dallas/Fort Worth, TX",Texas,710,1901,2,5,712,1906,20,12,732,1894,2199,264,284,296,0,,0,0.0,0.0,0.0,0.0,0.0
2024,4,10,3,2024-04-10,HA,8874,CLT,DFW,"Charlotte, NC",North Carolina,"Dallas/Fort Worth, TX",Texas,2190,2177,-10,-15,2180,2162,8,17,2188,2145,1251,156,176,181,0,,0,0.0,0.0,0.0,0.0,0.0
2024,9,16,1,2024-09-16,9E,2305,ATL,TPA,"Atlanta, GA",Georgia,"Tampa, FL",Florida,2277,1584,3,-5,2280,1579,22,6,2302,1573,1660,210,230,238,1,,0,0.0,0.0,0.0,0.0,0.0
2024,9,2,1,2024-09-02,OO,4214,EWR,STL,"Newark, NJ",New Jersey,"St. Louis, MO",Missouri,1007,1724,-3,-10,1004,1714,16,9,1020,1705,951,112,132,137,0,,0,0.0,0.0,0.0,0.0,0.0
2024,10,1,2,2024-10-01,F9,4127,PHX,HNL,"Phoenix, AZ",Arizona,"Honolulu, HI",Hawaii,1599,1003,32,30,1631,1033,25,18,1656,1015,2929,360,380,403,0,,0,1.0,8.0,1.0,0.0,20.0
2024,2,1,4,2024-02-01,MQ,4916,PHL,DFW,"Philadelphia, PA",Pennsylvania,"Dallas/Fort Worth, TX",Texas,1846,1907,-10,-5,1836,1902,8,10,1844,1892,214,18,38,36,0,,0,0.0,0.0,0.0,0.0,0.0
2024,5,16,4,2024-05-16,B6,7288,SAN,JFK,"San Diego, CA",California,"New York, NY",New York,951,1900,-22,-15,929,1885,22,16,951,1869,2287,288,308,326,0,,0,0.0,0.0,0.0,0.0,0.0
2024,1,12,5,2024-01-12,WN,2908,IAD,PHX,"Washington, DC",District of Columbia,"Phoenix, AZ",Arizona,1186,738,-6,-5,1180,733,11,9,1191,724,1697,217,237,237,0,,0,0.0,0.0,0.0,0.0,0.0
2024,10,28,1,2024-10-28,MQ,3703,BWI,SFO,"Baltimore, MD",Maryland,"San Francisco, CA",California,1122,1844,-1,-5,1121,1839,6,16,1127,1823,233,36,56,58,0,,0,0.0,0.0,0.0,0.0,0.0
2024,1,16,2,2024-01-16,G4,4013,SEA,TPA,"Seattle, WA",Washington,"Tampa, FL",Florida,1470,668,1,0,1471,668,6,8,1477,660,2795,348,368,362,0,,0,0.0,0.0,0.0,0.0,0.0
2024,5,8,3,2024-05-08,G4,1519,DTW,DFW,"Detroit, MI",Michigan,"Dallas/Fort Worth, TX",Texas,1429,1404,-1,-10,1428,1394,17,11,1445,1383,2530,310,330,338,0,,0,0.0,0.0,0.0,0.0,0.0
2024,3,3,7,2024-03-03,AA,2267,TPA,ATL,"Tampa, FL",Florida,"Atlanta, GA",Georgia,517,776,-19,-20,498,756,8,16,506,740,597,65,85,89,0,,0,0.0,0.0,0.0,0.0,0.0
2024,4,18,4,2024-04-18,DL,2244,JFK,CLT,"New York, NY",New York,"Charlotte, NC",North Carolina,1814,1996,-19,-15,1795,1981,9,18,1804,1963,441,54,74,81,0,,0,0.0,0.0,0.0,0.0,0.0
2024,1,21,7,2024-01-21,F9,2267,IAD,EWR,"Washington, DC",District of Columbia,"Newark, NJ",New Jersey,1285,2332,-15,-10,1270,2322,16,6,1286,2316,330,44,64,66,1,,0,0.0,0.0,0.0,0.0,0.0
2024,6,6,4,2024-06-06,B6,9852,SAN,HNL,"San Diego, CA",California,"Honolulu, HI",Hawaii,2273,1144,-11,-5,2262,1139,15,5,2277,1134,2378,300,320,320,0,,0,0.0,0.0,0.0,0.0,0.0
2024,9,25,3,2024-09-25,NK,9468,IAH,CLT,"Houston, TX",Texas,"Charlotte, NC",North Carolina,697,900,18,10,715,910,7,15,722,895,1033,133,153,155,0,,0,0.0,0.0,0.0,0.0,0.0
2024,6,10,1,2024-06-10,AA,9560,STL,SLC,"St. Louis, MO",Missouri,"Salt Lake City, UT",Utah,1685,1851,-7,-10,1678,1841,15,18,1693,1823,2435,305,325,338,0,,0,0.0,0.0,0.0,0.0,0.0
2024,9,16,1,2024-09-16,YX,5991,SFO,DCA,"San Francisco, CA",California,"Washington, DC",District of Columbia,916,2271,-30,-20,886,2251,13,6,899,2245,621,75,95,94,0,,0,0.0,0.0,0.0,0.0,0.0
2024,4,11,4,2024-04-11,9E,6636,LAX,TPA,"Los Angeles, CA",California,"Tampa, FL",Florida,883,1995,5,5,888,2000,26,5,914,1995,2731,332,352,363,0,,0,0.0,0.0,0.0,0.0,0.0
2024,8,10,6,2024-08-10,YX,1266,SLC,SAN,"Salt Lake City, UT",Utah,"San Diego, CA",California,699,1614,3,10,702,1624,12,9,714,1615,1865,237,257,258,0,,0,0.0,0.0,0.0,0.0,0.0
2024,2,28,3,2024-02-28,B6,3675,ORD,DFW,"Chicago, IL",Illinois,"Dallas/Fort Worth, TX",Texas,2269,1245,3,0,2272,1245,25,17,2297,1228,2362,304,324,346,0,,0,0.0,0.0,0.0,0.0,0.0
2024,9,3,2,2024-09-03,OO,2941,TPA,CLT,"Tampa, FL",Florida,"Charlotte, NC",North Carolina,1394,998,-3,-10,1391,988,12,4,1403,984,662,87,107,103,0,,0,0.0,0.0,0.0,0.0,0.0
2024,5,7,2,2024-05-07,YX,1970,PDX,MDW,"Portland, OR",Oregon,"Chicago, IL",Illinois,2021,1766,0,5,2021,1771,14,11,2035,1760,2057,266,286,291,0,,0,0.0,0.0,0.0,0.0,0.0
2024,10,9,3,2024-10-09,UA,2986,MDW,SEA,"Chicago, IL",Illinois,"Seattle, WA",Washington,1479,1356,-26,-20,1453,1336,10,5,1463,1331,299,34,54,49,0,,0,0.0,0.0,0.0,0.0,0.0
2024,11,20,3,2024-11-20,9E,259,SLC,LGA,"Salt Lake City, UT",Utah,"New York, NY",New York,1566,1760,21,15,1587,1775,27,12,1614,1763,1699,219,239,258,0,,0,0.0,0.0,0.0,0.0,0.0
2024,1,25,4,2024-01-25,YX,7343,PDX,DFW,"Portland, OR",Oregon,"Dallas/Fort Worth, TX",Texas,581,1172,6,10,587,1182,22,17,609,1165,917,113,133,152,0,,0,0.0,0.0,0.0,0.0,0.0
2024,5,10,5,2024-05-10,YX,3863,MDW,LGA,"Chicago, IL",Illinois,"New York, NY",New York,2062,655,0,0,2062,655,10,18,2072,637,2218,275,295,303,0,,0,0.0,0.0,0.0,0.0,0.0
2024,12,18,3,2024-12-18,OH,1155,MIA,ATL,"Miami, FL",Florida,"Atlanta, GA",Georgia,1827,2268,-7,-10,1820,2258,25,15,1845,2243,1103,138,158,178,0,,0,0.0,0.0,0.0,0.0,0.0
2024,7,14,7,2024-07-14,DL,433,SAN,TPA,"San Diego, CA",California,"Tampa, FL",Florida,2104,981,-29,-20,2075,961,16,14,2091,947,2855,363,383,393,0,,0,0.0,0.0,0.0,0.0,0.0
2024,10,7,1,2024-10-07,DL,3696,DFW,MSP,"Dallas/Fort Worth, TX",Texas,"Minneapolis, MN",Minnesota,1722,1070,126,120,1848,1190,20,14,1868,1176,965,129,149,163,0,,0,22.0,15.0,12.0,0.0,71.0
2024,6,2,7,2024-06-02,G4,7707,SLC,IAD,"Salt Lake City, UT",Utah,"Washington, DC",District of Columbia,1929,1831,-4,5,1925,1836,28,3,1953,1833,2011,243,263,274,0,,0,0.0,0.0,0.0,0.0,0.0
2024,5,12,7,2024-05-12,MQ,9183,SAN,TPA,"San Diego, CA",California,"Tampa, FL",Florida,1950,2261,-1,-5,1949,2256,25,17,1974,2239,2490,310,330,352,0,,0,0.0,0.0,0.0,0.0,0.0
2024,8,14,3,2024-08-14,WN,1462,MSP,EWR,"Minneapolis, MN",Minnesota,"Newark, NJ",New Jersey,1984,1234,-24,-20,1960,1214,20,3,1980,1211,278,31,51,54,0,,0,0.0,0.0,0.0,0.0,0.0
2024,7,7,7,2024-07-07,WN,1025,PHL,LAS,"Philadelphia, PA",Pennsylvania,"Las Vegas, NV",Nevada,1383,1342,-8,0,1375,1342,27,10,1402,1332,390,38,58,75,0,,0,0.0,0.0,0.0,0.0,0.0
2024,9,21,6,2024-09-21,NK,5619,MSP,ORD,"Minneapolis, MN",Minnesota,"Chicago, IL",Illinois,979,634,25,30,1004,664,8,18,1012,646,1045,126,146,152,0,,0,8.0,5.0,5.0,0.0,12.0
2024,5,13,1,2024-05-13,9E,2543,MCO,DCA,"Orlando, FL",Florida,"Washington, DC",District of Columbia,1227,1889,3,5,1230,1894,22,18,1252,1876,1024,126,146,166,0,,0,0.0,0.0,0.0,0.0,0.0
2024,7,29,1,2024-07-29,9E,4080,EWR,PHL,"Newark, NJ",New Jersey,"Philadelphia, PA",Pennsylvania,623,2226,-16,-15,607,2211,17,5,624,2206,1946,245,265,267,0,,0,0.0,0.0,0.0,0.0,0.0
2024,2,29,4,2024-02-29,MQ,7360,CLT,SEA,"Charlotte, NC",North Carolina,"Seattle, WA",Washington,1027,1575,-8,-5,1019,1570,7,16,1026,1554,1027,133,153,156,0,,0,0.0,0.0,0.0,0.0,0.0
2024,12,29,7,2024-12-29,DL,1519,DTW,IAD,"Detroit, MI",Michigan,"Washington, DC",District of Columbia,2161,620,-19,-15,2142,605,16,11,2158,594,1755,214,234,241,0,,0,0.0,0.0,0.0,0.0,0.0
2024,12,29,7,2024-12-29,UA,159,MDW,MSP,"Chicago, IL",Illinois,"Minneapolis, MN",Minnesota,1025,1763,5,15,1030,1778,24,14,1054,1764,1726,218,238,256,0,,0,0.0,0.0,0.0,0.0,0.0
2024,7,31,3,2024-07-31,UA,2624,PHL,SFO,"Philadelphia, PA",Pennsylvania,"San Francisco, CA",California,538,864,-6,-5,532,859,23,18,555,841,314,29,49,70,0,,0,0.0,0.0,0.0,0.0,0.0
2024,8,3,6,2024-08-03,AS,3897,DTW,IAD,"Detroit, MI",Michigan,"Washington, DC",District of Columbia,1722,2023,12,5,1734,2028,27,3,1761,2025,2727,331,351,361,0,,0,0.0,0.0,0.0,0.0,0.0
2024,8,13,2,2024-08-13,UA,1678,CLT,MSP,"Charlotte, NC",North Carolina,"Minneapolis, MN",Minnesota,607,1056,-10,-15,597,1041,9,9,606,1032,1749,219,239,237,0,,0,0.0,0.0,0.0,0.0,0.0
2024,5,10,5,2024-05-10,OO,7301,IAH,PHL,"Houston, TX",Texas,"Philadelphia, PA",Pennsylvania,767,1743,-22,-15,745,1728,23,13,768,1715,2333,286,306,322,0,,0,0.0,0.0,0.0,0.0,0.0
2024,3,16,6,2024-03-16,B6,807,LAS,BWI,"Las Vegas, NV",Nevada,"Baltimore, MD",Maryland,1876,2356,3,5,1879,2361,23,5,1902,2356,933,107,127,135,0,,0,0.0,0.0,0.0,0.0,0.0
2024,10,12,6,2024-10-12,WN,8265,SFO,LAS,"San Francisco, CA",California,"Las Vegas, NV",Nevada,810,1549,17,10,827,1559,29,12,856,1547,1093,130,150,171,0,,0,0.0,0.0,0.0,0.0,0.0
2024,10,3,4,2024-10-03,UA,5377,SLC,MCO,"Salt Lake City, UT",Utah,"Orlando, FL",Florida,1913,982,-10,-10,1903,972,16,14,1919,958,2797,348,368,378,0,,0,0.0,0.0,0.0,0.0,0.0
2024,6,4,2,2024-06-04,F9,1880,JFK,DEN,"New York, NY",New York,"Denver, CO",Colorado,539,1134,-4,-5,535,1129,29,10,564,1119,1408,182,202,221,0,,0,0.0,0.0,0.0,0.0,0.0
2024,9,4,3,2024-09-04,OH,2513,PHL,PHX,"Philadelphia, PA",Pennsylvania,"Phoenix, AZ",Arizona,1280,1662,-3,0,1277,1662,9,5,1286,1657,1765,226,246,240,0,,0,0.0,0.0,0.0,0.0,0.0
2024,8,5,1,2024-08-05,9E,7850,LGA,IAD,"New York, NY",New York,"Washington, DC",District of Columbia,1080,2263,-5,5,1075,2268,6,4,1081,2264,959,114,134,124,0,,0,0.0,0.0,0.0,0.0,0.0
2024,7,8,1,2024-07-08,UA,2261,JFK,CLT,"New York, NY",New York,"Charlotte, NC",North Carolina,651,1583,-3,0,648,1583,20,9,668,1574,1790,213,233,242,0,,0,0.0,0.0,0.0,0.0,0.0
2024,6,11,2,2024-06-11,AS,8900,SFO,DFW,"San Francisco, CA",California,"Dallas/Fort Worth, TX",Texas,686,1645,-21,-15,665,1630,25,14,690,1616,1198,158,178,197,0,,0,0.0,0.0,0.0,0.0,0.0
2024,6,28,5,2024-06-28,MQ,408,CLT,SLC,"Charlotte, NC",North Carolina,"Salt Lake City, UT",Utah,929,2190,-10,0,919,2190,8,15,927,2175,1577,204,224,227,0,,0,0.0,0.0,0.0,0.0,0.0
2024,2,3,6,2024-02-03,HA,5539,ATL,STL,"Atlanta, GA",Georgia,"St. Louis, MO",Missouri,956,646,2,10,958,656,26,13,984,643,2962,368,388,407,0,,0,0.0,0.0,0.0,0.0,0.0
2024,2,10,6,2024-02-10,NK,4407,MCO,ATL,"Orlando, FL",Florida,"Atlanta, GA",Georgia,1252,1345,12,10,1264,1355,19,15,1283,1340,2580,328,348,362,0,,0,0.0,0.0,0.0,0.0,0.0
2024,11,2,6,2024-11-02,NK,2464,JFK,PHX,"New York, NY",New York,"Phoenix, AZ",Arizona,1750,1138,5,0,1755,1138,14,10,1769,1128,2825,361,381,385,0,,0,0.0,0.0,0.0,0.0,0.0
2024,12,3,2,2024-12-03,DL,284,EWR,LAX,"Newark, NJ",New Jersey,"Los Angeles, CA",California,1951,2007,61,60,2012,2067,26,7,2038,2060,2923,371,391,404,0,,0,13.0,8.0,5.0,1.0,33.0
2024,11,9,6,2024-11-09,OH,5424,TPA,DCA,"Tampa, FL",Florida,"Washington, DC",District of Columbia,703,2105,-19,-15,684,2090,10,10,694,2080,2711,340,360,360,0,,0,0.0,0.0,0.0,0.0,0.0
2024,3,15,5,2024-03-15,UA,5583,DTW,BOS,"Detroit, MI",Michigan,"Boston, MA",Massachusetts,1278,1671,-3,0,1275,1671,11,9,1286,1662,2685,325,345,345,0,,0,0.0,0.0,0.0,0.0,0.0
2024,10,5,6,2024-10-05,YX,345,HNL,MDW,"Honolulu, HI",Hawaii,"Chicago, IL",Illinois,617,1278,5,5,622,1283,6,7,628,1276,2151,270,290,283,0,,0,0.0,0.0,0.0,0.0,0.0
2024,6,24,1,2024-06-24,9E,8530,DCA,MIA,"Washington, DC",District of Columbia,"Miami, FL",Florida,1917,1583,-13,-15,1904,1568,8,11,1912,1557,1588,193,213,212,0,,0,0.0,0.0,0.0,0.0,0.0
2024,5,29,3,2024-05-29,9E,8283,MDW,BWI,"Chicago, IL",Illinois,"Baltimore, MD",Maryland,721,1704,20,20,741,1724,19,14,760,1710,1945,244,264,277,0,,0,2.0,0.0,2.0,0.0,16.0
2024,9,29,7,2024-09-29,HA,6024,SLC,SAN,"Salt Lake City, UT",Utah,"San Diego, CA",California,1396,2253,-12,-5,1384,2248,17,6,1401,2242,2263,277,297,300,0,,0,0.0,0.0,0.0,0.0,0.0
2024,11,20,3,2024-11-20,WN,619,MSP,EWR,"Minneapolis, MN",Minnesota,"Newark, NJ",New Jersey,562,644,-10,-5,552,639,13,5,565,634,2056,250,270,268,0,,0,0.0,0.0,0.0,0.0,0.0
2024,4,17,3,2024-04-17,NK,4007,IAD,PHX,"Washington, DC",District of Columbia,"Phoenix, AZ",Arizona,895,874,-2,-10,893,864,9,13,902,851,341,41,61,63,0,,0,0.0,0.0,0.0,0.0,0.0
2024,5,18,6,2024-05-18,DL,376,MIA,LAX,"Miami, FL",Florida,"Los Angeles, CA",California,504,2316,-13,-10,491,2306,21,4,512,2302,265,25,45,50,0,,0,0.0,0.0,0.0,0.0,0.0
2024,12,15,7,2024-12-15,UA,5201,DCA,ORD,"Washington, DC",District of Columbia,"Chicago, IL",Illinois,1857,1584,-5,0,1852,1584,10,11,1862,1573,909,118,138,139,0,,0,0.0,0.0,0.0,0.0,0.0
2024,9,27,5,2024-09-27,NK,8897,MCO,JFK,"Orlando, FL",Florida,"New York, NY",New York,1815,1934,1,-5,1816,1929,18,12,1834,1917,2174,261,281,291,0,,0,0.0,0.0,0.0,0.0,0.0
2024,12,12,4,2024-12-12,NK,4673,LAS,MDW,"Las Vegas, NV",Nevada,"Chicago, IL",Illinois,1007,831,-3,-10,1004,821,9,8,1013,813,755,91,111,108,0,,0,0.0,0.0,0.0,0.0,0.0
2024,10,15,2,2024-10-15,HA,4703,STL,SEA,"St. Louis, MO",Missouri,"Seattle, WA",Washington,644,685,2,10,646,695,6,11,652,684,2895,358,378,375,0,,0,0.0,0.0,0.0,0.0,0.0
2024,7,30,2,2024-07-30,9E,4153,SLC,SEA,"Salt Lake City, UT",Utah,"Seattle, WA",Washington,1453,1728,-14,-15,1439,1713,18,6,1457,1707,2433,313,333,337,0,,0,0.0,0.0,0.0,0.0,0.0
2024,9,28,6,2024-09-28,UA,6912,ATL,DCA,"Atlanta, GA",Georgia,"Washington, DC",District of Columbia,1161,776,14,10,1175,786,23,6,1198,780,238,20,40,49,0,,0,0.0,0.0,0.0,0.0,0.0
2024,3,6,3,2024-03-06,YX,6173,MCO,BOS,"Orlando, FL",Florida,"Boston, MA",Massachusetts,1682,2213,-14,-10,1668,2203,23,19,1691,2184,626,74,94,116,0,,0,0.0,0.0,0.0,0.0,0.0
2024,9,4,3,2024-09-04,AA,241,CLT,LAS,"Charlotte, NC",North Carolina,"Las Vegas, NV",Nevada,1280,1237,2,0,1282,1237,27,15,1309,1222,263,29,49,71,0,,0,0.0,0.0,0.0,0.0,0.0
2024,6,4,2,2024-06-04,YX,1817,MSP,DCA,"Minneapolis, MN",Minnesota,"Washington, DC",District of Columbia,1458,1812,-6,-5,1452,1807,17,5,1469,1802,2240,277,297,299,0,,1,0.0,0.0,0.0,0.0,0.0
2024,2,16,5,2024-02-16,UA,7413,PHL,TPA,"Philadelphia, PA",Pennsylvania,"Tampa, FL",Florida,1462,1683,8,0,1470,1683,25,6,1495,1677,1308,172,192,203,0,,0,0.0,0.0,0.0,0.0,0.0
2024,7,19,5,2024-07-19,B6,5814,STL,HNL,"St. Louis, MO",Missouri,"Honolulu, HI",Hawaii,510,1843,3,5,513,1848,16,9,529,1839,1883,225,245,250,0,,0,0.0,0.0,0.0,0.0,0.0
2024,5,27,1,2024-05-27,NK,499,JFK,SFO,"New York, NY",New York,"San Francisco, CA",California,568,1187,31,30,599,1217,29,12,628,1205,1481,187,207,228,0,,0,5.0,7.0,5.0,0.0,13.0
2024,5,3,5,2024-05-03,WN,4863,SFO,LAS,"San Francisco, CA",California,"Las Vegas, NV",Nevada,2227,1202,-5,-5,2222,1197,5,15,2227,1182,498,60,80,80,0,,0,0.0,0.0,0.0,0.0,0.0
2024,1,1,1,2024-01-01,MQ,9814,PDX,MCO,"Portland, OR",Oregon,"Orlando, FL",Florida,2137,1739,-3,0,2134,1739,7,6,2141,1733,1775,227,247,240,0,,0,0.0,0.0,0.0,0.0,0.0
2024,9,3,2,2024-09-03,MQ,9626,MIA,BOS,"Miami, FL",Florida,"Boston, MA",Massachusetts,1463,2093,-2,0,1461,2093,14,9,1475,2084,2305,285,305,308,0,,0,0.0,0.0,0.0,0.0,0.0
2024,12,8,7,2024-12-08,OO,6355,IAD,PHL,"Washington, DC",District of Columbia,"Philadelphia, PA",Pennsylvania,2067,1790,83,90,2150,1880,12,13,2162,1867,1051,131,151,156,0,,0,35.0,10.0,3.0,2.0,40.0
2024,5,7,2,2024-05-07,OO,338,STL,DTW,"St. Louis, MO",Missouri,"Detroit, MI",Michigan,701,1237,19,10,720,1247,17,18,737,1229,2333,285,305,320,0,,0,0.0,0.0,0.0,0.0,0.0
2024,7,9,2,2024-07-09,HA,3315,DEN,JFK,"Denver, CO",Colorado,"New York, NY",New York,765,2068,-11,-5,754,2063,23,14,777,2049,2516,316,336,353,0,,0,0.0,0.0,0.0,0.0,0.0
2024,3,7,4,2024-03-07,AA,7641,HNL,MDW,"Honolulu, HI",Hawaii,"Chicago, IL",Illinois,607,1856,-4,0,603,1856,7,8,610,1848,2759,345,365,360,0,,0,0.0,0.0,0.0,0.0,0.0
2024,1,4,4,2024-01-04,AS,3747,LGA,SLC,"New York, NY",New York,"Salt Lake City, UT",Utah,1577,713,-12,-10,1565,703,28,7,1593,696,2370,293,313,328,0,,0,0.0,0.0,0.0,0.0,0.0
2024,10,29,2,2024-10-29,DL,5508,EWR,SFO,"Newark, NJ",New Jersey,"San Francisco, CA",California,1450,1598,-2,5,1448,1603,7,15,1455,1588,1331,156,176,178,0,,0,0.0,0.0,0.0,0.0,0.0
2024,10,20,7,2024-10-20,YX,9908,ATL,HNL,"Atlanta, GA",Georgia,"Honolulu, HI",Hawaii,1861,2131,11,10,1872,2141,22,3,1894,2138,1446,172,192,197,0,,0,0.0,0.0,0.0,0.0,0.0
2024,5,22,3,2024-05-22,UA,6440,PHL,PDX,"Philadelphia, PA",Pennsylvania,"Portland, OR",Oregon,689,1211,21,20,710,1231,7,17,717,1214,1118,144,164,168,0,,0,2.0,0.0,1.0,0.0,17.0
2024,7,9,2,2024-07-09,WN,2529,LGA,HNL,"New York, NY",New York,"Honolulu, HI",Hawaii,738,750,-5,0,733,750,16,10,749,740,1633,199,219,225,0,,0,0.0,0.0,0.0,0.0,0.0
2024,1,21,7,2024-01-21,AS,3752,BOS,LGA,"Boston, MA",Massachusetts,"New York, NY",New York,1450,1183,7,5,1457,1188,6,13,1463,1175,946,118,138,137,0,,0,0.0,0.0,0.0,0.0,0.0
2024,8,14,3,2024-08-14,AS,6407,BWI,LGA,"Baltimore, MD",Maryland,"New York, NY",New York,842,1587,-7,-5,835,1582,12,3,847,1579,421,46,66,61,0,,0,0.0,0.0,0.0,0.0,0.0
2024,11,8,5,2024-11-08,NK,9564,BOS,JFK,"Boston, MA",Massachusetts,"New York, NY",New York,790,969,-2,0,788,969,25,3,813,966,2883,356,376,384,0,,0,0.0,0.0,0.0,0.0,0.0
2024,4,26,5,2024-04-26,B6,5240,MDW,PHX,"Chicago, IL",Illinois,"Phoenix, AZ",Arizona,1846,1972,-13,-5,1833,1967,18,14,1851,1953,528,70,90,102,0,,0,0.0,0.0,0.0,0.0,0.0
2024,10,28,1,2024-10-28,NK,2978,MIA,EWR,"Miami, FL",Florida,"Newark, NJ",New Jersey,820,1574,7,5,827,1579,23,18,850,1561,1646,207,227,248,0,,0,0.0,0.0,0.0,0.0,0.0
2024,5,21,2,2024-05-21,DL,1635,HNL,PHX,"Honolulu, HI",Hawaii,"Phoenix, AZ",Arizona,541,1790,-25,-20,516,1770,15,10,531,1760,881,104,124,129,0,,0,0.0,0.0,0.0,0.0,0.0
2024,2,8,4,2024-02-08,AA,8827,DCA,DFW,"Washington, DC",District of Columbia,"Dallas/Fort Worth, TX",Texas,1454,671,-13,-20,1441,651,20,16,1461,635,444,51,71,87,0,,0,0.0,0.0,0.0,0.0,0.0
2024,12,20,5,2024-12-20,YX,6354,TPA,BOS,"Tampa, FL",Florida,"Boston, MA",Massachusetts,1721,1459,8,5,1729,1464,18,9,1747,1455,2791,356,376,383,0,,0,0.0,0.0,0.0,0.0,0.0
2024,9,8,7,2024-09-08,9E,1048,LAX,DFW,"Los Angeles, CA",California,"Dallas/Fort Worth, TX",Texas,1388,952,6,15,1394,967,12,15,1406,952,2031,248,268,275,0,,0,0.0,0.0,0.0,0.0,0.0
2024,11,28,4,2024-11-28,F9,4041,IAD,DCA,"Washington, DC",District of Columbia,"Washington, DC",District of Columbia,1132,1634,-5,0,1127,1634,28,15,1155,1619,275,41,61,84,0,,0,0.0,0.0,0.0,0.0,0.0
2024,7,25,4,2024-07-25,AA,9313,SLC,BOS,"Salt Lake City, UT",Utah,"Boston, MA",Massachusetts,1345,1409,14,5,1359,1414,24,11,1383,1403,2963,360,380,395,0,,0,0.0,0.0,0.0,0.0,0.0
2024,7,28,7,2024-07-28,YX,6703,CLT,ATL,"Charlotte, NC",North Carolina,"Atlanta, GA",Georgia,783,1340,6,10,789,1350,18,5,807,1345,290,43,63,66,0,,0,0.0,0.0,0.0,0.0,0.0
2024,4,24,3,2024-04-24,DL,8725,JFK,SLC,"New York, NY",New York,"Salt Lake City, UT",Utah,1306,1237,-8,-5,1298,1232,29,5,1327,1227,501,71,91,105,0,,0,0.0,0.0,0.0,0.0,0.0
2024,8,12,1,2024-08-12,OO,1503,LAS,HNL,"Las Vegas, NV",Nevada,"Honolulu, HI",Hawaii,681,752,-16,-15,665,737,16,16,681,721,737,92,112,124,0,,0,0.0,0.0,0.0,0.0,0.0
2024,5,13,1,2024-05-13,YX,7919,ATL,DEN,"Atlanta, GA",Georgia,"Denver, CO",Colorado,2135,1785,17,15,2152,1800,21,11,2173,1789,306,37,57,69,0,,0,0.0,0.0,0.0,0.0,0.0
2024,9,7,6,2024-09-07,9E,3611,DFW,PHX,"Dallas/Fort Worth, TX",Texas,"Phoenix, AZ",Arizona,1534,985,5,15,1539,1000,27,18,1566,982,1429,173,193,218,0,,0,0.0,0.0,0.0,0.0,0.0
2024,8,6,2,2024-08-06,AS,3035,PDX,TPA,"Portland, OR",Oregon,"Tampa, FL",Florida,1244,1290,-11,-5,1233,1285,16,7,1249,1278,594,68,88,91,0,,0,0.0,0.0,0.0,0.0,0.0
2024,3,31,7,2024-03-31,AA,4978,ATL,BOS,"Atlanta, GA",Georgia,"Boston, MA",Massachusetts,941,1767,-19,-10,922,1757,25,15,947,1742,2857,348,368,388,0,,0,0.0,0.0,0.0,0.0,0.0
2024,12,19,4,2024-12-19,9E,7606,HNL,DEN,"Honolulu, HI",Hawaii,"Denver, CO",Colorado,1128,738,3,10,1131,748,16,10,1147,738,878,114,134,140,0,,0,0.0,0.0,0.0,0.0,0.0
2024,2,15,4,2024-02-15,UA,7691,DTW,DCA,"Detroit, MI",Michigan,"Washington, DC",District of Columbia,1947,805,6,5,1953,810,16,11,1969,799,2262,274,294,301,0,,0,0.0,0.0,0.0,0.0,0.0
2024,2,7,3,2024-02-07,NK,5160,BOS,STL,"Boston, MA",Massachusetts,"St. Louis, MO",Missouri,2023,695,-26,-20,1997,675,11,11,2008,664,392,40,60,62,0,,0,0.0,0.0,0.0,0.0,0.0
2024,5,21,2,2024-05-21,YX,3433,LAX,CLT,"Los Angeles, CA",California,"Charlotte, NC",North Carolina,887,1325,-11,-15,876,1310,14,12,890,1298,2922,364,384,390,0,,0,0.0,0.0,0.0,0.0,0.0
2024,4,9,2,2024-04-09,F9,1702,SLC,JFK,"Salt Lake City, UT",Utah,"New York, NY",New York,1075,2204,29,30,1104,2234,20,11,1124,2223,700,78,98,109,0,,0,0.0,1.0,0.0,0.0,29.0
2024,11,23,6,2024-11-23,WN,8520,MSP,CLT,"Minneapolis, MN",Minnesota,"Charlotte, NC",North Carolina,2211,1979,-14,-20,2197,1959,28,14,2225,1945,205,34,54,76,0,,0,0.0,0.0,0.0,0.0,0.0
2024,7,8,1,2024-07-08,YX,2296,SEA,IAH,"Seattle, WA",Washington,"Houston, TX",Texas,953,2094,-7,-10,946,2084,7,14,953,2070,2362,296,316,317,0,,0,0.0,0.0,0.0,0.0,0.0
2024,2,4,7,2024-02-04,UA,210,LGA,EWR,"New York, NY",New York,"Newark, NJ",New Jersey,2118,917,-4,0,2114,917,7,13,2121,904,1974,237,257,257,1,,0,0.0,0.0,0.0,0.0,0.0
2024,5,26,7,2024-05-26,AA,9536,SFO,ORD,"San Francisco, CA",California,"Chicago, IL",Illinois,1426,1111,-19,-10,1407,1101,5,9,1412,1092,1178,151,171,165,0,,0,0.0,0.0,0.0,0.0,0.0
2024,1,30,2,2024-01-30,YX,6123,DFW,PHL,"Dallas/Fort Worth, TX",Texas,"Philadelphia, PA",Pennsylvania,1525,618,-18,-10,1507,608,9,3,1516,605,294,43,63,55,0,,0,0.0,0.0,0.0,0.0,0.0
2024,11,29,5,2024-11-29,G4,4259,LGA,SAN,"New York, NY",New York,"San Diego, CA",California,1310,2036,-12,-5,1298,2031,12,9,1310,2022,2970,363,383,384,0,,0,0.0,0.0,0.0,0.0,0.0
2024,3,24,7,2024-03-24,9E,3967,ATL,PHL,"Atlanta, GA",Georgia,"Philadelphia, PA",Pennsylvania,2252,1006,-5,-10,2247,996,21,3,2268,993,2239,269,289,293,0,,0,0.0,0.0,0.0,0.0,0.0
2024,10,7,1,2024-10-07,AS,9669,PHL,LAS,"Philadelphia, PA",Pennsylvania,"Las Vegas, NV",Nevada,1765,1568,15,10,1780,1578,20,16,1800,1562,2142,261,281,297,0,,0,0.0,0.0,0.0,0.0,0.0
2024,12,9,1,2024-12-09,AS,7741,ATL,SEA,"Atlanta, GA",Georgia,"Seattle, WA",Washington,1308,2025,-8,0,1300,2025,20,15,1320,2010,2266,283,303,318,1,,0,0.0,0.0,0.0,0.0,0.0
2024,9,26,4,2024-09-26,G4,5104,SAN,LAX,"San Diego, CA",California,"Los Angeles, CA",California,1583,1462,-4,-10,1579,1452,22,15,1601,1437,724,99,119,136,1,,0,0.0,0.0,0.0,0.0,0.0
2024,6,2,7,2024-06-02,AA,8304,CLT,HNL,"Charlotte, NC",North Carolina,"Honolulu, HI",Hawaii,867,700,1,-5,868,695,22,19,890,676,1157,144,164,185,0,,0,0.0,0.0,0.0,0.0,0.0
2024,4,11,4,2024-04-11,AS,7177,DFW,LGA,"Dallas/Fort Worth, TX",Texas,"New York, NY",New York,2238,1192,-11,-20,2227,1172,18,10,2245,1162,2371,286,306,314,0,,0,0.0,0.0,0.0,0.0,0.0
2024,8,2,5,2024-08-02,YX,3361,EWR,IAH,"Newark, NJ",New Jersey,"Houston, TX",Texas,1441,1294,-24,-20,1417,1274,16,19,1433,1255,463,53,73,88,0,,0,0.0,0.0,0.0,0.0,0.0
2024,5,29,3,2024-05-29,B6,762,PHX,PDX,"Phoenix, AZ",Arizona,"Portland, OR",Oregon,539,617,2,5,541,622,14,15,555,607,2624,330,350,359,0,,0,0.0,0.0,0.0,0.0,0.0
2024,3,23,6,2024-03-23,MQ,8985,MIA,TPA,"Miami, FL",Florida,"Tampa, FL",Florida,1838,1778,-7,-15,1831,1763,6,19,1837,1744,1315,157,177,182,0,,0,0.0,0.0,0.0,0.0,0.0
2024,4,19,5,2024-04-19,OO,3490,PHX,MIA,"Phoenix, AZ",Arizona,"Miami, FL",Florida,1056,728,-4,0,1052,728,25,17,1077,711,2815,359,379,401,0,,0,0.0,0.0,0.0,0.0,0.0
2024,10,1,2,2024-10-01,HA,9473,DFW,ORD,"Dallas/Fort Worth, TX",Texas,"Chicago, IL",Illinois,1821,1591,0,10,1821,1601,27,4,1848,1597,316,39,59,70,0,,0,0.0,0.0,0.0,0.0,0.0
2024,7,19,5,2024-07-19,AS,3118,MSP,DFW,"Minneapolis, MN",Minnesota,"Dallas/Fort Worth, TX",Texas,2154,1938,0,-5,2154,1933,7,15,2161,1918,1517,181,201,203,1,,0,0.0,0.0,0.0,0.0,0.0
2024,10,10,4,2024-10-10,OH,9796,MCO,TPA,"Orlando, FL",Florida,"Tampa, FL",Florida,1416,965,2,-5,1418,960,5,10,1423,950,2609,320,340,335,0,,0,0.0,0.0,0.0,0.0,0.0
2024,6,21,5,2024-06-21,OO,2002,IAH,IAD,"Houston, TX",Texas,"Washington, DC",District of Columbia,1520,1061,7,10,1527,1071,13,5,1540,1066,1797,220,240,238,0,,0,0.0,0.0,0.0,0.0,0.0
2024,11,22,5,2024-11-22,F9,4271,TPA,LAX,"Tampa, FL",Florida,"Los Angeles, CA",California,1142,1784,6,10,1148,1794,29,9,1177,1785,1412,166,186,204,0,,0,0.0,0.0,0.0,0.0,0.0
2024,7,24,3,2024-07-24,B6,428,DFW,DTW,"Dallas/Fort Worth, TX",Texas,"Detroit, MI",Michigan,949,2254,9,10,958,2264,8,19,966,2245,1641,205,225,232,0,,0,0.0,0.0,0.0,0.0,0.0
2024,3,3,7,2024-03-03,DL,9731,LAX,MIA,"Los Angeles, CA",California,"Miami, FL",Florida,894,1534,-9,0,885,1534,25,8,910,1526,2706,330,350,363,0,,0,0.0,0.0,0.0,0.0,0.0
2024,3,13,3,2024-03-13,YX,6395,PHL,MIA,"Philadelphia, PA",Pennsylvania,"Miami, FL",Florida,1291,1999,24,20,1315,2019,20,8,1335,2011,2721,348,368,376,0,,0,0.0,5.0,0.0,0.0,15.0
2024,9,7,6,2024-09-07,YX,3946,SFO,BWI,"San Francisco, CA",California,"Baltimore, MD",Maryland,2085,931,13,10,2098,941,8,13,2106,928,1782,226,246,247,0,,0,0.0,0.0,0.0,0.0,0.0
2024,5,3,5,2024-05-03,DL,324,LAX,DTW,"Los Angeles, CA",California,"Detroit, MI",Michigan,587,1284,-14,-5,573,1279,28,8,601,1271,2413,300,320,336,0,,0,0.0,0.0,0.0,0.0,0.0
2024,4,30,2,2024-04-30,9E,2620,LGA,SEA,"New York, NY",New York,"Seattle, WA",Washington,1032,2288,-4,0,1028,2288,21,4,1049,2284,1384,165,185,190,0,,0,0.0,0.0,0.0,0.0,0.0
2024,10,1,2,2024-10-01,B6,8164,LAX,ORD,"Los Angeles, CA",California,"Chicago, IL",Illinois,1911,1510,-14,-15,1897,1495,19,5,1916,1490,1066,129,149,153,0,,0,0.0,0.0,0.0,0.0,0.0
2024,4,29,1,2024-04-29,UA,3814,PHL,MIA,"Philadelphia, PA",Pennsylvania,"Miami, FL",Florida,1243,619,-6,0,1237,619,8,4,1245,615,1205,152,172,164,0,,0,0.0,0.0,0.0,0.0,0.0
2024,11,12,2,2024-11-12,9E,2507,BWI,DCA,"Baltimore, MD",Maryland,"Washington, DC",District of Columbia,880,1145,-15,-10,865,1135,8,5,873,1130,2658,327,347,340,0,,0,0.0,0.0,0.0,0.0,0.0
2024,6,12,3,2024-06-12,UA,6783,BWI,TPA,"Baltimore, MD",Maryland,"Tampa, FL",Florida,2078,1171,-5,-10,2073,1161,16,3,2089,1158,923,109,129,128,0,,0,0.0,0.0,0.0,0.0,0.0
2024,10,12,6,2024-10-12,F9,910,ORD,ATL,"Chicago, IL",Illinois,"Atlanta, GA",Georgia,930,1061,-14,-15,916,1046,7,9,923,1037,1491,184,204,200,0,,0,0.0,0.0,0.0,0.0,0.0
2024,9,21,6,2024-09-21,NK,6852,MDW,IAD,"Chicago, IL",Illinois,"Washington, DC",District of Columbia,2058,1781,-7,-5,2051,1776,24,18,2075,1758,2625,329,349,371,0,,0,0.0,0.0,0.0,0.0,0.0
2024,11,15,5,2024-11-15,AA,3217,LAS,LAX,"Las Vegas, NV",Nevada,"Los Angeles, CA",California,1739,1987,9,0,1748,1987,27,18,1775,1969,961,127,147,172,0,,0,0.0,0.0,0.0,0.0,0.0
2024,6,9,7,2024-06-09,YX,4873,ATL,SLC,"Atlanta, GA",Georgia,"Salt Lake City, UT",Utah,776,1508,1,0,777,1508,9,19,786,1489,2692,333,353,361,0,,0,0.0,0.0,0.0,0.0,0.0
2024,11,3,7,2024-11-03,MQ,3390,PHL,SFO,"Philadelphia, PA",Pennsylvania,"San Francisco, CA",California,693,2341,-6,-5,687,2336,23,3,710,2333,205,34,54,60,0,,0,0.0,0.0,0.0,0.0,0.0
2024,3,29,5,2024-03-29,YX,2351,JFK,LGA,"New York, NY",New York,"New York, NY",New York,2250,1204,11,5,2261,1209,10,9,2271,1200,1179,142,162,161,0,,0,0.0,0.0,0.0,0.0,0.0
2024,5,21,2,2024-05-21,B6,4761,CLT,LAS,"Charlotte, NC",North Carolina,"Las Vegas, NV",Nevada,678,2353,0,0,678,2353,13,11,691,2342,1438,186,206,210,0,,0,0.0,0.0,0.0,0.0,0.0
2024,7,21,7,2024-07-21,G4,4706,PHX,LAX,"Phoenix, AZ",Arizona,"Los Angeles, CA",California,1666,922,7,0,1673,922,7,5,1680,917,662,77,97,89,0,,0,0.0,0.0,0.0,0.0,0.0
2024,11,4,1,2024-11-04,WN,9215,LAS,MCO,"Las Vegas, NV",Nevada,"Orlando, FL",Florida,2061,688,-17,-10,2044,678,6,18,2050,660,582,79,99,103,0,,0,0.0,0.0,0.0,0.0,0.0
2024,8,14,3,2024-08-14,AA,6521,SEA,SLC,"Seattle, WA",Washington,"Salt Lake City, UT",Utah,717,772,2,10,719,782,29,5,748,777,1615,207,227,241,0,,0,0.0,0.0,0.0,0.0,0.0
2024,11,29,5,2024-11-29,F9,3152,JFK,BOS,"New York, NY",New York,"Boston, MA",Massachusetts,2034,639,8,0,2042,639,25,8,2067,631,717,89,109,122,0,,0,0.0,0.0,0.0,0.0,0.0
2024,8,9,5,2024-08-09,B6,8307,MIA,SAN,"Miami, FL",Florida,"San Diego, CA",California,1487,1533,5,10,1492,1543,14,16,1506,1527,387,41,61,71,0,,0,0.0,0.0,0.0,0.0,0.0
2024,2,10,6,2024-02-10,DL,4551,SLC,LAX,"Salt Lake City, UT",Utah,"Los Angeles, CA",California,1582,802,-13,-10,1569,792,9,5,1578,787,2401,304,324,318,0,,0,0.0,0.0,0.0,0.0,0.0
2024,7,14,7,2024-07-14,HA,5025,STL,EWR,"St. Louis, MO",Missouri,"Newark, NJ",New Jersey,1869,2356,-9,-5,1860,2351,11,8,1871,2343,2009,260,280,279,0,,0,0.0,0.0,0.0,0.0,0.0
2024,3,8,5,2024-03-08,YX,2746,LGA,BWI,"New York, NY",New York,"Baltimore, MD",Maryland,1056,2182,-11,-15,1045,2167,19,19,1064,2148,326,46,66,84,0,,0,0.0,0.0,0.0,0.0,0.0
2024,9,20,5,2024-09-20,AA,9393,MDW,HNL,"Chicago, IL",Illinois,"Honolulu, HI",Hawaii,1942,842,-9,-10,1933,832,6,6,1939,826,1649,207,227,219,0,,0,0.0,0.0,0.0,0.0,0.0
2024,1,2,2,2024-01-02,OH,9382,DEN,ORD,"Denver, CO",Colorado,"Chicago, IL",Illinois,1747,2129,-1,-5,1746,2124,14,6,1760,2118,2996,374,394,394,0,,0,0.0,0.0,0.0,0.0,0.0
2024,12,26,4,2024-12-26,YX,3006,LGA,LAX,"New York, NY",New York,"Los Angeles, CA",California,1873,687,8,10,1881,697,15,12,1896,685,2240,277,297,304,0,,0,0.0,0.0,0.0,0.0,0.0
2024,5,4,6,2024-05-04,YX,1846,EWR,TPA,"Newark, NJ",New Jersey,"Tampa, FL",Florida,1267,2292,-9,0,1258,2292,25,17,1283,2275,2616,333,353,375,0,,0,0.0,0.0,0.0,0.0,0.0
2024,4,19,5,2024-04-19,YX,4409,TPA,HNL,"Tampa, FL",Florida,"Honolulu, HI",Hawaii,2145,1273,4,-5,2149,1268,28,19,2177,1249,2053,250,270,297,0,,0,0.0,0.0,0.0,0.0,0.0
2024,3,26,2,2024-03-26,UA,548,LGA,TPA,"New York, NY",New York,"Tampa, FL",Florida,2285,1131,9,5,2294,1136,12,19,2306,1117,943,118,138,149,0,,0,0.0,0.0,0.0,0.0,0.0
2024,4,29,1,2024-04-29,G4,3112,ORD,PHX,"Chicago, IL",Illinois,"Phoenix, AZ",Arizona,576,1259,-13,-20,563,1239,27,13,590,1226,622,82,102,122,0,,0,0.0,0.0,0.0,0.0,0.0
2024,5,6,1,2024-05-06,AA,1668,PDX,PHX,"Portland, OR",Oregon,"Phoenix, AZ",Arizona,1098,1312,-3,-5,1095,1307,25,6,1120,1301,1114,144,164,175,0,,0,0.0,0.0,0.0,0.0,0.0
2024,9,11,3,2024-09-11,WN,3591,MCO,DTW,"Orlando, FL",Florida,"Detroit, MI",Michigan,2285,1774,5,0,2290,1774,16,15,2306,1759,1103,143,163,174,0,,0,0.0,0.0,0.0,0.0,0.0
2024,7,1,1,2024-07-01,F9,7410,IAH,ORD,"Houston, TX",Texas,"Chicago, IL",Illinois,1731,1723,4,0,1735,1723,8,16,1743,1707,2500,311,331,335,0,,0,0.0,0.0,0.0,0.0,0.0
2024,1,16,2,2024-01-16,F9,6983,PHL,LAX,"Philadelphia, PA",Pennsylvania,"Los Angeles, CA",California,1682,846,0,0,1682,846,17,13,1699,833,2911,362,382,392,0,,1,0.0,0.0,0.0,0.0,0.0
2024,3,2,6,2024-03-02,9E,6084,SFO,MSP,"San Francisco, CA",California,"Minneapolis, MN",Minnesota,1023,1224,-18,-10,1005,1214,22,8,1027,1206,1084,127,147,157,0,,0,0.0,0.0,0.0,0.0,0.0
2024,6,6,4,2024-06-06,YX,9339,HNL,ATL,"Honolulu, HI",Hawaii,"Atlanta, GA",Georgia,1748,1330,-6,-5,1742,1325,22,18,1764,1307,447,55,75,95,0,,0,0.0,0.0,0.0,0.0,0.0
2024,9,24,2,2024-09-24,OO,7188,STL,LGA,"St. Louis, MO",Missouri,"New York, NY",New York,1881,2160,21,15,1902,2175,7,13,1909,2162,215,27,47,47,0,,0,0.0,0.0,0.0,0.0,0.0
2024,2,4,7,2024-02-04,MQ,4868,MCO,DFW,"Orlando, FL",Florida,"Dallas/Fort Worth, TX",Texas,1312,1584,17,20,1329,1604,7,8,1336,1596,1620,211,231,226,0,,0,4.0,4.0,3.0,0.0,9.0
2024,9,23,1,2024-09-23,OO,1164,EWR,BWI,"Newark, NJ",New Jersey,"Baltimore, MD",Maryland,883,1095,-11,-5,872,1090,11,14,883,1076,1337,158,178,183,0,,0,0.0,0.0,0.0,0.0,0.0
2024,3,4,1,2024-03-04,F9,3921,JFK,BOS,"New York, NY",New York,"Boston, MA",Massachusetts,2067,1912,-3,0,2064,1912,26,16,2090,1896,1216,150,170,192,0,,0,0.0,0.0,0.0,0.0,0.0
2024,2,19,1,2024-02-19,9E,8859,PHX,DFW,"Phoenix, AZ",Arizona,"Dallas/Fort Worth, TX",Texas,2089,1014,-6,-10,2083,1004,21,11,2104,993,613,66,86,98,0,,0,0.0,0.0,0.0,0.0,0.0
2024,9,11,3,2024-09-11,F9,1536,DCA,IAH,"Washington, DC",District of Columbia,"Houston, TX",Texas,1003,1569,-5,-5,998,1564,10,12,1008,1552,1364,163,183,185,0,,0,0.0,0.0,0.0,0.0,0.0
2024,5,28,2,2024-05-28,WN,6197,SLC,BOS,"Salt Lake City, UT",Utah,"Boston, MA",Massachusetts,1973,1214,3,5,1976,1219,20,17,1996,1202,1948,242,262,279,0,,0,0.0,0.0,0.0,0.0,0.0
2024,11,20,3,2024-11-20,F9,2583,DFW,ATL,"Dallas/Fort Worth, TX",Texas,"Atlanta, GA",Georgia,741,678,-9,0,732,678,9,19,741,659,538,69,89,97,0,,0,0.0,0.0,0.0,0.0,0.0
2024,10,30,3,2024-10-30,G4,7819,CLT,PHX,"Charlotte, NC",North Carolina,"Phoenix, AZ",Arizona,868,2008,6,10,874,2018,26,15,900,2003,2402,308,328,349,0,,0,0.0,0.0,0.0,0.0,0.0
2024,10,2,3,2024-10-02,NK,4900,HNL,SLC,"Honolulu, HI",Hawaii,"Salt Lake City, UT",Utah,2150,2061,5,0,2155,2061,28,18,2183,2043,621,69,89,115,0,,0,0.0,0.0,0.0,0.0,0.0
2024,12,22,7,2024-12-22,OH,6482,CLT,JFK,"Charlotte, NC",North Carolina,"New York, NY",New York,1994,1127,-4,0,1990,1127,21,9,2011,1118,691,86,106,116,0,,0,0.0,0.0,0.0,0.0,0.0
2024,6,20,4,2024-06-20,YX,4929,CLT,DTW,"Charlotte, NC",North Carolina,"Detroit, MI",Michigan,787,1964,-27,-20,760,1944,15,8,775,1936,237,20,40,43,0,,0,0.0,0.0,0.0,0.0,0.0
2024,7,19,5,2024-07-19,DL,6253,MCO,SFO,"Orlando, FL",Florida,"San Francisco, CA",California,898,1682,-1,5,897,1687,26,15,923,1672,855,103,123,144,0,,0,0.0,0.0,0.0,0.0,0.0
2024,11,19,2,2024-11-19,G4,2894,HNL,ATL,"Honolulu, HI",Hawaii,"Atlanta, GA",Georgia,603,1305,23,20,626,1325,16,14,642,1311,1269,149,169,179,0,,0,2.0,2.0,0.0,0.0,16.0
2024,2,4,7,2024-02-04,OO,7712,SEA,DFW,"Seattle, WA",Washington,"Dallas/Fort Worth, TX",Texas,1834,1236,-4,0,1830,1236,16,17,1846,1219,1951,241,261,274,0,,0,0.0,0.0,0.0,0.0,0.0
2024,8,3,6,2024-08-03,F9,1197,IAD,MDW,"Washington, DC",District of Columbia,"Chicago, IL",Illinois,626,1498,-8,-10,618,1488,8,6,626,1482,2758,346,366,360,0,,0,0.0,0.0,0.0,0.0,0.0
2024,3,5,2,2024-03-05,MQ,1738,IAH,PHX,"Houston, TX",Texas,"Phoenix, AZ",Arizona,539,1510,27,20,566,1530,13,14,579,1516,1139,145,165,172,0,,0,2.0,4.0,1.0,0.0,13.0
2024,1,8,1,2024-01-08,B6,9950,IAD,BWI,"Washington, DC",District of Columbia,"Baltimore, MD",Maryland,1595,1143,-11,-10,1584,1133,18,12,1602,1121,2361,304,324,334,0,,0,0.0,0.0,0.0,0.0,0.0
2024,10,27,7,2024-10-27,HA,9417,MCO,SLC,"Orlando, FL",Florida,"Salt Lake City, UT",Utah,2270,1615,-14,-5,2256,1610,16,10,2272,1600,2967,375,395,401,0,,0,0.0,0.0,0.0,0.0,0.0
2024,12,8,7,2024-12-08,YX,8555,DTW,TPA,"Detroit, MI",Michigan,"Tampa, FL",Florida,1381,1289,-13,-15,1368,1274,14,16,1382,1258,1656,207,227,237,0,,0,0.0,0.0,0.0,0.0,0.0
2024,11,27,3,2024-11-27,UA,260,IAH,DFW,"Houston, TX",Texas,"Dallas/Fort Worth, TX",Texas,1444,818,-24,-15,1420,803,12,16,1432,787,1623,207,227,235,0,,0,0.0,0.0,0.0,0.0,0.0
2024,3,16,6,2024-03-16,NK,9548,JFK,BOS,"New York, NY",New York,"Boston, MA",Massachusetts,746,1723,-6,-10,740,1713,27,9,767,1704,2657,332,352,368,0,,0,0.0,0.0,0.0,0.0,0.0
2024,6,22,6,2024-06-22,OH,6006,BWI,BOS,"Baltimore, MD",Maryland,"Boston, MA",Massachusetts,1770,1594,-6,0,1764,1594,7,12,1771,1582,2199,281,301,300,0,,0,0.0,0.0,0.0,0.0,0.0
2024,2,16,5,2024-02-16,OH,8602,DTW,MIA,"Detroit, MI",Michigan,"Miami, FL",Florida,811,702,0,0,811,702,17,12,828,690,432,62,82,91,0,,0,0.0,0.0,0.0,0.0,0.0
2024,1,15,1,2024-01-15,HA,8518,PDX,TPA,"Portland, OR",Oregon,"Tampa, FL",Florida,533,1483,-5,0,528,1483,20,19,548,1464,2262,290,310,329,0,,0,0.0,0.0,0.0,0.0,0.0
2024,12,26,4,2024-12-26,DL,8564,PHX,DCA,"Phoenix, AZ",Arizona,"Washington, DC",District of Columbia,628,1229,8,0,636,1229,29,16,665,1213,1409,178,198,223,0,,0,0.0,0.0,0.0,0.0,0.0
2024,5,26,7,2024-05-26,MQ,7181,CLT,PHX,"Charlotte, NC",North Carolina,"Phoenix, AZ",Arizona,509,1354,4,0,513,1354,17,7,530,1347,2585,313,333,337,0,,0,0.0,0.0,0.0,0.0,0.0
2024,1,26,5,2024-01-26,UA,4512,ATL,LAS,"Atlanta, GA",Georgia,"Las Vegas, NV",Nevada,1691,1742,3,10,1694,1752,17,9,1711,1743,938,109,129,135,0,,0,0.0,0.0,0.0,0.0,0.0
2024,11,3,7,2024-11-03,YX,3257,PDX,MCO,"Portland, OR",Oregon,"Orlando, FL",Florida,1739,606,11,15,1750,621,23,19,1773,602,2406,304,324,346,0,,0,0.0,0.0,0.0,0.0,0.0
2024,4,2,2,2024-04-02,G4,2438,PHL,SFO,"Philadelphia, PA",Pennsylvania,"San Francisco, CA",California,1441,987,-4,-10,1437,977,26,4,1463,973,1586,207,227,237,0,,0,0.0,0.0,0.0,0.0,0.0
2024,8,19,1,2024-08-19,WN,5688,MDW,TPA,"Chicago, IL",Illinois,"Tampa, FL",Florida,1931,2101,-16,-15,1915,2086,22,6,1937,2080,1062,125,145,153,0,,0,0.0,0.0,0.0,0.0,0.0
2024,1,21,7,2024-01-21,WN,1701,ATL,HNL,"Atlanta, GA",Georgia,"Honolulu, HI",Hawaii,2275,2145,1,-5,2276,2140,12,11,2288,2129,2238,287,307,310,0,,0,0.0,0.0,0.0,0.0,0.0
2024,11,2,6,2024-11-02,UA,5988,MCO,SEA,"Orlando, FL",Florida,"Seattle, WA",Washington,2049,1427,-20,-20,2029,1407,5,10,2034,1397,2457,312,332,327,0,,0,0.0,0.0,0.0,0.0,0.0
2024,2,7,3,2024-02-07,B6,3818,BWI,MDW,"Baltimore, MD",Maryland,"Chicago, IL",Illinois,2125,1904,15,10,2140,1914,21,6,2161,1908,2743,341,361,368,0,,0,0.0,0.0,0.0,0.0,0.0
2024,10,2,3,2024-10-02,UA,5646,DFW,LAS,"Dallas/Fort Worth, TX",Texas,"Las Vegas, NV",Nevada,1434,641,-14,-10,1420,631,28,13,1448,618,1128,134,154,175,0,,0,0.0,0.0,0.0,0.0,0.0
2024,6,5,3,2024-06-05,G4,2025,IAD,JFK,"Washington, DC",District of Columbia,"New York, NY",New York,1541,2182,-3,0,1538,2182,13,9,1551,2173,1204,150,170,172,0,,0,0.0,0.0,0.0,0.0,0.0
2024,6,27,4,2024-06-27,HA,8858,PHX,PHL,"Phoenix, AZ",Arizona,"Philadelphia, PA",Pennsylvania,839,695,-10,-15,829,680,14,13,843,667,2378,290,310,317,0,,0,0.0,0.0,0.0,0.0,0.0
2024,5,11,6,2024-05-11,UA,3015,LAS,MSP,"Las Vegas, NV",Nevada,"Minneapolis, MN",Minnesota,1180,2127,5,0,1185,2127,13,5,1198,2122,2777,339,359,357,0,,0,0.0,0.0,0.0,0.0,0.0
2024,11,6,3,2024-11-06,DL,6998,MCO,DCA,"Orlando, FL",Florida,"Washington, DC",District of Columbia,2091,845,-27,-20,2064,825,16,14,2080,811,635,73,93,103,0,,0,0.0,0.0,0.0,0.0,0.0
2024,12,13,5,2024-12-13,YX,8543,LAX,CLT,"Los Angeles, CA",California,"Charlotte, NC",North Carolina,2199,1847,1,5,2200,1852,28,10,2228,1842,1059,133,153,171,1,,0,0.0,0.0,0.0,0.0,0.0
2024,1,28,7,2024-01-28,B6,5752,STL,MIA,"St. Louis, MO",Missouri,"Miami, FL",Florida,2187,713,26,20,2213,733,14,9,2227,724,1784,231,251,254,0,,0,5.0,4.0,1.0,0.0,10.0
2024,9,16,1,2024-09-16,AS,3601,MSP,ORD,"Minneapolis, MN",Minnesota,"Chicago, IL",Illinois,1613,1143,-13,-5,1600,1138,12,15,1612,1123,2412,298,318,325,0,,0,0.0,0.0,0.0,0.0,0.0
2024,3,16,6,2024-03-16,AA,7374,ORD,LAS,"Chicago, IL",Illinois,"Las Vegas, NV",Nevada,1808,929,-4,-10,1804,919,8,6,1812,913,2318,281,301,295,0,,0,0.0,0.0,0.0,0.0,0.0
2024,3,7,4,2024-03-07,OH,1702,DFW,TPA,"Dallas/Fort Worth, TX",Texas,"Tampa, FL",Florida,1033,2126,-5,-5,1028,2121,28,5,1056,2116,1507,187,207,220,0,,0,0.0,0.0,0.0,0.0,0.0
2024,12,7,6,2024-12-07,YX,7459,DFW,PDX,"Dallas/Fort Worth, TX",Texas,"Portland, OR",Oregon,1790,1776,-3,0,1787,1776,18,13,1805,1763,1255,164,184,195,0,,0,0.0,0.0,0.0,0.0,0.0
2024,7,12,5,2024-07-12,OO,613,BWI,TPA,"Baltimore, MD",Maryland,"Tampa, FL",Florida,1308,1840,-2,-10,1306,1830,11,8,1317,1822,368,36,56,55,0,,0,0.0,0.0,0.0,0.0,0.0
2024,6,10,1,2024-06-10,AS,8733,SAN,TPA,"San Diego, CA",California,"Tampa, FL",Florida,932,2112,6,10,938,2122,29,18,967,2104,619,81,101,128,0,,0,0.0,0.0,0.0,0.0,0.0
2024,12,12,4,2024-12-12,9E,8292,DCA,IAD,"Washington, DC",District of Columbia,"Washington, DC",District of Columbia,1257,871,-3,-10,1254,861,14,10,1268,851,285,39,59,63,0,,0,0.0,0.0,0.0,0.0,0.0
2024,12,26,4,2024-12-26,UA,6601,PDX,SFO,"Portland, OR",Oregon,"San Francisco, CA",California,1150,2023,-16,-20,1134,2003,28,13,1162,1990,2008,251,271,292,0,,0,0.0,0.0,0.0,0.0,0.0
2024,9,13,5,2024-09-13,WN,1002,CLT,BOS,"Charlotte, NC",North Carolina,"Boston, MA",Massachusetts,1575,1973,8,0,1583,1973,14,11,1597,1962,728,84,104,109,0,,0,0.0,0.0,0.0,0.0,0.0
2024,3,12,2,2024-03-12,AS,5819,SLC,MDW,"Salt Lake City, UT",Utah,"Chicago, IL",Illinois,1590,2045,-23,-15,1567,2030,19,3,1586,2027,2599,316,336,338,0,,0,0.0,0.0,0.0,0.0,0.0
2024,3,27,3,2024-03-27,F9,9512,DFW,SFO,"Dallas/Fort Worth, TX",Texas,"San Francisco, CA",California,1096,860,10,5,1106,865,19,9,1125,856,1791,229,249,257,0,,0,0.0,0.0,0.0,0.0,0.0
2024,9,18,3,2024-09-18,HA,8248,BOS,SAN,"Boston, MA",Massachusetts,"San Diego, CA",California,749,2142,-6,-10,743,2132,6,12,749,2120,945,124,144,142,0,,0,0.0,0.0,0.0,0.0,0.0
2024,8,1,4,2024-08-01,G4,2421,SFO,LAX,"San Francisco, CA",California,"Los Angeles, CA",California,1854,1316,4,10,1858,1326,28,11,1886,1315,338,42,62,81,0,,0,0.0,0.0,0.0,0.0,0.0
2024,6,1,6,2024-06-01,AS,955,DCA,MCO,"Washington, DC",District of Columbia,"Orlando, FL",Florida,1403,863,3,0,1406,863,20,15,1426,848,500,55,75,90,0,,0,0.0,0.0,0.0,0.0,0.0
2024,7,28,7,2024-07-28,NK,1117,DEN,SAN,"Denver, CO",Colorado,"San Diego, CA",California,914,1400,-9,0,905,1400,28,18,933,1382,2374,290,310,336,0,,0,0.0,0.0,0.0,0.0,0.0
2024,3,1,5,2024-03-01,HA,5379,CLT,HNL,"Charlotte, NC",North Carolina,"Honolulu, HI",Hawaii,1646,917,-17,-10,1629,907,14,6,1643,901,728,98,118,118,0,,0,0.0,0.0,0.0,0.0,0.0
2024,9,24,2,2024-09-24,OH,7812,MIA,SEA,"Miami, FL",Florida,"Seattle, WA",Washington,1725,2337,-6,-15,1719,2322,29,8,1748,2314,2439,296,316,333,0,,0,0.0,0.0,0.0,0.0,0.0
2024,9,18,3,2024-09-18,B6,4780,MIA,LAS,"Miami, FL",Florida,"Las Vegas, NV",Nevada,505,1739,2,0,507,1739,19,11,526,1728,2722,330,350,360,0,,0,0.0,0.0,0.0,0.0,0.0
2024,8,5,1,2024-08-05,OH,7172,IAH,ORD,"Houston, TX",Texas,"Chicago, IL",Illinois,1348,1835,-5,-10,1343,1825,23,14,1366,1811,2454,315,335,352,0,,0,0.0,0.0,0.0,0.0,0.0
2024,10,9,3,2024-10-09,YX,6724,DCA,MDW,"Washington, DC",District of Columbia,"Chicago, IL",Illinois,2009,759,-4,-5,2005,754,28,14,2033,740,1484,182,202,224,0,,0,0.0,0.0,0.0,0.0,0.0
2024,5,15,3,2024-05-15,HA,295,DCA,SEA,"Washington, DC",District of Columbia,"Seattle, WA",Washington,1722,1076,-6,0,1716,1076,28,3,1744,1073,306,39,59,70,0,,0,0.0,0.0,0.0,0.0,0.0
2024,12,27,5,2024-12-27,G4,4794,MCO,LAX,"Orlando, FL",Florida,"Los Angeles, CA",California,2259,1240,-9,-10,2250,1230,14,11,2264,1219,1556,195,215,220,0,,0,0.0,0.0,0.0,0.0,0.0
2024,4,2,2,2024-04-02,WN,9624,IAH,HNL,"Houston, TX",Texas,"Honolulu, HI",Hawaii,512,1458,2,5,514,1463,24,12,538,1451,2061,265,285,301,0,,0,0.0,0.0,0.0,0.0,0.0
2024,4,18,4,2024-04-18,9E,4751,SEA,PDX,"Seattle, WA",Washington,"Portland, OR",Oregon,505,747,9,15,514,762,19,19,533,743,241,33,53,71,0,,0,0.0,0.0,0.0,0.0,0.0
2024,8,28,3,2024-08-28,OO,7091,DTW,MDW,"Detroit, MI",Michigan,"Chicago, IL",Illinois,1934,2070,-13,-5,1921,2065,25,3,1946,2062,2971,377,397,405,0,,0,0.0,0.0,0.0,0.0,0.0
2024,12,20,5,2024-12-20,AS,9809,DCA,ORD,"Washington, DC",District of Columbia,"Chicago, IL",Illinois,1644,1701,17,15,1661,1716,6,3,1667,1713,2058,266,286,275,0,,0,0.0,0.0,0.0,0.0,0.0
2024,5,21,2,2024-05-21,B6,2797,BOS,SFO,"Boston, MA",Massachusetts,"San Francisco, CA",California,2080,1574,3,10,2083,1584,18,12,2101,1572,2595,323,343,353,0,,0,0.0,0.0,0.0,0.0,0.0
2024,10,17,4,2024-10-17,AA,1157,LGA,LAS,"New York, NY",New York,"Las Vegas, NV",Nevada,1885,1885,-13,-10,1872,1875,19,11,1891,1864,330,38,58,68,0,,0,0.0,0.0,0.0,0.0,0.0
2024,8,24,6,2024-08-24,B6,5307,PDX,LAX,"Portland, OR",Oregon,"Los Angeles, CA",California,1037,651,-17,-10,1020,641,26,11,1046,630,1033,133,153,170,0,,0,0.0,0.0,0.0,0.0,0.0
2024,12,5,4,2024-12-05,MQ,2892,BWI,DEN,"Baltimore, MD",Maryland,"Denver, CO",Colorado,503,857,-4,0,499,857,14,7,513,850,2752,352,372,373,0,,0,0.0,0.0,0.0,0.0,0.0
2024,11,7,4,2024-11-07,B6,520,PHX,MIA,"Phoenix, AZ",Arizona,"Miami, FL",Florida,783,1619,-8,0,775,1619,13,4,788,1615,1508,181,201,198,0,,0,0.0,0.0,0.0,0.0,0.0
2024,6,25,2,2024-06-25,OH,2914,LAX,HNL,"Los Angeles, CA",California,"Honolulu, HI",Hawaii,1221,2356,-12,-5,1209,2351,23,16,1232,2335,1102,141,161,180,0,,0,0.0,0.0,0.0,0.0,0.0
2024,5,20,1,2024-05-20,G4,2940,IAH,DTW,"Houston, TX",Texas,"Detroit, MI",Michigan,1515,2174,-8,-5,1507,2169,10,14,1517,2155,1843,224,244,248,0,,0,0.0,0.0,0.0,0.0,0.0
2024,7,7,7,2024-07-07,AA,1131,JFK,PHX,"New York, NY",New York,"Phoenix, AZ",Arizona,1882,847,-3,-5,1879,842,12,18,1891,824,2891,365,385,395,0,,0,0.0,0.0,0.0,0.0,0.0
2024,2,18,7,2024-02-18,HA,7739,PHL,SLC,"Philadelphia, PA",Pennsylvania,"Salt Lake City, UT",Utah,1192,887,7,5,1199,892,6,18,1205,874,1401,165,185,189,0,,0,0.0,0.0,0.0,0.0,0.0
2024,10,28,1,2024-10-28,B6,1591,PHL,PHX,"Philadelphia, PA",Pennsylvania,"Phoenix, AZ",Arizona,2288,1877,-17,-15,2271,1862,5,11,2276,1851,988,131,151,147,0,,0,0.0,0.0,0.0,0.0,0.0
2024,7,8,1,2024-07-08,HA,5075,BOS,MCO,"Boston, MA",Massachusetts,"Orlando, FL",Florida,1805,2251,14,5,1819,2256,17,12,1836,2244,1440,182,202,211,0,,0,0.0,0.0,0.0,0.0,0.0
2024,5,15,3,2024-05-15,NK,5047,DFW,ATL,"Dallas/Fort Worth, TX",Texas,"Atlanta, GA",Georgia,1156,1546,24,15,1180,1561,10,13,1190,1548,592,80,100,103,0,,0,0.0,0.0,0.0,0.0,0.0
2024,2,12,1,2024-02-12,OO,609,SFO,HNL,"San Francisco, CA",California,"Honolulu, HI",Hawaii,1451,2332,-1,5,1450,2337,7,7,1457,2330,1923,248,268,262,0,,0,0.0,0.0,0.0,0.0,0.0
2024,12,18,3,2024-12-18,AS,1959,SAN,MSP,"San Diego, CA",California,"Minneapolis, MN",Minnesota,1127,813,-7,-10,1120,803,6,18,1126,785,2259,284,304,308,0,,0,0.0,0.0,0.0,0.0,0.0
2024,3,30,6,2024-03-30,AS,5161,BOS,PDX,"Boston, MA",Massachusetts,"Portland, OR",Oregon,1872,1715,-21,-15,1851,1700,14,14,1865,1686,2559,314,334,342,0,,0,0.0,0.0,0.0,0.0,0.0
2024,10,21,1,2024-10-21,YX,1958,EWR,JFK,"Newark, NJ",New Jersey,"New York, NY",New York,1479,1143,-8,0,1471,1143,12,19,1483,1124,716,86,106,117,0,,0,0.0,0.0,0.0,0.0,0.0
2024,12,6,5,2024-12-06,NK,9205,PHL,EWR,"Philadelphia, PA",Pennsylvania,"Newark, NJ",New Jersey,1553,2228,10,20,1563,2248,13,4,1576,2244,2018,245,265,262,0,,0,1.0,3.0,2.0,0.0,14.0
2024,9,1,7,2024-09-01,AS,5707,BWI,PHX,"Baltimore, MD",Maryland,"Phoenix, AZ",Arizona,2277,831,9,10,2286,841,11,11,2297,830,1838,231,251,253,0,,0,0.0,0.0,0.0,0.0,0.0
2024,7,10,3,2024-07-10,B6,2165,TPA,ORD,"Tampa, FL",Florida,"Chicago, IL",Illinois,2040,1242,4,0,2044,1242,29,4,2073,1238,2424,309,329,342,0,,0,0.0,0.0,0.0,0.0,0.0
2024,11,13,3,2024-11-13,9E,3066,PHL,IAH,"Philadelphia, PA",Pennsylvania,"Houston, TX",Texas,873,2358,-9,-15,864,2343,17,12,881,2331,1499,190,210,219,0,,0,0.0,0.0,0.0,0.0,0.0
2024,4,15,1,2024-04-15,B6,6873,SAN,DCA,"San Diego, CA",California,"Washington, DC",District of Columbia,2297,612,6,5,2303,617,11,11,2314,606,839,95,115,117,0,,0,0.0,0.0,0.0,0.0,0.0
2024,12,28,6,2024-12-28,G4,7992,MCO,DCA,"Orlando, FL",Florida,"Washington, DC",District of Columbia,2141,1437,13,10,2154,1447,23,5,2177,1442,484,65,85,93,0,,0,0.0,0.0,0.0,0.0,0.0
2024,11,5,2,2024-11-05,OH,9888,DCA,DEN,"Washington, DC",District of Columbia,"Denver, CO",Colorado,1647,1132,8,15,1655,1147,5,11,1660,1136,1470,192,212,208,0,,0,0.0,0.0,0.0,0.0,0.0
2024,8,20,2,2024-08-20,F9,4542,DTW,MCO,"Detroit, MI",Michigan,"Orlando, FL",Florida,1969,2068,0,0,1969,2068,17,6,1986,2062,1434,180,200,203,0,,0,0.0,0.0,0.0,0.0,0.0
2024,9,21,6,2024-09-21,OH,9347,LGA,IAD,"New York, NY",New York,"Washington, DC",District of Columbia,1510,2126,4,0,1514,2126,21,15,1535,2111,2539,316,336,352,0,,0,0.0,0.0,0.0,0.0,0.0
2024,12,9,1,2024-12-09,YX,9315,MDW,LAS,"Chicago, IL",Illinois,"Las Vegas, NV",Nevada,1917,2149,3,0,1920,2149,16,14,1936,2135,847,98,118,128,0,,0,0.0,0.0,0.0,0.0,0.0
2024,2,6,2,2024-02-06,HA,3304,DEN,SLC,"Denver, CO",Colorado,"Salt Lake City, UT",Utah,1149,1438,22,15,1171,1453,25,14,1196,1439,2598,318,338,357,0,,0,0.0,0.0,0.0,0.0,0.0
2024,10,31,4,2024-10-31,9E,675,BWI,ATL,"Baltimore, MD",Maryland,"Atlanta, GA",Georgia,2141,1218,-2,0,2139,1218,29,17,2168,1201,584,79,99,125,0,,0,0.0,0.0,0.0,0.0,0.0
2024,2,10,6,2024-02-10,OH,298,CLT,BOS,"Charlotte, NC",North Carolina,"Boston, MA",Massachusetts,1224,1005,-6,-10,1218,995,18,14,1236,981,1690,220,240,252,0,,0,0.0,0.0,0.0,0.0,0.0
2024,1,17,3,2024-01-17,WN,7523,SLC,ORD,"Salt Lake City, UT",Utah,"Chicago, IL",Illinois,1311,2263,-8,0,1303,2263,20,4,1323,2259,1214,148,168,172,0,,0,0.0,0.0,0.0,0.0,0.0
2024,12,9,1,2024-12-09,WN,1465,DFW,MCO,"Dallas/Fort Worth, TX",Texas,"Orlando, FL",Florida,1579,2167,19,10,1598,2177,16,14,1614,2163,1909,245,265,275,0,,0,0.0,0.0,0.0,0.0,0.0
2024,10,3,4,2024-10-03,9E,7934,LGA,MIA,"New York, NY",New York,"Miami, FL",Florida,631,2304,2,0,633,2304,26,9,659,2295,510,60,80,95,0,,0,0.0,0.0,0.0,0.0,0.0
2024,11,2,6,2024-11-02,B6,2098,MCO,LAX,"Orlando, FL",Florida,"Los Angeles, CA",California,1280,887,-9,0,1271,887,20,9,1291,878,2840,352,372,381,0,,0,0.0,0.0,0.0,0.0,0.0
2024,2,28,3,2024-02-28,MQ,5450,STL,JFK,"St. Louis, MO",Missouri,"New York, NY",New York,621,1025,9,5,630,1030,6,14,636,1016,305,42,62,62,0,,0,0.0,0.0,0.0,0.0,0.0
2024,7,1,1,2024-07-01,MQ,6544,LAX,EWR,"Los Angeles, CA",California,"Newark, NJ",New Jersey,701,1035,8,5,709,1040,26,8,735,1032,2790,345,365,379,0,,0,0.0,0.0,0.0,0.0,0.0
2024,2,10,6,2024-02-10,UA,1116,SFO,SLC,"San Francisco, CA",California,"Salt Lake City, UT",Utah,2243,1589,-19,-15,2224,1574,24,10,2248,1564,2311,287,307,321,0,,0,0.0,0.0,0.0,0.0,0.0
2024,2,8,4,2024-02-08,HA,3718,LAS,MDW,"Las Vegas, NV",Nevada,"Chicago, IL",Illinois,2125,680,-2,5,2123,685,29,19,2152,666,1499,193,213,241,0,,0,0.0,0.0,0.0,0.0,0.0
2024,7,10,3,2024-07-10,F9,125,PHL,BWI,"Philadelphia, PA",Pennsylvania,"Baltimore, MD",Maryland,1201,2111,-12,-5,1189,2106,23,17,1212,2089,2532,319,339,359,0,,0,0.0,0.0,0.0,0.0,0.0
2024,9,23,1,2024-09-23,NK,9850,PHX,BWI,"Phoenix, AZ",Arizona,"Baltimore, MD",Maryland,1788,1805,14,15,1802,1820,11,14,1813,1806,2478,314,334,339,0,,0,0.0,0.0,0.0,0.0,0.0
2024,5,26,7,2024-05-26,B6,3824,IAD,LAX,"Washington, DC",District of Columbia,"Los Angeles, CA",California,1057,957,28,20,1085,977,16,9,1101,968,2430,312,332,337,0,,0,1.0,5.0,2.0,0.0,12.0
2024,11,28,4,2024-11-28,9E,3558,IAH,HNL,"Houston, TX",Texas,"Honolulu, HI",Hawaii,1563,1301,-3,-5,1560,1296,18,15,1578,1281,1125,131,151,164,0,,0,0.0,0.0,0.0,0.0,0.0
2024,5,6,1,2024-05-06,UA,6693,ORD,IAH,"Chicago, IL",Illinois,"Houston, TX",Texas,1078,854,15,20,1093,874,28,14,1121,860,2792,358,378,400,0,,0,5.0,5.0,1.0,0.0,9.0
2024,2,15,4,2024-02-15,HA,8762,TPA,ORD,"Tampa, FL",Florida,"Chicago, IL",Illinois,1636,1498,-8,-5,1628,1493,22,18,1650,1475,2905,358,378,398,0,,0,0.0,0.0,0.0,0.0,0.0
2024,2,14,3,2024-02-14,B6,7380,MDW,DTW,"Chicago, IL",Illinois,"Detroit, MI",Michigan,1862,765,4,5,1866,770,11,12,1877,758,380,56,76,79,0,,0,0.0,0.0,0.0,0.0,0.0
2024,1,1,1,2024-01-01,UA,8169,SAN,EWR,"San Diego, CA",California,"Newark, NJ",New Jersey,1585,1064,-9,-15,1576,1049,9,18,1585,1031,465,52,72,79,0,,0,0.0,0.0,0.0,0.0,0.0
2024,6,16,7,2024-06-16,9E,4846,PDX,MIA,"Portland, OR",Oregon,"Miami, FL",Florida,726,855,-17,-15,709,840,5,14,714,826,1763,228,248,247,0,,0,0.0,0.0,0.0,0.0,0.0
2024,4,17,3,2024-04-17,B6,7689,PDX,LAX,"Portland, OR",Oregon,"Los Angeles, CA",California,673,1022,13,10,686,1032,11,5,697,1027,1576,197,217,213,0,,0,0.0,0.0,0.0,0.0,0.0
2024,1,19,5,2024-01-19,AA,9177,PDX,EWR,"Portland, OR",Oregon,"Newark, NJ",New Jersey,1519,797,19,10,1538,807,20,6,1558,801,686,90,110,116,0,,0,0.0,0.0,0.0,0.0,0.0
2024,11,27,3,2024-11-27,AS,7078,SFO,HNL,"San Francisco, CA",California,"Honolulu, HI",Hawaii,1657,1836,-6,0,1651,1836,28,3,1679,1833,1090,143,163,174,0,,0,0.0,0.0,0.0,0.0,0.0
2024,3,12,2,2024-03-12,9E,9167,SLC,IAD,"Salt Lake City, UT",Utah,"Washington, DC",District of Columbia,1808,1156,-13,-5,1795,1151,20,6,1815,1145,1113,135,155,161,0,,0,0.0,0.0,0.0,0.0,0.0
2024,4,18,4,2024-04-18,WN,9233,LAS,SFO,"Las Vegas, NV",Nevada,"San Francisco, CA",California,2149,1482,-2,0,2147,1482,21,6,2168,1476,2098,270,290,297,0,,0,0.0,0.0,0.0,0.0,0.0
2024,9,24,2,2024-09-24,WN,3141,DFW,MCO,"Dallas/Fort Worth, TX",Texas,"Orlando, FL",Florida,1631,1124,11,10,1642,1134,8,5,1650,1129,1822,230,250,243,0,,0,0.0,0.0,0.0,0.0,0.0
2024,8,27,2,2024-08-27,F9,7865,BWI,MIA,"Baltimore, MD",Maryland,"Miami, FL",Florida,642,1675,-20,-10,622,1665,20,10,642,1655,2913,363,383,393,0,,0,0.0,0.0,0.0,0.0,0.0
2024,10,27,7,2024-10-27,DL,5504,SLC,IAH,"Salt Lake City, UT",Utah,"Houston, TX",Texas,1068,1888,-10,-10,1058,1878,8,10,1066,1868,1208,146,166,164,0,,0,0.0,0.0,0.0,0.0,0.0
2024,3,30,6,2024-03-30,WN,671,DCA,CLT,"Washington, DC",District of Columbia,"Charlotte, NC",North Carolina,1817,1948,-1,5,1816,1953,9,9,1825,1944,2290,283,303,301,0,,0,0.0,0.0,0.0,0.0,0.0
2024,4,12,5,2024-04-12,HA,8896,PHX,SAN,"Phoenix, AZ",Arizona,"San Diego, CA",California,776,1154,23,15,799,1169,9,10,808,1159,2792,356,376,375,1,,0,0.0,0.0,0.0,0.0,0.0
2024,9,6,5,2024-09-06,DL,5080,PHL,PDX,"Philadelphia, PA",Pennsylvania,"Portland, OR",Oregon,2015,606,-22,-15,1993,591,24,18,2017,573,1239,149,169,191,0,,0,0.0,0.0,0.0,0.0,0.0
2024,1,8,1,2024-01-08,AA,8673,SFO,MIA,"San Francisco, CA",California,"Miami, FL",Florida,2086,643,11,10,2097,653,15,5,2112,648,2074,251,271,271,0,,0,0.0,0.0,0.0,0.0,0.0
2024,6,1,6,2024-06-01,9E,1336,SEA,STL,"Seattle, WA",Washington,"St. Louis, MO",Missouri,1994,1795,5,0,1999,1795,18,17,2017,1778,2919,356,376,391,0,,0,0.0,0.0,0.0,0.0,0.0
2024,12,12,4,2024-12-12,MQ,2480,JFK,ATL,"New York, NY",New York,"Atlanta, GA",Georgia,775,1725,-5,-10,770,1715,21,13,791,1702,722,93,113,127,0,,0,0.0,0.0,0.0,0.0,0.0
2024,6,22,6,2024-06-22,MQ,7277,SEA,LAS,"Seattle, WA",Washington,"Las Vegas, NV",Nevada,733,1334,-5,5,728,1339,13,4,741,1335,1331,168,188,185,0,,0,0.0,0.0,0.0,0.0,0.0
2024,12,8,7,2024-12-08,UA,1617,LAS,TPA,"Las Vegas, NV",Nevada,"Tampa, FL",Florida,1765,2203,-3,5,1762,2208,25,18,1787,2190,815,99,119,142,0,,0,0.0,0.0,0.0,0.0,0.0
2024,6,6,4,2024-06-06,YX,1633,LAX,MCO,"Los Angeles, CA",California,"Orlando, FL",Florida,1781,2257,-6,-15,1775,2242,21,8,1796,2234,517,69,89,98,0,,0,0.0,0.0,0.0,0.0,0.0
2024,8,2,5,2024-08-02,F9,5987,SEA,PHX,"Seattle, WA",Washington,"Phoenix, AZ",Arizona,2272,1188,4,0,2276,1188,23,11,2299,1177,1889,236,256,270,0,,0,0.0,0.0,0.0,0.0,0.0
2024,6,25,2,2024-06-25,AS,7959,MCO,TPA,"Orlando, FL",Florida,"Tampa, FL",Florida,531,1411,14,5,545,1416,5,17,550,1399,1342,172,192,194,0,,0,0.0,0.0,0.0,0.0,0.0
2024,6,23,7,2024-06-23,YX,3589,STL,SFO,"St. Louis, MO",Missouri,"San Francisco, CA",California,1890,1919,-4,-10,1886,1909,17,11,1903,1898,2248,280,300,308,0,,0,0.0,0.0,0.0,0.0,0.0
2024,12,5,4,2024-12-05,NK,4742,MIA,STL,"Miami, FL",Florida,"St. Louis, MO",Missouri,1871,1828,-7,0,1864,1828,27,12,1891,1816,941,119,139,158,0,,0,0.0,0.0,0.0,0.0,0.0
2024,12,3,2,2024-12-03,DL,9162,DEN,PHL,"Denver, CO",Colorado,"Philadelphia, PA",Pennsylvania,1259,1090,-23,-15,1236,1075,14,4,1250,1071,979,131,151,149,0,,0,0.0,0.0,0.0,0.0,0.0
2024,5,25,6,2024-05-25,AS,2250,SFO,LAS,"San Francisco, CA",California,"Las Vegas, NV",Nevada,1655,917,-5,-5,1650,912,14,17,1664,895,512,70,90,101,0,,0,0.0,0.0,0.0,0.0,0.0
2024,11,19,2,2024-11-19,OH,5419,SAN,DFW,"San Diego, CA",California,"Dallas/Fort Worth, TX",Texas,2298,1794,-20,-10,2278,1784,11,3,2289,1781,2575,330,350,344,0,,0,0.0,0.0,0.0,0.0,0.0
2024,6,9,7,2024-06-09,F9,3866,SEA,ORD,"Seattle, WA",Washington,"Chicago, IL",Illinois,2294,817,-6,0,2288,817,10,8,2298,809,1730,223,243,241,0,,0,0.0,0.0,0.0,0.0,0.0
2024,5,6,1,2024-05-06,F9,5060,JFK,DCA,"New York, NY",New York,"Washington, DC",District of Columbia,1292,1100,-22,-15,1270,1085,29,15,1299,1070,806,105,125,149,0,,0,0.0,0.0,0.0,0.0,0.0
2024,3,22,5,2024-03-22,WN,6161,LAS,LGA,"Las Vegas, NV",Nevada,"New York, NY",New York,1891,1816,4,-5,1895,1811,11,9,1906,1802,346,40,60,60,1,,0,0.0,0.0,0.0,0.0,0.0
2024,5,26,7,2024-05-26,AS,5957,DCA,SLC,"Washington, DC",District of Columbia,"Salt Lake City, UT",Utah,1261,932,-13,-10,1248,922,9,19,1257,903,1831,235,255,263,1,,0,0.0,0.0,0.0,0.0,0.0
2024,8,26,1,2024-08-26,OH,4587,ATL,TPA,"Atlanta, GA",Georgia,"Tampa, FL",Florida,764,1776,5,5,769,1781,11,19,780,1762,2366,293,313,323,0,,0,0.0,0.0,0.0,0.0,0.0
2024,3,24,7,2024-03-24,B6,7850,TPA,DFW,"Tampa, FL",Florida,"Dallas/Fort Worth, TX",Texas,714,1152,5,5,719,1157,19,3,738,1154,486,63,83,85,0,,0,0.0,0.0,0.0,0.0,0.0
2024,4,22,1,2024-04-22,G4,9904,HNL,SFO,"Honolulu, HI",Hawaii,"San Francisco, CA",California,1738,1646,-8,-15,1730,1631,14,19,1744,1612,221,22,42,55,0,,0,0.0,0.0,0.0,0.0,0.0
2024,8,12,1,2024-08-12,F9,1177,EWR,LGA,"Newark, NJ",New Jersey,"New York, NY",New York,781,2321,19,20,800,2341,24,9,824,2332,320,34,54,67,0,,0,3.0,4.0,0.0,0.0,13.0
2024,11,27,3,2024-11-27,DL,1400,MSP,EWR,"Minneapolis, MN",Minnesota,"Newark, NJ",New Jersey,1029,815,7,5,1036,820,17,5,1053,815,1299,164,184,186,0,,0,0.0,0.0,0.0,0.0,0.0
2024,8,30,5,2024-08-30,YX,6749,LAX,MCO,"Los Angeles, CA",California,"Orlando, FL",Florida,501,1666,9,0,510,1666,13,6,523,1660,1306,165,185,184,0,,0,0.0,0.0,0.0,0.0,0.0
2024,5,22,3,2024-05-22,MQ,7281,LGA,DEN,"New York, NY",New York,"Denver, CO",Colorado,1012,1984,5,0,1017,1984,10,16,1027,1968,2604,316,336,342,0,,0,0.0,0.0,0.0,0.0,0.0
2024,2,10,6,2024-02-10,NK,8238,MDW,BOS,"Chicago, IL",Illinois,"Boston, MA",Massachusetts,1315,2248,-4,-10,1311,2238,24,14,1335,2224,2825,359,379,397,0,,0,0.0,0.0,0.0,0.0,0.0
2024,9,14,6,2024-09-14,NK,2629,MCO,EWR,"Orlando, FL",Florida,"Newark, NJ",New Jersey,963,1342,27,20,990,1362,25,9,1015,1353,869,117,137,151,0,,0,0.0,5.0,0.0,0.0,15.0
2024,10,11,5,2024-10-11,OO,3360,DCA,SFO,"Washington, DC",District of Columbia,"San Francisco, CA",California,1970,1535,-28,-20,1942,1515,28,16,1970,1499,2398,306,326,350,0,,0,0.0,0.0,0.0,0.0,0.0
2024,4,14,7,2024-04-14,OH,463,PDX,BWI,"Portland, OR",Oregon,"Baltimore, MD",Maryland,1886,1013,-5,5,1881,1018,11,15,1892,1003,1153,139,159,165,0,,0,0.0,0.0,0.0,0.0,0.0
2024,7,20,6,2024-07-20,OH,945,MCO,LAS,"Orlando, FL",Florida,"Las Vegas, NV",Nevada,1739,2041,-9,0,1730,2041,10,19,1740,2022,718,79,99,108,0,,0,0.0,0.0,0.0,0.0,0.0
2024,11,2,6,2024-11-02,YX,3132,SEA,MDW,"Seattle, WA",Washington,"Chicago, IL",Illinois,663,1221,10,15,673,1236,20,7,693,1229,2352,303,323,330,0,,0,0.0,0.0,0.0,0.0,0.0
2024,11,26,2,2024-11-26,AA,1427,JFK,SEA,"New York, NY",New York,"Seattle, WA",Washington,2226,2273,2,-5,2228,2268,6,10,2234,2258,402,54,74,70,0,,0,0.0,0.0,0.0,0.0,0.0
2024,9,22,7,2024-09-22,AA,8683,TPA,HNL,"Tampa, FL",Florida,"Honolulu, HI",Hawaii,2110,1216,6,0,2116,1216,19,13,2135,1203,2030,253,273,285,0,,0,0.0,0.0,0.0,0.0,0.0
2024,7,28,7,2024-07-28,YX,3355,SAN,MCO,"San Diego, CA",California,"Orlando, FL",Florida,1037,915,8,5,1045,920,7,17,1052,903,394,53,73,77,0,,0,0.0,0.0,0.0,0.0,0.0
2024,2,20,2,2024-02-20,WN,5236,IAD,CLT,"Washington, DC",District of Columbia,"Charlotte, NC",North Carolina,1010,2275,-14,-20,996,2255,17,17,1013,2238,2570,330,350,364,0,,0,0.0,0.0,0.0,0.0,0.0
2024,4,27,6,2024-04-27,B6,7208,SAN,IAH,"San Diego, CA",California,"Houston, TX",Texas,2297,2053,-17,-15,2280,2038,21,15,2301,2023,1835,228,248,264,0,,0,0.0,0.0,0.0,0.0,0.0
2024,7,19,5,2024-07-19,HA,3337,CLT,PHL,"Charlotte, NC",North Carolina,"Philadelphia, PA",Pennsylvania,1744,1366,-2,-10,1742,1356,23,9,1765,1347,1981,247,267,279,0,,0,0.0,0.0,0.0,0.0,0.0
2024,2,8,4,2024-02-08,WN,9597,SAN,ORD,"San Diego, CA",California,"Chicago, IL",Illinois,1054,1098,-24,-15,1030,1083,15,19,1045,1064,1838,225,245,259,0,,0,0.0,0.0,0.0,0.0,0.0
2024,1,28,7,2024-01-28,NK,5768,STL,SAN,"St. Louis, MO",Missouri,"San Diego, CA",California,2157,948,-28,-20,2129,928,6,14,2135,914,415,59,79,79,0,,0,0.0,0.0,0.0,0.0,0.0
2024,9,15,7,2024-09-15,UA,6412,DTW,MSP,"Detroit, MI",Michigan,"Minneapolis, MN",Minnesota,1140,674,5,0,1145,674,14,17,1159,657,1904,235,255,266,0,,0,0.0,0.0,0.0,0.0,0.0
2024,3,24,7,2024-03-24,NK,9056,LGA,SLC,"New York, NY",New York,"Salt Lake City, UT",Utah,1806,832,10,5,1816,837,16,7,1832,830,2216,268,288,291,0,,0,0.0,0.0,0.0,0.0,0.0
2024,6,3,1,2024-06-03,MQ,5565,IAD,DCA,"Washington, DC",District of Columbia,"Washington, DC",District of Columbia,1594,1512,10,20,1604,1532,17,10,1621,1522,2279,277,297,304,0,,0,0.0,4.0,2.0,0.0,14.0
2024,4,26,5,2024-04-26,F9,598,MIA,LGA,"Miami, FL",Florida,"New York, NY",New York,1897,1323,3,-5,1900,1318,10,6,1910,1312,2981,381,401,397,0,,0,0.0,0.0,0.0,0.0,0.0
2024,1,2,2,2024-01-02,AS,6162,MSP,PHL,"Minneapolis, MN",Minnesota,"Philadelphia, PA",Pennsylvania,758,1169,-3,-10,755,1159,8,7,763,1152,875,112,132,127,0,,0,0.0,0.0,0.0,0.0,0.0
2024,4,2,2,2024-04-02,AS,3044,IAH,DCA,"Houston, TX",Texas,"Washington, DC",District of Columbia,944,637,9,10,953,647,16,10,969,637,1677,203,223,229,0,,0,0.0,0.0,0.0,0.0,0.0
2024,6,14,5,2024-06-14,F9,8052,HNL,IAD,"Honolulu, HI",Hawaii,"Washington, DC",District of Columbia,1724,861,16,10,1740,871,19,4,1759,867,2087,259,279,282,0,,0,0.0,0.0,0.0,0.0,0.0
2024,12,15,7,2024-12-15,F9,5956,SAN,CLT,"San Diego, CA",California,"Charlotte, NC",North Carolina,2165,2069,-10,0,2155,2069,23,8,2178,2061,895,108,128,139,0,,0,0.0,0.0,0.0,0.0,0.0
2024,10,22,2,2024-10-22,NK,7938,IAD,HNL,"Washington, DC",District of Columbia,"Honolulu, HI",Hawaii,1903,811,-16,-10,1887,801,12,19,1899,782,2866,355,375,386,0,,0,0.0,0.0,0.0,0.0,0.0
2024,9,14,6,2024-09-14,AS,6177,TPA,PHX,"Tampa, FL",Florida,"Phoenix, AZ",Arizona,2116,2081,8,15,2124,2096,9,19,2133,2077,779,102,122,130,0,,0,0.0,0.0,0.0,0.0,0.0
2024,3,21,4,2024-03-21,AS,235,BOS,PHX,"Boston, MA",Massachusetts,"Phoenix, AZ",Arizona,1265,2273,-2,-10,1263,2263,8,19,1271,2244,962,118,138,145,0,,0,0.0,0.0,0.0,0.0,0.0
2024,9,24,2,2024-09-24,9E,9392,PDX,SLC,"Portland, OR",Oregon,"Salt Lake City, UT",Utah,1938,1590,-24,-20,1914,1570,17,17,1931,1553,1458,173,193,207,0,,0,0.0,0.0,0.0,0.0,0.0
2024,8,22,4,2024-08-22,OO,4133,MIA,PHL,"Miami, FL",Florida,"Philadelphia, PA",Pennsylvania,564,1905,2,5,566,1910,10,9,576,1901,1162,147,167,166,0,,0,0.0,0.0,0.0,0.0,0.0
2024,11,16,6,2024-11-16,MQ,6800,LAS,SFO,"Las Vegas, NV",Nevada,"San Francisco, CA",California,1901,2193,8,0,1909,2193,24,7,1933,2186,1578,189,209,220,0,,0,0.0,0.0,0.0,0.0,0.0
2024,11,6,3,2024-11-06,MQ,4213,ORD,BWI,"Chicago, IL",Illinois,"Baltimore, MD",Maryland,1157,1384,-13,-10,1144,1374,20,9,1164,1365,691,78,98,107,0,,0,0.0,0.0,0.0,0.0,0.0
2024,10,27,7,2024-10-27,AS,6646,LGA,DTW,"New York, NY",New York,"Detroit, MI",Michigan,2169,2188,3,5,2172,2193,14,4,2186,2189,1247,149,169,167,0,,0,0.0,0.0,0.0,0.0,0.0
2024,12,22,7,2024-12-22,F9,8496,MCO,ORD,"Orlando, FL",Florida,"Chicago, IL",Illinois,1625,805,13,5,1638,810,9,17,1647,793,2613,334,354,360,0,,0,0.0,0.0,0.0,0.0,0.0
2024,7,31,3,2024-07-31,AA,4694,JFK,LGA,"New York, NY",New York,"New York, NY",New York,1500,604,17,10,1517,614,19,16,1536,598,1887,228,248,263,0,,0,0.0,0.0,0.0,0.0,0.0
2024,3,2,6,2024-03-02,B6,661,EWR,TPA,"Newark, NJ",New Jersey,"Tampa, FL",Florida,541,2242,-7,-10,534,2232,15,8,549,2224,699,79,99,102,0,,0,0.0,0.0,0.0,0.0,0.0
2024,2,18,7,2024-02-18,UA,5500,DCA,LAS,"Washington, DC",District of Columbia,"Las Vegas, NV",Nevada,1378,1866,-13,-20,1365,1846,24,9,1389,1837,1370,170,190,203,0,,0,0.0,0.0,0.0,0.0,0.0
2024,5,6,1,2024-05-06,YX,7433,ATL,PDX,"Atlanta, GA",Georgia,"Portland, OR",Oregon,695,747,-6,0,689,747,13,11,702,736,2702,346,366,370,0,,0,0.0,0.0,0.0,0.0,0.0
2024,8,10,6,2024-08-10,F9,3414,LGA,SFO,"New York, NY",New York,"San Francisco, CA",California,1883,2314,0,10,1883,2324,22,4,1905,2320,2848,362,382,388,0,,0,0.0,0.0,0.0,0.0,0.0
2024,10,5,6,2024-10-05,OO,4060,EWR,DCA,"Newark, NJ",New Jersey,"Washington, DC",District of Columbia,2295,2309,-15,-10,2280,2299,5,3,2285,2296,2121,264,284,272,0,,0,0.0,0.0,0.0,0.0,0.0
2024,10,20,7,2024-10-20,AS,2311,SFO,MSP,"San Francisco, CA",California,"Minneapolis, MN",Minnesota,1622,1574,-9,-5,1613,1569,27,14,1640,1555,1423,177,197,218,0,,0,0.0,0.0,0.0,0.0,0.0
2024,10,10,4,2024-10-10,OH,2471,DTW,IAH,"Detroit, MI",Michigan,"Houston, TX",Texas,887,1946,-16,-10,871,1936,13,9,884,1927,447,60,80,82,0,,0,0.0,0.0,0.0,0.0,0.0
2024,10,3,4,2024-10-03,DL,7074,SLC,MCO,"Salt Lake City, UT",Utah,"Orlando, FL",Florida,564,986,-23,-20,541,966,13,13,554,953,2742,338,358,364,0,,0,0.0,0.0,0.0,0.0,0.0
2024,4,16,2,2024-04-16,HA,2781,BWI,SLC,"Baltimore, MD",Maryland,"Salt Lake City, UT",Utah,1820,2016,5,10,1825,2026,19,14,1844,2012,1447,177,197,210,0,,0,0.0,0.0,0.0,0.0,0.0
2024,5,25,6,2024-05-25,MQ,2906,ATL,SEA,"Atlanta, GA",Georgia,"Seattle, WA",Washington,1950,2274,-25,-15,1925,2259,8,7,1933,2252,2867,348,368,363,0,,0,0.0,0.0,0.0,0.0,0.0
2024,4,8,1,2024-04-08,NK,2355,LAX,DFW,"Los Angeles, CA",California,"Dallas/Fort Worth, TX",Texas,722,2310,6,5,728,2315,8,3,736,2312,1927,242,262,253,0,,0,0.0,0.0,0.0,0.0,0.0
2024,3,13,3,2024-03-13,NK,9192,HNL,BWI,"Honolulu, HI",Hawaii,"Baltimore, MD",Maryland,2280,1873,-11,-5,2269,1868,5,3,2274,1865,2856,353,373,361,0,,0,0.0,0.0,0.0,0.0,0.0
2024,5,1,3,2024-05-01,MQ,6482,BWI,SFO,"Baltimore, MD",Maryland,"San Francisco, CA",California,2218,1027,-16,-10,2202,1017,5,11,2207,1006,1451,179,199,195,0,,0,0.0,0.0,0.0,0.0,0.0
2024,1,30,2,2024-01-30,B6,4999,SFO,PDX,"San Francisco, CA",California,"Portland, OR",Oregon,1414,968,19,15,1433,983,5,3,1438,980,1866,226,246,234,0,,0,0.0,0.0,0.0,0.0,0.0
2024,7,6,6,2024-07-06,F9,3259,TPA,IAH,"Tampa, FL",Florida,"Houston, TX",Texas,1672,1600,11,5,1683,1605,26,14,1709,1591,2806,341,361,381,0,,0,0.0,0.0,0.0,0.0,0.0
2024,12,29,7,2024-12-29,OH,5756,SAN,DFW,"San Diego, CA",California,"Dallas/Fort Worth, TX",Texas,2032,1247,-1,5,2031,1252,10,19,2041,1233,1964,251,271,280,0,,0,0.0,0.0,0.0,0.0,0.0
2024,12,19,4,2024-12-19,B6,1552,HNL,JFK,"Honolulu, HI",Hawaii,"New York, NY",New York,941,2070,13,5,954,2075,15,18,969,2057,1823,224,244,257,0,,0,0.0,0.0,0.0,0.0,0.0
2024,10,14,1,2024-10-14,AA,9535,TPA,DCA,"Tampa, FL",Florida,"Washington, DC",District of Columbia,1937,1645,-6,-5,1931,1640,20,19,1951,1621,2038,252,272,291,0,,0,0.0,0.0,0.0,0.0,0.0
2024,7,13,6,2024-07-13,G4,2422,SAN,SFO,"San Diego, CA",California,"San Francisco, CA",California,1639,1149,-8,0,1631,1149,9,9,1640,1140,1575,196,216,214,0,,0,0.0,0.0,0.0,0.0,0.0
2024,6,4,2,2024-06-04,WN,9962,JFK,PHL,"New York, NY",New York,"Philadelphia, PA",Pennsylvania,1402,1138,-10,-10,1392,1128,14,5,1406,1123,1151,144,164,163,0,,0,0.0,0.0,0.0,0.0,0.0
2024,6,20,4,2024-06-20,MQ,7197,EWR,HNL,"Newark, NJ",New Jersey,"Honolulu, HI",Hawaii,952,1905,7,10,959,1915,20,11,979,1904,2967,378,398,409,0,,0,0.0,0.0,0.0,0.0,0.0
2024,11,30,6,2024-11-30,DL,1868,DCA,IAH,"Washington, DC",District of Columbia,"Houston, TX",Texas,819,1902,2,0,821,1902,15,5,836,1897,656,85,105,105,0,,0,0.0,0.0,0.0,0.0,0.0
2024,2,10,6,2024-02-10,WN,6196,SEA,JFK,"Seattle, WA",Washington,"New York, NY",New York,1269,1743,-15,-10,1254,1733,22,18,1276,1715,505,67,87,107,0,,0,0.0,0.0,0.0,0.0,0.0
2024,3,3,7,2024-03-03,OH,5285,BOS,IAH,"Boston, MA",Massachusetts,"Houston, TX",Texas,1382,1876,2,10,1384,1886,26,18,1410,1868,1483,189,209,233,0,,0,0.0,0.0,0.0,0.0,0.0
2024,1,23,2,2024-01-23,MQ,1269,IAD,LAX,"Washington, DC",District of Columbia,"Los Angeles, CA",California,1515,1076,8,0,1523,1076,18,12,1541,1064,1247,152,172,182,0,,0,0.0,0.0,0.0,0.0,0.0
2024,12,25,3,2024-12-25,G4,4810,DEN,EWR,"Denver, CO",Colorado,"Newark, NJ",New Jersey,950,1688,-4,0,946,1688,17,10,963,1678,438,44,64,71,0,,0,0.0,0.0,0.0,0.0,0.0
2024,3,15,5,2024-03-15,DL,6690,MCO,ORD,"Orlando, FL",Florida,"Chicago, IL",Illinois,1395,2209,-29,-20,1366,2189,5,18,1371,2171,1382,163,183,186,0,,0,0.0,0.0,0.0,0.0,0.0
2024,2,17,6,2024-02-17,WN,486,DFW,JFK,"Dallas/Fort Worth, TX",Texas,"New York, NY",New York,1602,1926,23,15,1625,1941,7,18,1632,1923,1567,186,206,211,0,,0,0.0,0.0,0.0,0.0,0.0
2024,6,8,6,2024-06-08,DL,2530,STL,EWR,"St. Louis, MO",Missouri,"Newark, NJ",New Jersey,1242,1940,22,20,1264,1960,19,8,1283,1952,1599,208,228,235,0,,0,6.0,1.0,3.0,0.0,10.0
2024,11,8,5,2024-11-08,B6,1505,SLC,DCA,"Salt Lake City, UT",Utah,"Washington, DC",District of Columbia,856,773,0,0,856,773,16,6,872,767,2109,270,290,292,0,,0,0.0,0.0,0.0,0.0,0.0
2024,4,27,6,2024-04-27,UA,223,MIA,BOS,"Miami, FL",Florida,"Boston, MA",Massachusetts,1642,2038,-7,-5,1635,2033,9,17,1644,2016,1579,190,210,216,0,,0,0.0,0.0,0.0,0.0,0.0
2024,4,9,2,2024-04-09,9E,4097,HNL,MCO,"Honolulu, HI",Hawaii,"Orlando, FL",Florida,2109,1883,3,-5,2112,1878,20,5,2132,1873,359,36,56,61,0,,0,0.0,0.0,0.0,0.0,0.0
2024,6,15,6,2024-06-15,DL,6009,BOS,MCO,"Boston, MA",Massachusetts,"Orlando, FL",Florida,2044,1908,-2,-10,2042,1898,18,19,2060,1879,1693,217,237,254,0,,0,0.0,0.0,0.0,0.0,0.0
2024,10,16,3,2024-10-16,OH,3996,MSP,MCO,"Minneapolis, MN",Minnesota,"Orlando, FL",Florida,1802,672,3,0,1805,672,14,17,1819,655,2562,315,335,346,0,,0,0.0,0.0,0.0,0.0,0.0
2024,6,4,2,2024-06-04,G4,9916,HNL,TPA,"Honolulu, HI",Hawaii,"Tampa, FL",Florida,1281,1702,-14,-15,1267,1687,9,11,1276,1676,942,110,130,130,0,,0,0.0,0.0,0.0,0.0,0.0
2024,1,7,7,2024-01-07,B6,8166,LAS,PHL,"Las Vegas, NV",Nevada,"Philadelphia, PA",Pennsylvania,1065,1667,5,15,1070,1682,11,15,1081,1667,2771,344,364,370,0,,0,0.0,0.0,0.0,0.0,0.0
2024,7,14,7,2024-07-14,9E,9473,LAS,PHX,"Las Vegas, NV",Nevada,"Phoenix, AZ",Arizona,1568,1344,-20,-10,1548,1334,25,3,1573,1331,2865,348,368,376,0,,0,0.0,0.0,0.0,0.0,0.0
2024,2,25,7,2024-02-25,B6,827,SLC,SEA,"Salt Lake City, UT",Utah,"Seattle, WA",Washington,1748,1626,11,5,1759,1631,20,14,1779,1617,1097,128,148,162,0,,0,0.0,0.0,0.0,0.0,0.0
2024,11,16,6,2024-11-16,AA,7139,MCO,MIA,"Orlando, FL",Florida,"Miami, FL",Florida,1027,1042,-12,-5,1015,1037,19,19,1034,1018,1646,207,227,245,0,,0,0.0,0.0,0.0,0.0,0.0
2024,7,11,4,2024-07-11,AS,7815,DTW,DCA,"Detroit, MI",Michigan,"Washington, DC",District of Columbia,1223,678,-8,-10,1215,668,10,16,1225,652,2701,334,354,360,0,,0,0.0,0.0,0.0,0.0,0.0
2024,2,16,5,2024-02-16,MQ,3770,EWR,LAX,"Newark, NJ",New Jersey,"Los Angeles, CA",California,2235,2000,0,0,2235,2000,11,3,2246,1997,1018,132,152,146,0,,0,0.0,0.0,0.0,0.0,0.0
2024,5,27,1,2024-05-27,NK,1241,MCO,LGA,"Orlando, FL",Florida,"New York, NY",New York,740,2316,12,5,752,2321,22,12,774,2309,2150,275,295,309,0,,0,0.0,0.0,0.0,0.0,0.0
2024,10,1,2,2024-10-01,AA,4131,STL,LAS,"St. Louis, MO",Missouri,"Las Vegas, NV",Nevada,1113,738,6,5,1119,743,23,16,1142,727,352,48,68,87,0,,0,0.0,0.0,0.0,0.0,0.0
2024,6,5,3,2024-06-05,G4,8650,MCO,SFO,"Orlando, FL",Florida,"San Francisco, CA",California,2005,1414,-2,-10,2003,1404,23,17,2026,1387,2494,305,325,345,0,,0,0.0,0.0,0.0,0.0,0.0
2024,7,20,6,2024-07-20,F9,3842,BWI,ATL,"Baltimore, MD",Maryland,"Atlanta, GA",Georgia,594,1630,4,-5,598,1625,21,13,619,1612,512,63,83,97,0,,0,0.0,0.0,0.0,0.0,0.0
2024,5,5,7,2024-05-05,YX,2944,STL,PHX,"St. Louis, MO",Missouri,"Phoenix, AZ",Arizona,864,1482,0,10,864,1492,18,13,882,1479,481,59,79,90,0,,0,0.0,0.0,0.0,0.0,0.0
2024,10,31,4,2024-10-31,OH,2311,PDX,PHL,"Portland, OR",Oregon,"Philadelphia, PA",Pennsylvania,1708,1324,12,5,1720,1329,13,13,1733,1316,2443,308,328,334,0,,0,0.0,0.0,0.0,0.0,0.0
2024,10,20,7,2024-10-20,OH,1072,SEA,SLC,"Seattle, WA",Washington,"Salt Lake City, UT",Utah,1659,1112,-4,5,1655,1117,20,9,1675,1108,228,37,57,66,0,,0,0.0,0.0,0.0,0.0,0.0
2024,3,4,1,2024-03-04,F9,460,PHL,IAH,"Philadelphia, PA",Pennsylvania,"Houston, TX",Texas,524,1295,-10,-10,514,1285,14,9,528,1276,2326,292,312,315,0,,0,0.0,0.0,0.0,0.0,0.0
2024,11,20,3,2024-11-20,NK,2732,LGA,MCO,"New York, NY",New York,"Orlando, FL",Florida,817,1326,9,5,826,1331,29,8,855,1323,2430,308,328,345,0,,0,0.0,0.0,0.0,0.0,0.0
2024,6,24,1,2024-06-24,B6,3290,DCA,LAS,"Washington, DC",District of Columbia,"Las Vegas, NV",Nevada,832,676,-1,-5,831,671,13,11,844,660,937,126,146,150,0,,0,0.0,0.0,0.0,0.0,0.0
2024,4,25,4,2024-04-25,UA,5048,BOS,CLT,"Boston, MA",Massachusetts,"Charlotte, NC",North Carolina,1413,1666,-10,-5,1403,1661,16,8,1419,1653,2116,272,292,296,0,,0,0.0,0.0,0.0,0.0,0.0
2024,7,22,1,2024-07-22,HA,1724,JFK,HNL,"New York, NY",New York,"Honolulu, HI",Hawaii,1061,1780,-17,-10,1044,1770,13,16,1057,1754,1576,190,210,219,0,,0,0.0,0.0,0.0,0.0,0.0
2024,11,16,6,2024-11-16,YX,1856,IAH,MCO,"Houston, TX",Texas,"Orlando, FL",Florida,1180,1129,-14,-15,1166,1114,20,11,1186,1103,1815,220,240,251,0,,0,0.0,0.0,0.0,0.0,0.0
2024,1,31,3,2024-01-31,OH,7918,MDW,ORD,"Chicago, IL",Illinois,"Chicago, IL",Illinois,599,1843,-5,-5,594,1838,20,5,614,1833,1775,211,231,236,0,,0,0.0,0.0,0.0,0.0,0.0
2024,4,22,1,2024-04-22,G4,5219,PHX,LGA,"Phoenix, AZ",Arizona,"New York, NY",New York,869,2208,-23,-20,846,2188,28,5,874,2183,2094,254,274,287,0,,0,0.0,0.0,0.0,0.0,0.0
2024,12,30,1,2024-12-30,OH,6126,MDW,STL,"Chicago, IL",Illinois,"St. Louis, MO",Missouri,2116,1612,-9,0,2107,1612,25,10,2132,1602,2764,345,365,380,0,,0,0.0,0.0,0.0,0.0,0.0
2024,11,20,3,2024-11-20,NK,8532,PHX,MSP,"Phoenix, AZ",Arizona,"Minneapolis, MN",Minnesota,1535,789,10,5,1545,794,29,14,1574,780,1065,127,147,170,0,,0,0.0,0.0,0.0,0.0,0.0
2024,12,9,1,2024-12-09,OO,7075,DFW,MDW,"Dallas/Fort Worth, TX",Texas,"Chicago, IL",Illinois,1219,1474,11,20,1230,1494,27,3,1257,1491,2180,280,300,310,0,,0,7.0,3.0,0.0,0.0,10.0
2024,3,7,4,2024-03-07,9E,1075,SAN,PHX,"San Diego, CA",California,"Phoenix, AZ",Arizona,576,861,-22,-15,554,846,6,14,560,832,236,20,40,40,0,,0,0.0,0.0,0.0,0.0,0.0
2024,3,15,5,2024-03-15,9E,4418,DFW,MDW,"Dallas/Fort Worth, TX",Texas,"Chicago, IL",Illinois,1086,743,-19,-10,1067,733,11,18,1078,715,273,31,51,60,0,,0,0.0,0.0,0.0,0.0,0.0
2024,2,14,3,2024-02-14,F9,6023,ORD,BOS,"Chicago, IL",Illinois,"Boston, MA",Massachusetts,1473,2108,-2,0,1471,2108,24,11,1495,2097,1344,170,190,205,0,,0,0.0,0.0,0.0,0.0,0.0
2024,9,16,1,2024-09-16,OH,2413,LAX,SAN,"Los Angeles, CA",California,"San Diego, CA",California,1181,1240,-8,-10,1173,1230,11,8,1184,1222,1766,216,236,235,0,,0,0.0,0.0,0.0,0.0,0.0
2024,6,2,7,2024-06-02,AS,9597,STL,MDW,"St. Louis, MO",Missouri,"Chicago, IL",Illinois,1871,877,-6,-15,1865,862,11,8,1876,854,1985,254,274,273,1,,0,0.0,0.0,0.0,0.0,0.0
2024,6,3,1,2024-06-03,YX,887,HNL,TPA,"Honolulu, HI",Hawaii,"Tampa, FL",Florida,1966,1413,-9,0,1957,1413,23,9,1980,1404,489,61,81,93,0,,0,0.0,0.0,0.0,0.0,0.0
2024,12,28,6,2024-12-28,OH,2528,BWI,DCA,"Baltimore, MD",Maryland,"Washington, DC",District of Columbia,1190,2325,8,0,1198,2325,7,16,1205,2309,764,93,113,116,0,,0,0.0,0.0,0.0,0.0,0.0
2024,8,21,3,2024-08-21,OO,8847,SEA,MDW,"Seattle, WA",Washington,"Chicago, IL",Illinois,587,2286,7,10,594,2296,14,18,608,2278,1562,195,215,227,0,,0,0.0,0.0,0.0,0.0,0.0
2024,2,20,2,2024-02-20,OH,6764,PHX,LGA,"Phoenix, AZ",Arizona,"New York, NY",New York,964,906,60,60,1024,966,10,5,1034,961,1836,225,245,240,0,,0,16.0,16.0,2.0,1.0,25.0
2024,11,1,5,2024-11-01,B6,9851,MSP,MDW,"Minneapolis, MN",Minnesota,"Chicago, IL",Illinois,993,1206,2,5,995,1211,6,3,1001,1208,732,85,105,94,0,,0,0.0,0.0,0.0,0.0,0.0
2024,9,18,3,2024-09-18,HA,7583,LAX,DFW,"Los Angeles, CA",California,"Dallas/Fort Worth, TX",Texas,1745,1149,-5,-10,1740,1139,28,19,1768,1120,1631,198,218,245,0,,0,0.0,0.0,0.0,0.0,0.0
2024,11,10,7,2024-11-10,F9,1463,PHX,ATL,"Phoenix, AZ",Arizona,"Atlanta, GA",Georgia,2038,1779,14,5,2052,1784,28,3,2080,1781,2055,258,278,289,0,,0,0.0,0.0,0.0,0.0,0.0
2024,5,4,6,2024-05-04,UA,4059,DEN,IAD,"Denver, CO",Colorado,"Washington, DC",District of Columbia,1641,899,6,0,1647,899,24,7,1671,892,2093,255,275,286,0,,0,0.0,0.0,0.0,0.0,0.0
2024,9,1,7,2024-09-01,YX,8881,SFO,ATL,"San Francisco, CA",California,"Atlanta, GA",Georgia,635,946,4,0,639,946,22,19,661,927,984,124,144,165,0,,0,0.0,0.0,0.0,0.0,0.0
2024,1,30,2,2024-01-30,MQ,1849,STL,SFO,"St. Louis, MO",Missouri,"San Francisco, CA",California,1477,2046,11,15,1488,2061,13,7,1501,2054,1013,128,148,148,0,,0,0.0,0.0,0.0,0.0,0.0
2024,5,1,3,2024-05-01,MQ,6771,DFW,PDX,"Dallas/Fort Worth, TX",Texas,"Portland, OR",Oregon,686,1025,-5,5,681,1030,19,13,700,1017,2475,316,336,348,0,,0,0.0,0.0,0.0,0.0,0.0
2024,5,4,6,2024-05-04,NK,640,DTW,ATL,"Detroit, MI",Michigan,"Atlanta, GA",Georgia,1041,641,8,5,1049,646,18,5,1067,641,358,45,65,68,0,,0,0.0,0.0,0.0,0.0,0.0
2024,2,6,2,2024-02-06,DL,7734,LAX,ATL,"Los Angeles, CA",California,"Atlanta, GA",Georgia,1078,915,-15,-20,1063,895,13,12,1076,883,1401,167,187,192,0,,0,0.0,0.0,0.0,0.0,0.0
2024,6,18,2,2024-06-18,UA,8582,SLC,DEN,"Salt Lake City, UT",Utah,"Denver, CO",Colorado,1834,1237,2,10,1836,1247,6,16,1842,1231,498,67,87,89,0,,0,0.0,0.0,0.0,0.0,0.0
2024,5,3,5,2024-05-03,HA,4035,PHL,HNL,"Philadelphia, PA",Pennsylvania,"Honolulu, HI",Hawaii,1429,676,12,5,1441,681,14,13,1455,668,728,84,104,111,0,,0,0.0,0.0,0.0,0.0,0.0
2024,12,22,7,2024-12-22,MQ,4058,PHL,SEA,"Philadelphia, PA",Pennsylvania,"Seattle, WA",Washington,1902,695,-2,-10,1900,685,8,3,1908,682,2981,378,398,389,0,,0,0.0,0.0,0.0,0.0,0.0
2024,2,4,7,2024-02-04,YX,3959,PDX,BOS,"Portland, OR",Oregon,"Boston, MA",Massachusetts,1310,1886,-15,-10,1295,1876,5,14,1300,1862,1145,142,162,161,0,,0,0.0,0.0,0.0,0.0,0.0
2024,3,27,3,2024-03-27,HA,8150,PHX,HNL,"Phoenix, AZ",Arizona,"Honolulu, HI",Hawaii,911,1418,-17,-15,894,1403,26,4,920,1399,2437,306,326,336,0,,0,0.0,0.0,0.0,0.0,0.0
2024,5,13,1,2024-05-13,DL,9547,BWI,STL,"Baltimore, MD",Maryland,"St. Louis, MO",Missouri,1944,1336,-13,-15,1931,1321,15,3,1946,1318,2146,262,282,280,0,,0,0.0,0.0,0.0,0.0,0.0
2024,7,14,7,2024-07-14,B6,5431,HNL,DEN,"Honolulu, HI",Hawaii,"Denver, CO",Colorado,716,2246,6,5,722,2251,20,17,742,2234,236,35,55,72,0,,0,0.0,0.0,0.0,0.0,0.0
2024,9,30,1,2024-09-30,NK,8299,PDX,CLT,"Portland, OR",Oregon,"Charlotte, NC",North Carolina,1169,1349,-6,-10,1163,1339,15,15,1178,1324,1830,226,246,256,0,,0,0.0,0.0,0.0,0.0,0.0
2024,7,19,5,2024-07-19,OO,1757,DEN,SEA,"Denver, CO",Colorado,"Seattle, WA",Washington,1594,804,11,15,1605,819,17,15,1622,804,855,97,117,129,0,,0,0.0,0.0,0.0,0.0,0.0
2024,10,11,5,2024-10-11,9E,6285,TPA,PHX,"Tampa, FL",Florida,"Phoenix, AZ",Arizona,1329,1911,11,10,1340,1921,18,15,1358,1906,276,39,59,72,0,,0,0.0,0.0,0.0,0.0,0.0
2024,3,17,7,2024-03-17,OO,4528,EWR,STL,"Newark, NJ",New Jersey,"St. Louis, MO",Missouri,1633,1886,1,-5,1634,1881,5,19,1639,1862,662,88,108,112,0,,0,0.0,0.0,0.0,0.0,0.0
2024,2,28,3,2024-02-28,OO,9548,IAH,MIA,"Houston, TX",Texas,"Miami, FL",Florida,784,2211,-3,-5,781,2206,27,8,808,2198,1761,211,231,246,0,,0,0.0,0.0,0.0,0.0,0.0
2024,5,5,7,2024-05-05,OO,7337,MIA,EWR,"Miami, FL",Florida,"Newark, NJ",New Jersey,1382,1535,1,-5,1383,1530,29,14,1412,1516,2724,333,353,376,0,,0,0.0,0.0,0.0,0.0,0.0
2024,4,18,4,2024-04-18,HA,1139,IAD,DFW,"Washington, DC",District of Columbia,"Dallas/Fort Worth, TX",Texas,1269,1254,-18,-15,1251,1239,13,17,1264,1222,1928,244,264,274,0,,0,0.0,0.0,0.0,0.0,0.0
2024,8,11,7,2024-08-11,9E,2216,PDX,BOS,"Portland, OR",Oregon,"Boston, MA",Massachusetts,2125,914,-13,-20,2112,894,22,5,2134,889,2563,311,331,338,0,,0,0.0,0.0,0.0,0.0,0.0
2024,10,4,5,2024-10-04,HA,8976,LGA,MSP,"New York, NY",New York,"Minneapolis, MN",Minnesota,1068,1992,-9,0,1059,1992,15,8,1074,1984,323,45,65,68,0,,0,0.0,0.0,0.0,0.0,0.0
2024,3,8,5,2024-03-08,HA,4118,DCA,CLT,"Washington, DC",District of Columbia,"Charlotte, NC",North Carolina,1452,2220,21,15,1473,2235,28,5,1501,2230,1658,202,222,235,1,,0,0.0,0.0,0.0,0.0,0.0
2024,3,9,6,2024-03-09,HA,7646,LAX,DCA,"Los Angeles, CA",California,"Washington, DC",District of Columbia,1821,1875,16,15,1837,1890,7,14,1844,1876,1065,131,151,152,0,,0,0.0,0.0,0.0,0.0,0.0
2024,6,13,4,2024-06-13,MQ,1924,LAX,HNL,"Los Angeles, CA",California,"Honolulu, HI",Hawaii,2022,1956,12,10,2034,1966,25,13,2059,1953,519,67,87,105,0,,0,0.0,0.0,0.0,0.0,0.0
2024,10,31,4,2024-10-31,OH,3634,PDX,DCA,"Portland, OR",Oregon,"Washington, DC",District of Columbia,1060,1343,4,0,1064,1343,8,8,1072,1335,2231,280,300,296,0,,0,0.0,0.0,0.0,0.0,0.0
2024,6,10,1,2024-06-10,AA,6770,STL,MIA,"St. Louis, MO",Missouri,"Miami, FL",Florida,1196,2049,10,10,1206,2059,26,13,1232,2046,2729,341,361,380,0,,0,0.0,0.0,0.0,0.0,0.0
2024,12,30,1,2024-12-30,MQ,8354,DFW,DTW,"Dallas/Fort Worth, TX",Texas,"Detroit, MI",Michigan,1210,894,-2,0,1208,894,15,19,1223,875,1604,197,217,231,0,,0,0.0,0.0,0.0,0.0,0.0
2024,12,7,6,2024-12-07,9E,8552,ORD,JFK,"Chicago, IL",Illinois,"New York, NY",New York,1029,1430,-13,-10,1016,1420,11,6,1027,1414,2894,352,372,369,0,,0,0.0,0.0,0.0,0.0,0.0
2024,11,4,1,2024-11-04,G4,3671,STL,SFO,"St. Louis, MO",Missouri,"San Francisco, CA",California,1721,1241,14,5,1735,1246,13,13,1748,1233,1928,249,269,275,0,,0,0.0,0.0,0.0,0.0,0.0
2024,12,8,7,2024-12-08,AA,3292,DFW,DTW,"Dallas/Fort Worth, TX",Texas,"Detroit, MI",Michigan,2030,884,19,15,2049,899,9,15,2058,884,2439,294,314,318,0,,0,0.0,0.0,0.0,0.0,0.0
2024,2,11,7,2024-02-11,AA,5053,BOS,SFO,"Boston, MA",Massachusetts,"San Francisco, CA",California,988,1940,-14,-20,974,1920,6,18,980,1902,2727,344,364,368,0,,0,0.0,0.0,0.0,0.0,0.0
2024,12,19,4,2024-12-19,OH,9780,LAS,PHX,"Las Vegas, NV",Nevada,"Phoenix, AZ",Arizona,2267,1111,-7,-10,2260,1101,16,8,2276,1093,900,110,130,134,0,,0,0.0,0.0,0.0,0.0,0.0
2024,4,18,4,2024-04-18,HA,9422,DFW,MIA,"Dallas/Fort Worth, TX",Texas,"Miami, FL",Florida,526,1607,-16,-10,510,1597,8,8,518,1589,2375,299,319,315,0,,0,0.0,0.0,0.0,0.0,0.0
2024,2,20,2,2024-02-20,YX,4375,BOS,JFK,"Boston, MA",Massachusetts,"New York, NY",New York,1641,628,-10,-15,1631,613,17,19,1648,594,2692,341,361,377,0,,0,0.0,0.0,0.0,0.0,0.0
2024,9,6,5,2024-09-06,9E,454,MIA,IAD,"Miami, FL",Florida,"Washington, DC",District of Columbia,1577,1917,-13,-10,1564,1907,6,5,1570,1902,2227,269,289,280,0,,0,0.0,0.0,0.0,0.0,0.0
2024,12,6,5,2024-12-06,F9,5129,MSP,CLT,"Minneapolis, MN",Minnesota,"Charlotte, NC",North Carolina,1003,1630,1,-5,1004,1625,19,9,1023,1616,1093,136,156,164,0,,0,0.0,0.0,0.0,0.0,0.0
2024,1,21,7,2024-01-21,AS,2874,EWR,SLC,"Newark, NJ",New Jersey,"Salt Lake City, UT",Utah,651,1141,15,15,666,1156,5,3,671,1153,2439,294,314,302,0,,0,0.0,0.0,0.0,0.0,0.0
2024,10,26,6,2024-10-26,AS,688,ORD,MIA,"Chicago, IL",Illinois,"Miami, FL",Florida,1236,814,17,10,1253,824,22,14,1275,810,485,51,71,87,0,,0,0.0,0.0,0.0,0.0,0.0
2024,5,18,6,2024-05-18,YX,704,BWI,SFO,"Baltimore, MD",Maryland,"San Francisco, CA",California,978,1226,6,15,984,1241,27,15,1011,1226,944,124,144,166,0,,0,0.0,0.0,0.0,0.0,0.0
2024,12,24,2,2024-12-24,G4,8465,SEA,PHL,"Seattle, WA",Washington,"Philadelphia, PA",Pennsylvania,1685,814,-25,-15,1660,799,6,5,1666,794,1861,234,254,245,0,,0,0.0,0.0,0.0,0.0,0.0
2024,11,19,2,2024-11-19,HA,453,PHL,DTW,"Philadelphia, PA",Pennsylvania,"Detroit, MI",Michigan,2185,1787,-22,-20,2163,1767,8,8,2171,1759,803,92,112,108,0,,0,0.0,0.0,0.0,0.0,0.0
2024,4,1,1,2024-04-01,WN,5534,STL,MCO,"St. Louis, MO",Missouri,"Orlando, FL",Florida,1739,1793,-18,-15,1721,1778,25,16,1746,1762,2081,258,278,299,0,,0,0.0,0.0,0.0,0.0,0.0
2024,10,6,7,2024-10-06,F9,533,LAS,MSP,"Las Vegas, NV",Nevada,"Minneapolis, MN",Minnesota,1330,820,6,15,1336,835,23,16,1359,819,2206,272,292,311,0,,0,0.0,0.0,0.0,0.0,0.0
2024,5,4,6,2024-05-04,WN,8550,ATL,IAH,"Atlanta, GA",Georgia,"Houston, TX",Texas,1943,1623,-9,-10,1934,1613,24,11,1958,1602,2897,365,385,400,0,,0,0.0,0.0,0.0,0.0,0.0
2024,4,20,6,2024-04-20,OH,967,SFO,ORD,"San Francisco, CA",California,"Chicago, IL",Illinois,1871,1883,-5,0,1866,1883,14,15,1880,1868,2834,352,372,381,0,,0,0.0,0.0,0.0,0.0,0.0
2024,12,19,4,2024-12-19,DL,8887,IAD,DEN,"Washington, DC",District of Columbia,"Denver, CO",Colorado,1863,2347,-19,-10,1844,2337,17,3,1861,2334,269,26,46,46,0,,0,0.0,0.0,0.0,0.0,0.0
2024,5,18,6,2024-05-18,OO,5864,CLT,PHL,"Charlotte, NC",North Carolina,"Philadelphia, PA",Pennsylvania,1349,860,-19,-20,1330,840,23,6,1353,834,996,116,136,145,0,,0,0.0,0.0,0.0,0.0,0.0
2024,9,29,7,2024-09-29,HA,493,DFW,MDW,"Dallas/Fort Worth, TX",Texas,"Chicago, IL",Illinois,1053,2265,-8,-15,1045,2250,12,15,1057,2235,2269,291,311,318,0,,0,0.0,0.0,0.0,0.0,0.0
2024,4,8,1,2024-04-08,F9,3854,HNL,JFK,"Honolulu, HI",Hawaii,"New York, NY",New York,1875,1623,-1,5,1874,1628,14,8,1888,1620,2645,330,350,352,0,,0,0.0,0.0,0.0,0.0,0.0
2024,9,8,7,2024-09-08,YX,4470,MIA,SEA,"Miami, FL",Florida,"Seattle, WA",Washington,2196,2240,-8,-10,2188,2230,12,3,2200,2227,2547,311,331,326,0,,0,0.0,0.0,0.0,0.0,0.0
2024,12,3,2,2024-12-03,NK,4621,SLC,LAX,"Salt Lake City, UT",Utah,"Los Angeles, CA",California,2109,1165,-17,-10,2092,1155,23,16,2115,1139,2310,282,302,321,0,,0,0.0,0.0,0.0,0.0,0.0
2024,4,13,6,2024-04-13,WN,7799,BWI,TPA,"Baltimore, MD",Maryland,"Tampa, FL",Florida,1898,2243,-8,-5,1890,2238,13,3,1903,2235,2937,370,390,386,0,,0,0.0,0.0,0.0,0.0,0.0
2024,8,1,4,2024-08-01,G4,4678,HNL,IAH,"Honolulu, HI",Hawaii,"Houston, TX",Texas,2060,2095,4,5,2064,2100,13,12,2077,2088,1860,236,256,261,0,,0,0.0,0.0,0.0,0.0,0.0
2024,9,5,4,2024-09-05,HA,8505,PHL,DCA,"Philadelphia, PA",Pennsylvania,"Washington, DC",District of Columbia,1826,1400,3,0,1829,1400,27,19,1856,1381,1243,160,180,206,0,,0,0.0,0.0,0.0,0.0,0.0
2024,5,31,5,2024-05-31,G4,2226,SAN,BWI,"San Diego, CA",California,"Baltimore, MD",Maryland,1765,1878,24,15,1789,1893,17,19,1806,1874,1170,147,167,183,0,,0,0.0,0.0,0.0,0.0,0.0
2024,9,6,5,2024-09-06,F9,8430,PDX,LAX,"Portland, OR",Oregon,"Los Angeles, CA",California,1901,1901,-14,-5,1887,1896,5,9,1892,1887,649,90,110,104,0,,0,0.0,0.0,0.0,0.0,0.0
2024,10,1,2,2024-10-01,OH,4293,BOS,ORD,"Boston, MA",Massachusetts,"Chicago, IL",Illinois,2208,2182,-19,-10,2189,2172,16,11,2205,2161,544,71,91,98,0,,0,0.0,0.0,0.0,0.0,0.0
2024,6,13,4,2024-06-13,AA,4060,PHX,LAX,"Phoenix, AZ",Arizona,"Los Angeles, CA",California,1912,1245,-7,0,1905,1245,14,14,1919,1231,2669,326,346,354,0,,0,0.0,0.0,0.0,0.0,0.0
2024,12,6,5,2024-12-06,NK,763,JFK,DFW,"New York, NY",New York,"Dallas/Fort Worth, TX",Texas,786,1647,0,0,786,1647,23,15,809,1632,1868,225,245,263,0,,0,0.0,0.0,0.0,0.0,0.0
2024,1,8,1,2024-01-08,B6,2932,EWR,SEA,"Newark, NJ",New Jersey,"Seattle, WA",Washington,1682,1588,3,5,1685,1593,12,4,1697,1589,2518,310,330,326,0,,0,0.0,0.0,0.0,0.0,0.0
2024,10,10,4,2024-10-10,NK,9365,BOS,BWI,"Boston, MA",Massachusetts,"Baltimore, MD",Maryland,1877,2056,22,15,1899,2071,26,14,1925,2057,2209,270,290,310,0,,0,0.0,0.0,0.0,0.0,0.0
2024,1,5,5,2024-01-05,YX,4674,DFW,IAH,"Dallas/Fort Worth, TX",Texas,"Houston, TX",Texas,2253,1591,16,10,2269,1601,29,19,2298,1582,2742,349,369,397,0,,0,0.0,0.0,0.0,0.0,0.0
2024,5,24,5,2024-05-24,G4,6471,BOS,BWI,"Boston, MA",Massachusetts,"Baltimore, MD",Maryland,954,1228,-14,-5,940,1223,15,4,955,1219,634,85,105,104,0,,0,0.0,0.0,0.0,0.0,0.0
2024,4,10,3,2024-04-10,DL,7724,IAD,DEN,"Washington, DC",District of Columbia,"Denver, CO",Colorado,1126,1077,-14,-10,1112,1067,15,4,1127,1063,232,30,50,49,0,,0,0.0,0.0,0.0,0.0,0.0
2024,6,12,3,2024-06-12,MQ,6392,IAD,DCA,"Washington, DC",District of Columbia,"Washington, DC",District of Columbia,1764,2117,16,15,1780,2132,20,8,1800,2124,812,94,114,122,0,,0,0.0,0.0,0.0,0.0,0.0
2024,5,26,7,2024-05-26,OH,5277,ATL,BOS,"Atlanta, GA",Georgia,"Boston, MA",Massachusetts,711,981,0,-5,711,976,15,9,726,967,1604,200,220,224,0,,0,0.0,0.0,0.0,0.0,0.0
2024,3,4,1,2024-03-04,OO,8453,CLT,BWI,"Charlotte, NC",North Carolina,"Baltimore, MD",Maryland,862,1418,4,5,866,1423,29,7,895,1416,1581,200,220,236,0,,0,0.0,0.0,0.0,0.0,0.0
2024,3,31,7,2024-03-31,WN,7106,IAD,TPA,"Washington, DC",District of Columbia,"Tampa, FL",Florida,1097,973,30,30,1127,1003,5,14,1132,989,2750,339,359,358,1,,0,9.0,0.0,5.0,0.0,16.0
2024,4,26,5,2024-04-26,WN,9792,TPA,SAN,"Tampa, FL",Florida,"San Diego, CA",California,632,1152,-2,0,630,1152,10,13,640,1139,530,63,83,86,0,,0,0.0,0.0,0.0,0.0,0.0
2024,12,19,4,2024-12-19,DL,3278,JFK,HNL,"New York, NY",New York,"Honolulu, HI",Hawaii,2032,1361,-7,0,2025,1361,17,12,2042,1349,1898,236,256,265,0,,0,0.0,0.0,0.0,0.0,0.0
2024,9,23,1,2024-09-23,UA,5646,SAN,JFK,"San Diego, CA",California,"New York, NY",New York,776,1946,10,5,786,1951,15,19,801,1932,1024,128,148,162,0,,0,0.0,0.0,0.0,0.0,0.0
2024,11,5,2,2024-11-05,OO,4590,SAN,TPA,"San Diego, CA",California,"Tampa, FL",Florida,1788,1712,-2,-10,1786,1702,7,10,1793,1692,519,59,79,76,0,,0,0.0,0.0,0.0,0.0,0.0
2024,6,21,5,2024-06-21,OH,4996,STL,LAS,"St. Louis, MO",Missouri,"Las Vegas, NV",Nevada,1104,691,9,0,1113,691,25,12,1138,679,400,48,68,85,0,,0,0.0,0.0,0.0,0.0,0.0
2024,2,16,5,2024-02-16,OH,285,IAH,MSP,"Houston, TX",Texas,"Minneapolis, MN",Minnesota,2126,976,-11,-5,2115,971,5,14,2120,957,786,93,113,112,1,,0,0.0,0.0,0.0,0.0,0.0
2024,5,19,7,2024-05-19,MQ,4753,SEA,SLC,"Seattle, WA",Washington,"Salt Lake City, UT",Utah,1156,1704,-9,-10,1147,1694,18,4,1165,1690,1712,210,230,232,0,,0,0.0,0.0,0.0,0.0,0.0
2024,9,2,1,2024-09-02,F9,2080,SAN,ATL,"San Diego, CA",California,"Atlanta, GA",Georgia,1883,2265,-1,0,1882,2265,15,10,1897,2255,2996,381,401,406,0,,0,0.0,0.0,0.0,0.0,0.0
2024,5,28,2,2024-05-28,YX,4641,LAX,EWR,"Los Angeles, CA",California,"Newark, NJ",New Jersey,2187,1202,3,0,2190,1202,18,8,2208,1194,1256,153,173,179,0,,0,0.0,0.0,0.0,0.0,0.0
2024,9,2,1,2024-09-02,G4,7908,ATL,TPA,"Atlanta, GA",Georgia,"Tampa, FL",Florida,1166,699,14,5,1180,704,27,3,1207,701,802,96,116,126,0,,0,0.0,0.0,0.0,0.0,0.0
2024,1,5,5,2024-01-05,AS,929,IAH,HNL,"Houston, TX",Texas,"Honolulu, HI",Hawaii,635,2213,19,10,654,2223,26,15,680,2208,1113,142,162,183,0,,0,0.0,0.0,0.0,0.0,0.0
2024,7,2,2,2024-07-02,9E,3619,PDX,IAD,"Portland, OR",Oregon,"Washington, DC",District of Columbia,1264,2178,-9,-10,1255,2168,14,16,1269,2152,1317,168,188,198,0,,0,0.0,0.0,0.0,0.0,0.0
2024,1,20,6,2024-01-20,DL,8108,LAX,BWI,"Los Angeles, CA",California,"Baltimore, MD",Maryland,927,1746,-2,5,925,1751,25,12,950,1739,516,71,91,108,0,,0,0.0,0.0,0.0,0.0,0.0
2024,2,15,4,2024-02-15,DL,6009,DTW,PDX,"Detroit, MI",Michigan,"Portland, OR",Oregon,1329,1399,4,-5,1333,1394,6,11,1339,1383,535,59,79,76,0,,0,0.0,0.0,0.0,0.0,0.0
2024,1,12,5,2024-01-12,NK,1325,BOS,IAD,"Boston, MA",Massachusetts,"Washington, DC",District of Columbia,1552,2019,-2,0,1550,2019,28,13,1578,2006,2687,328,348,369,0,,0,0.0,0.0,0.0,0.0,0.0
2024,3,10,7,2024-03-10,F9,5874,DEN,LAS,"Denver, CO",Colorado,"Las Vegas, NV",Nevada,1094,622,13,10,1107,632,9,18,1116,614,1247,153,173,180,0,,0,0.0,0.0,0.0,0.0,0.0
2024,1,17,3,2024-01-17,F9,2944,EWR,TPA,"Newark, NJ",New Jersey,"Tampa, FL",Florida,1853,1255,-16,-10,1837,1245,19,10,1856,1235,1928,235,255,264,0,,0,0.0,0.0,0.0,0.0,0.0
2024,5,26,7,2024-05-26,OH,7447,DTW,STL,"Detroit, MI",Michigan,"St. Louis, MO",Missouri,1419,1369,-2,0,1417,1369,22,17,1439,1352,275,42,62,81,0,,0,0.0,0.0,0.0,0.0,0.0
2024,6,2,7,2024-06-02,AS,2833,EWR,SFO,"Newark, NJ",New Jersey,"San Francisco, CA",California,1557,1118,-9,0,1548,1118,20,16,1568,1102,481,53,73,89,0,,0,0.0,0.0,0.0,0.0,0.0
2024,10,30,3,2024-10-30,9E,4520,MDW,PHX,"Chicago, IL",Illinois,"Phoenix, AZ",Arizona,1003,1900,6,5,1009,1905,24,6,1033,1899,2074,250,270,280,0,,0,0.0,0.0,0.0,0.0,0.0
2024,4,17,3,2024-04-17,F9,4096,SAN,EWR,"San Diego, CA",California,"Newark, NJ",New Jersey,603,2321,6,5,609,2326,28,14,637,2312,1160,145,165,187,0,,0,0.0,0.0,0.0,0.0,0.0
2024,8,23,5,2024-08-23,OH,9790,ORD,MSP,"Chicago, IL",Illinois,"Minneapolis, MN",Minnesota,993,1718,7,5,1000,1723,28,19,1028,1704,2217,282,302,329,0,,0,0.0,0.0,0.0,0.0,0.0
2024,11,3,7,2024-11-03,HA,1788,IAD,HNL,"Washington, DC",District of Columbia,"Honolulu, HI",Hawaii,1894,1518,-10,-10,1884,1508,7,7,1891,1501,901,104,124,118,0,,0,0.0,0.0,0.0,0.0,0.0
2024,12,17,2,2024-12-17,AA,2547,DEN,DTW,"Denver, CO",Colorado,"Detroit, MI",Michigan,887,2005,2,5,889,2010,28,10,917,2000,1563,204,224,242,0,,0,0.0,0.0,0.0,0.0,0.0
2024,3,10,7,2024-03-10,G4,967,MDW,IAH,"Chicago, IL",Illinois,"Houston, TX",Texas,2268,976,1,0,2269,976,13,7,2282,969,2727,338,358,358,0,,0,0.0,0.0,0.0,0.0,0.0
2024,7,1,1,2024-07-01,MQ,7052,ORD,SFO,"Chicago, IL",Illinois,"San Francisco, CA",California,1760,1648,-2,0,1758,1648,22,5,1780,1643,1006,118,138,145,0,,0,0.0,0.0,0.0,0.0,0.0
2024,9,6,5,2024-09-06,YX,6184,SEA,SFO,"Seattle, WA",Washington,"San Francisco, CA",California,1234,890,-4,-5,1230,885,26,18,1256,867,861,97,117,141,0,,0,0.0,0.0,0.0,0.0,0.0
2024,8,15,4,2024-08-15,AA,8531,LGA,STL,"New York, NY",New York,"St. Louis, MO",Missouri,1404,1850,-5,-5,1399,1845,23,4,1422,1841,451,60,80,87,0,,0,0.0,0.0,0.0,0.0,0.0
2024,4,11,4,2024-04-11,MQ,5405,JFK,HNL,"New York, NY",New York,"Honolulu, HI",Hawaii,1613,1796,-12,-20,1601,1776,9,6,1610,1770,2992,365,385,380,0,,0,0.0,0.0,0.0,0.0,0.0
2024,3,15,5,2024-03-15,UA,8339,CLT,PHL,"Charlotte, NC",North Carolina,"Philadelphia, PA",Pennsylvania,832,2270,-13,-10,819,2260,8,5,827,2255,1429,174,194,187,0,,0,0.0,0.0,0.0,0.0,0.0
2024,8,3,6,2024-08-03,YX,4149,HNL,BWI,"Honolulu, HI",Hawaii,"Baltimore, MD",Maryland,876,2076,-19,-15,857,2061,12,14,869,2047,2381,304,324,330,0,,0,0.0,0.0,0.0,0.0,0.0
2024,7,21,7,2024-07-21,G4,3557,LAX,EWR,"Los Angeles, CA",California,"Newark, NJ",New Jersey,739,1911,13,10,752,1921,11,11,763,1910,246,34,54,56,0,,0,0.0,0.0,0.0,0.0,0.0
2024,7,10,3,2024-07-10,HA,3328,MIA,BWI,"Miami, FL",Florida,"Baltimore, MD",Maryland,1229,1692,1,10,1230,1702,27,15,1257,1687,1790,228,248,270,0,,0,0.0,0.0,0.0,0.0,0.0
2024,9,5,4,2024-09-05,OO,1348,ATL,JFK,"Atlanta, GA",Georgia,"New York, NY",New York,681,1904,19,10,700,1914,15,16,715,1898,2223,269,289,300,0,,0,0.0,0.0,0.0,0.0,0.0
2024,8,29,4,2024-08-29,B6,1267,PDX,SAN,"Portland, OR",Oregon,"San Diego, CA",California,1780,1462,11,10,1791,1472,16,11,1807,1461,2993,366,386,393,0,,0,0.0,0.0,0.0,0.0,0.0
2024,6,27,4,2024-06-27,G4,3590,DFW,DEN,"Dallas/Fort Worth, TX",Texas,"Denver, CO",Colorado,1243,941,-20,-10,1223,931,16,7,1239,924,814,97,117,120,0,,0,0.0,0.0,0.0,0.0,0.0
2024,8,6,2,2024-08-06,G4,1997,DTW,BOS,"Detroit, MI",Michigan,"Boston, MA",Massachusetts,1712,1469,-1,0,1711,1469,20,10,1731,1459,1662,213,233,243,0,,0,0.0,0.0,0.0,0.0,0.0
2024,3,22,5,2024-03-22,AS,2279,SAN,DTW,"San Diego, CA",California,"Detroit, MI",Michigan,1340,1956,5,15,1345,1971,20,3,1365,1968,1213,148,168,171,0,,0,0.0,0.0,0.0,0.0,0.0
2024,4,1,1,2024-04-01,OO,6055,BOS,PHX,"Boston, MA",Massachusetts,"Phoenix, AZ",Arizona,1938,2009,4,5,1942,2014,19,18,1961,1996,445,63,83,100,0,,0,0.0,0.0,0.0,0.0,0.0
2024,6,23,7,2024-06-23,AA,2820,SFO,MDW,"San Francisco, CA",California,"Chicago, IL",Illinois,1778,1965,-23,-20,1755,1945,5,15,1760,1930,608,70,90,90,0,,0,0.0,0.0,0.0,0.0,0.0
2024,8,26,1,2024-08-26,9E,2043,IAD,LGA,"Washington, DC",District of Columbia,"New York, NY",New York,1568,916,2,0,1570,916,19,12,1589,904,2932,362,382,393,0,,0,0.0,0.0,0.0,0.0,0.0
2024,9,16,1,2024-09-16,NK,6012,BOS,SEA,"Boston, MA",Massachusetts,"Seattle, WA",Washington,1508,1930,-17,-20,1491,1910,26,11,1517,1899,2752,352,372,389,0,,0,0.0,0.0,0.0,0.0,0.0
2024,12,30,1,2024-12-30,OH,7786,MSP,DEN,"Minneapolis, MN",Minnesota,"Denver, CO",Colorado,1327,1796,-11,-10,1316,1786,22,18,1338,1768,1677,206,226,246,0,,0,0.0,0.0,0.0,0.0,0.0
2024,6,11,2,2024-06-11,AS,3796,PDX,PHL,"Portland, OR",Oregon,"Philadelphia, PA",Pennsylvania,1097,1143,-15,-5,1082,1138,28,11,1110,1127,2605,316,336,355,0,,0,0.0,0.0,0.0,0.0,0.0
2024,2,17,6,2024-02-17,G4,2925,DEN,IAD,"Denver, CO",Colorado,"Washington, DC",District of Columbia,1516,1823,5,10,1521,1833,10,14,1531,1819,2915,361,381,385,0,,0,0.0,0.0,0.0,0.0,0.0
2024,11,24,7,2024-11-24,NK,8514,LGA,SEA,"New York, NY",New York,"Seattle, WA",Washington,700,2215,6,5,706,2220,13,6,719,2214,2640,333,353,352,0,,0,0.0,0.0,0.0,0.0,0.0
2024,11,23,6,2024-11-23,OH,1846,IAD,PDX,"Washington, DC",District of Columbia,"Portland, OR",Oregon,1882,674,4,-5,1886,669,21,11,1907,658,297,36,56,68,0,,0,0.0,0.0,0.0,0.0,0.0
2024,4,25,4,2024-04-25,YX,629,STL,SLC,"St. Louis, MO",Missouri,"Salt Lake City, UT",Utah,842,1375,4,0,846,1375,28,18,874,1357,2185,280,300,326,0,,0,0.0,0.0,0.0,0.0,0.0
2024,12,2,1,2024-12-02,OO,6484,MDW,ORD,"Chicago, IL",Illinois,"Chicago, IL",Illinois,1735,2220,12,10,1747,2230,16,4,1763,2226,1885,242,262,262,0,,0,0.0,0.0,0.0,0.0,0.0
2024,12,2,1,2024-12-02,YX,8425,IAH,LAS,"Houston, TX",Texas,"Las Vegas, NV",Nevada,1130,816,-6,-10,1124,806,6,16,1130,790,2308,293,313,315,0,,0,0.0,0.0,0.0,0.0,0.0
2024,8,12,1,2024-08-12,MQ,4586,PHX,DTW,"Phoenix, AZ",Arizona,"Detroit, MI",Michigan,797,1232,5,0,802,1232,20,6,822,1226,1466,187,207,213,0,,0,0.0,0.0,0.0,0.0,0.0
2024,12,17,2,2024-12-17,WN,201,MSP,MDW,"Minneapolis, MN",Minnesota,"Chicago, IL",Illinois,1678,1131,-9,-10,1669,1121,27,13,1696,1108,1595,195,215,235,0,,0,0.0,0.0,0.0,0.0,0.0
2024,11,23,6,2024-11-23,NK,3823,HNL,SEA,"Honolulu, HI",Hawaii,"Seattle, WA",Washington,1197,1048,9,0,1206,1048,19,6,1225,1042,1034,130,150,155,0,,0,0.0,0.0,0.0,0.0,0.0
2024,5,26,7,2024-05-26,DL,2828,DFW,DTW,"Dallas/Fort Worth, TX",Texas,"Detroit, MI",Michigan,1720,2284,-20,-20,1700,2264,16,4,1716,2260,626,70,90,90,0,,0,0.0,0.0,0.0,0.0,0.0
2024,3,3,7,2024-03-03,AS,2645,IAH,BOS,"Houston, TX",Texas,"Boston, MA",Massachusetts,2005,1630,11,10,2016,1640,19,17,2035,1623,2420,292,312,328,0,,0,0.0,0.0,0.0,0.0,0.0
2024,10,20,7,2024-10-20,HA,2658,STL,ATL,"St. Louis, MO",Missouri,"Atlanta, GA",Georgia,1212,1488,-29,-20,1183,1468,17,11,1200,1457,1776,222,242,250,0,,0,0.0,0.0,0.0,0.0,0.0
2024,11,18,1,2024-11-18,AS,6946,LAX,DCA,"Los Angeles, CA",California,"Washington, DC",District of Columbia,1429,992,-18,-10,1411,982,16,14,1427,968,805,92,112,122,0,,0,0.0,0.0,0.0,0.0,0.0
2024,11,20,3,2024-11-20,DL,1048,LAX,PDX,"Los Angeles, CA",California,"Portland, OR",Oregon,1277,2221,1,-5,1278,2216,23,7,1301,2209,346,33,53,63,0,,0,0.0,0.0,0.0,0.0,0.0
2024,1,13,6,2024-01-13,OH,9860,SEA,MCO,"Seattle, WA",Washington,"Orlando, FL",Florida,878,2009,3,0,881,2009,20,9,901,2000,499,63,83,92,0,,0,0.0,0.0,0.0,0.0,0.0
2024,7,7,7,2024-07-07,WN,5036,MDW,LAS,"Chicago, IL",Illinois,"Las Vegas, NV",Nevada,1247,2124,1,5,1248,2129,11,14,1259,2115,1249,157,177,182,0,,0,0.0,0.0,0.0,0.0,0.0
2024,10,13,7,2024-10-13,F9,2153,ATL,PHX,"Atlanta, GA",Georgia,"Phoenix, AZ",Arizona,1205,1770,-6,-15,1199,1755,21,7,1220,1748,1879,243,263,271,1,,0,0.0,0.0,0.0,0.0,0.0
2024,7,26,5,2024-07-26,F9,293,LAS,HNL,"Las Vegas, NV",Nevada,"Honolulu, HI",Hawaii,866,915,-17,-20,849,895,14,5,863,890,1869,238,258,257,0,,0,0.0,0.0,0.0,0.0,0.0
2024,4,23,2,2024-04-23,MQ,9033,IAD,CLT,"Washington, DC",District of Columbia,"Charlotte, NC",North Carolina,2060,1053,3,5,2063,1058,13,17,2076,1041,748,87,107,117,0,,0,0.0,0.0,0.0,0.0,0.0
2024,1,22,1,2024-01-22,F9,7404,MIA,PDX,"Miami, FL",Florida,"Portland, OR",Oregon,1270,1810,4,5,1274,1815,10,19,1284,1796,405,52,72,81,0,,0,0.0,0.0,0.0,0.0,0.0
2024,12,14,6,2024-12-14,F9,3059,CLT,MIA,"Charlotte, NC",North Carolina,"Miami, FL",Florida,1594,1948,10,10,1604,1958,27,5,1631,1953,2709,330,350,362,0,,0,0.0,0.0,0.0,0.0,0.0
2024,8,1,4,2024-08-01,AA,8274,DFW,SAN,"Dallas/Fort Worth, TX",Texas,"San Diego, CA",California,1551,1412,5,5,1556,1417,13,17,1569,1400,1680,204,224,234,0,,0,0.0,0.0,0.0,0.0,0.0
2024,6,19,3,2024-06-19,DL,3023,IAH,LGA,"Houston, TX",Texas,"New York, NY",New York,1916,917,13,5,1929,922,5,8,1934,914,2415,291,311,304,0,,0,0.0,0.0,0.0,0.0,0.0
2024,11,18,1,2024-11-18,YX,3339,ATL,IAH,"Atlanta, GA",Georgia,"Houston, TX",Texas,2046,993,-3,-5,2043,988,20,13,2063,975,575,75,95,108,0,,0,0.0,0.0,0.0,0.0,0.0
2024,2,23,5,2024-02-23,HA,3965,IAH,SAN,"Houston, TX",Texas,"San Diego, CA",California,848,978,-1,0,847,978,18,16,865,962,1426,169,189,203,0,,0,0.0,0.0,0.0,0.0,0.0
2024,10,24,4,2024-10-24,WN,8329,DCA,JFK,"Washington, DC",District of Columbia,"New York, NY",New York,1641,1304,15,10,1656,1314,12,6,1668,1308,1105,141,161,159,0,,0,0.0,0.0,0.0,0.0,0.0
2024,11,15,5,2024-11-15,YX,9990,BWI,EWR,"Baltimore, MD",Maryland,"Newark, NJ",New Jersey,1903,1393,-11,-10,1892,1383,19,5,1911,1378,870,115,135,139,0,,0,0.0,0.0,0.0,0.0,0.0
2024,5,5,7,2024-05-05,G4,4666,MIA,SEA,"Miami, FL",Florida,"Seattle, WA",Washington,1731,2097,-6,-5,1725,2092,20,10,1745,2082,1661,199,219,229,0,,0,0.0,0.0,0.0,0.0,0.0
2024,10,3,4,2024-10-03,UA,6695,LAS,MIA,"Las Vegas, NV",Nevada,"Miami, FL",Florida,1946,2323,6,5,1952,2328,18,5,1970,2323,2464,298,318,321,0,,0,0.0,0.0,0.0,0.0,0.0
2024,7,22,1,2024-07-22,OH,5709,SAN,SLC,"San Diego, CA",California,"Salt Lake City, UT",Utah,592,1641,-10,0,582,1641,20,6,602,1635,1382,176,196,202,0,,0,0.0,0.0,0.0,0.0,0.0
2024,7,12,5,2024-07-12,AS,3313,HNL,MCO,"Honolulu, HI",Hawaii,"Orlando, FL",Florida,640,1426,12,5,652,1431,11,6,663,1425,2752,344,364,361,0,,0,0.0,0.0,0.0,0.0,0.0
2024,6,17,1,2024-06-17,NK,5208,TPA,BOS,"Tampa, FL",Florida,"Boston, MA",Massachusetts,854,748,-1,-10,853,738,22,16,875,722,855,111,131,149,0,,0,0.0,0.0,0.0,0.0,0.0
2024,5,31,5,2024-05-31,F9,1883,MSP,SFO,"Minneapolis, MN",Minnesota,"San Francisco, CA",California,2046,1157,-20,-20,2026,1137,21,14,2047,1123,1580,200,220,235,0,,0,0.0,0.0,0.0,0.0,0.0
2024,2,4,7,2024-02-04,MQ,8394,LAS,DFW,"Las Vegas, NV",Nevada,"Dallas/Fort Worth, TX",Texas,2274,1635,-24,-20,2250,1615,5,5,2255,1610,2317,285,305,295,0,,0,0.0,0.0,0.0,0.0,0.0
2024,7,2,2,2024-07-02,NK,5930,EWR,MDW,"Newark, NJ",New Jersey,"Chicago, IL",Illinois,2299,1341,18,15,2317,1356,15,10,2332,1346,498,57,77,82,0,,0,0.0,0.0,0.0,0.0,0.0
2024,10,12,6,2024-10-12,UA,5931,CLT,BOS,"Charlotte, NC",North Carolina,"Boston, MA",Massachusetts,2298,1061,12,15,2310,1076,24,16,2334,1060,322,44,64,84,0,,0,0.0,0.0,0.0,0.0,0.0
2024,2,26,1,2024-02-26,AS,141,STL,PHL,"St. Louis, MO",Missouri,"Philadelphia, PA",Pennsylvania,1592,2248,-17,-10,1575,2238,9,3,1584,2235,1854,234,254,246,0,,0,0.0,0.0,0.0,0.0,0.0
2024,8,9,5,2024-08-09,B6,6309,PDX,MSP,"Portland, OR",Oregon,"Minneapolis, MN",Minnesota,1081,1783,-23,-15,1058,1768,27,16,1085,1752,1647,214,234,257,0,,0,0.0,0.0,0.0,0.0,0.0
2024,10,29,2,2024-10-29,HA,1161,DTW,IAD,"Detroit, MI",Michigan,"Washington, DC",District of Columbia,2220,1576,-21,-20,2199,1556,17,9,2216,1547,1800,221,241,247,0,,0,0.0,0.0,0.0,0.0,0.0
2024,6,11,2,2024-06-11,MQ,9968,DFW,HNL,"Dallas/Fort Worth, TX",Texas,"Honolulu, HI",Hawaii,1382,1294,-12,-10,1370,1284,12,15,1382,1269,354,51,71,78,0,,0,0.0,0.0,0.0,0.0,0.0
2024,1,19,5,2024-01-19,YX,3789,LAS,STL,"Las Vegas, NV",Nevada,"St. Louis, MO",Missouri,623,1166,-1,-5,622,1161,22,11,644,1150,2204,273,293,306,0,,0,0.0,0.0,0.0,0.0,0.0
2024,9,20,5,2024-09-20,9E,7695,MIA,DFW,"Miami, FL",Florida,"Dallas/Fort Worth, TX",Texas,1942,865,-13,-10,1929,855,17,18,1946,837,2416,303,323,338,0,,0,0.0,0.0,0.0,0.0,0.0
2024,10,8,2,2024-10-08,WN,6907,EWR,IAH,"Newark, NJ",New Jersey,"Houston, TX",Texas,2257,1146,7,5,2264,1151,13,18,2277,1133,1109,147,167,178,0,,0,0.0,0.0,0.0,0.0,0.0
2024,4,22,1,2024-04-22,AA,4097,LAX,ORD,"Los Angeles, CA",California,"Chicago, IL",Illinois,2046,679,1,5,2047,684,15,10,2062,674,539,63,83,88,0,,0,0.0,0.0,0.0,0.0,0.0
2024,11,22,5,2024-11-22,OH,425,MDW,HNL,"Chicago, IL",Illinois,"Honolulu, HI",Hawaii,2201,1117,-13,-15,2188,1102,27,10,2215,1092,2092,267,287,304,0,,0,0.0,0.0,0.0,0.0,0.0
2024,1,30,2,2024-01-30,MQ,7305,DCA,MDW,"Washington, DC",District of Columbia,"Chicago, IL",Illinois,1102,2262,0,5,1102,2267,10,4,1112,2263,422,59,79,73,0,,0,0.0,0.0,0.0,0.0,0.0
2024,5,14,2,2024-05-14,NK,1220,LGA,ORD,"New York, NY",New York,"Chicago, IL",Illinois,2283,1691,-1,0,2282,1691,15,4,2297,1687,2761,352,372,371,0,,0,0.0,0.0,0.0,0.0,0.0
2024,3,7,4,2024-03-07,F9,207,BOS,IAD,"Boston, MA",Massachusetts,"Washington, DC",District of Columbia,1864,1301,-7,-15,1857,1286,19,12,1876,1274,924,122,142,153,0,,0,0.0,0.0,0.0,0.0,0.0
2024,3,5,2,2024-03-05,DL,6394,ATL,LGA,"Atlanta, GA",Georgia,"New York, NY",New York,1473,843,5,5,1478,848,18,19,1496,829,1312,155,175,192,0,,0,0.0,0.0,0.0,0.0,0.0
2024,10,18,5,2024-10-18,NK,5293,LAX,IAH,"Los Angeles, CA",California,"Houston, TX",Texas,804,608,-10,-15,794,593,12,10,806,583,1236,148,168,170,0,,0,0.0,0.0,0.0,0.0,0.0
2024,1,25,4,2024-01-25,AS,7324,HNL,DTW,"Honolulu, HI",Hawaii,"Detroit, MI",Michigan,1302,1780,-1,-10,1301,1770,22,10,1323,1760,1259,150,170,182,0,,0,0.0,0.0,0.0,0.0,0.0
2024,2,6,2,2024-02-06,B6,8626,EWR,PHX,"Newark, NJ",New Jersey,"Phoenix, AZ",Arizona,1680,2206,-12,-15,1668,2191,5,7,1673,2184,2485,316,336,328,0,,0,0.0,0.0,0.0,0.0,0.0
2024,1,1,1,2024-01-01,MQ,2139,CLT,MIA,"Charlotte, NC",North Carolina,"Miami, FL",Florida,1611,1063,13,15,1624,1078,25,5,1649,1073,915,114,134,144,0,,0,0.0,0.0,0.0,0.0,0.0
2024,2,6,2,2024-02-06,WN,903,STL,LAS,"St. Louis, MO",Missouri,"Las Vegas, NV",Nevada,1751,1245,10,5,1761,1250,13,3,1774,1247,413,46,66,62,0,,0,0.0,0.0,0.0,0.0,0.0
2024,5,20,1,2024-05-20,DL,866,LAX,DEN,"Los Angeles, CA",California,"Denver, CO",Colorado,1436,1923,-7,-5,1429,1918,27,9,1456,1909,2143,259,279,295,0,,0,0.0,0.0,0.0,0.0,0.0
2024,8,19,1,2024-08-19,9E,3627,DCA,MIA,"Washington, DC",District of Columbia,"Miami, FL",Florida,864,1943,5,10,869,1953,11,9,880,1944,214,23,43,43,0,,0,0.0,0.0,0.0,0.0,0.0
2024,5,15,3,2024-05-15,AS,2406,HNL,MSP,"Honolulu, HI",Hawaii,"Minneapolis, MN",Minnesota,1491,848,-15,-10,1476,838,19,15,1495,823,334,32,52,66,0,,0,0.0,0.0,0.0,0.0,0.0
2024,7,6,6,2024-07-06,B6,1588,ATL,PDX,"Atlanta, GA",Georgia,"Portland, OR",Oregon,2169,922,22,15,2191,937,19,8,2210,929,1866,227,247,254,0,,0,0.0,0.0,0.0,0.0,0.0
2024,5,7,2,2024-05-07,DL,4229,CLT,JFK,"Charlotte, NC",North Carolina,"New York, NY",New York,765,1155,13,5,778,1160,13,15,791,1145,2907,362,382,390,0,,0,0.0,0.0,0.0,0.0,0.0
2024,7,19,5,2024-07-19,9E,2473,JFK,STL,"New York, NY",New York,"St. Louis, MO",Missouri,583,2251,6,0,589,2251,25,4,614,2247,626,73,93,102,0,,0,0.0,0.0,0.0,0.0,0.0
2024,5,6,1,2024-05-06,NK,9128,TPA,PHX,"Tampa, FL",Florida,"Phoenix, AZ",Arizona,1735,2085,-2,5,1733,2090,9,4,1742,2086,1780,224,244,237,0,,0,0.0,0.0,0.0,0.0,0.0
2024,9,13,5,2024-09-13,AS,3409,SLC,BWI,"Salt Lake City, UT",Utah,"Baltimore, MD",Maryland,1741,2021,8,0,1749,2021,11,4,1760,2017,2787,343,363,358,0,,0,0.0,0.0,0.0,0.0,0.0
2024,6,12,3,2024-06-12,YX,6934,IAH,BWI,"Houston, TX",Texas,"Baltimore, MD",Maryland,1352,992,10,10,1362,1002,16,17,1378,985,1066,126,146,159,0,,0,0.0,0.0,0.0,0.0,0.0
2024,2,4,7,2024-02-04,HA,5835,BWI,PHL,"Baltimore, MD",Maryland,"Philadelphia, PA",Pennsylvania,1248,1851,10,10,1258,1861,10,17,1268,1844,2292,276,296,303,0,,0,0.0,0.0,0.0,0.0,0.0
2024,7,12,5,2024-07-12,HA,4934,DFW,DCA,"Dallas/Fort Worth, TX",Texas,"Washington, DC",District of Columbia,650,1518,-10,-10,640,1508,14,7,654,1501,2031,244,264,265,0,,0,0.0,0.0,0.0,0.0,0.0
2024,7,9,2,2024-07-09,OO,7090,LGA,SLC,"New York, NY",New York,"Salt Lake City, UT",Utah,1185,1168,-2,-10,1183,1158,19,16,1202,1142,2768,351,371,386,0,,0,0.0,0.0,0.0,0.0,0.0
2024,4,13,6,2024-04-13,G4,4083,LGA,JFK,"New York, NY",New York,"New York, NY",New York,639,843,-18,-15,621,828,26,7,647,821,1294,158,178,191,0,,0,0.0,0.0,0.0,0.0,0.0
2024,1,23,2,2024-01-23,OO,3868,ORD,MSP,"Chicago, IL",Illinois,"Minneapolis, MN",Minnesota,554,1680,-5,-10,549,1670,28,10,577,1660,2543,326,346,364,0,,0,0.0,0.0,0.0,0.0,0.0
2024,9,21,6,2024-09-21,9E,1604,DTW,ORD,"Detroit, MI",Michigan,"Chicago, IL",Illinois,1664,1766,-8,-5,1656,1761,8,13,1664,1748,2201,278,298,299,0,,0,0.0,0.0,0.0,0.0,0.0
2024,10,16,3,2024-10-16,B6,6893,MSP,BWI,"Minneapolis, MN",Minnesota,"Baltimore, MD",Maryland,573,791,-22,-20,551,771,19,10,570,761,1015,130,150,159,0,,0,0.0,0.0,0.0,0.0,0.0
2024,9,16,1,2024-09-16,G4,2550,PHL,PDX,"Philadelphia, PA",Pennsylvania,"Portland, OR",Oregon,1658,1118,-4,-5,1654,1113,22,8,1676,1105,2134,263,283,293,0,,0,0.0,0.0,0.0,0.0,0.0
2024,12,23,1,2024-12-23,G4,2133,CLT,PHX,"Charlotte, NC",North Carolina,"Phoenix, AZ",Arizona,1496,2027,6,5,1502,2032,7,6,1509,2026,884,109,129,122,0,,0,0.0,0.0,0.0,0.0,0.0
2024,3,15,5,2024-03-15,MQ,8102,PHL,SEA,"Philadelphia, PA",Pennsylvania,"Seattle, WA",Washington,1407,1559,1,10,1408,1569,19,5,1427,1564,697,82,102,106,0,,0,0.0,0.0,0.0,0.0,0.0
2024,12,20,5,2024-12-20,AA,9991,MSP,ATL,"Minneapolis, MN",Minnesota,"Atlanta, GA",Georgia,1328,1898,-25,-20,1303,1878,24,14,1327,1864,2394,305,325,343,0,,0,0.0,0.0,0.0,0.0,0.0
2024,3,12,2,2024-03-12,B6,6119,LAX,PDX,"Los Angeles, CA",California,"Portland, OR",Oregon,1141,2269,-27,-20,1114,2249,9,13,1123,2236,2423,298,318,320,0,,0,0.0,0.0,0.0,0.0,0.0
2024,9,15,7,2024-09-15,G4,1407,BWI,IAD,"Baltimore, MD",Maryland,"Washington, DC",District of Columbia,1243,1662,-13,-15,1230,1647,6,7,1236,1640,705,91,111,104,0,,0,0.0,0.0,0.0,0.0,0.0
2024,7,6,6,2024-07-06,NK,1075,DFW,MDW,"Dallas/Fort Worth, TX",Texas,"Chicago, IL",Illinois,525,792,3,10,528,802,19,10,547,792,1251,162,182,191,0,,0,0.0,0.0,0.0,0.0,0.0
2024,6,21,5,2024-06-21,AS,5039,PDX,DCA,"Portland, OR",Oregon,"Washington, DC",District of Columbia,2011,926,-2,0,2009,926,12,13,2021,913,1651,206,226,231,0,,0,0.0,0.0,0.0,0.0,0.0
2024,10,16,3,2024-10-16,AS,3833,DFW,SEA,"Dallas/Fort Worth, TX",Texas,"Seattle, WA",Washington,934,1082,26,30,960,1112,9,13,969,1099,2206,272,292,294,0,,0,5.0,1.0,3.0,0.0,21.0
2024,2,14,3,2024-02-14,OO,8651,ORD,BWI,"Chicago, IL",Illinois,"Baltimore, MD",Maryland,2104,624,5,10,2109,634,27,5,2136,629,221,24,44,56,0,,0,0.0,0.0,0.0,0.0,0.0
2024,3,1,5,2024-03-01,NK,2323,PHL,DCA,"Philadelphia, PA",Pennsylvania,"Washington, DC",District of Columbia,561,701,17,10,578,711,13,13,591,698,1309,161,181,187,0,,0,0.0,0.0,0.0,0.0,0.0
2024,3,23,6,2024-03-23,AA,584,DEN,LAX,"Denver, CO",Colorado,"Los Angeles, CA",California,1723,1262,-11,-15,1712,1247,11,8,1723,1239,2729,331,351,350,0,,0,0.0,0.0,0.0,0.0,0.0
2024,5,2,4,2024-05-02,WN,1528,SLC,PHL,"Salt Lake City, UT",Utah,"Philadelphia, PA",Pennsylvania,989,816,5,0,994,816,8,8,1002,808,2547,320,340,336,1,,0,0.0,0.0,0.0,0.0,0.0
2024,12,23,1,2024-12-23,MQ,2180,JFK,BWI,"New York, NY",New York,"Baltimore, MD",Maryland,992,1341,35,45,1027,1386,23,7,1050,1379,695,84,104,114,0,,0,2.0,6.0,7.0,0.0,30.0
2024,1,16,2,2024-01-16,HA,795,ORD,SLC,"Chicago, IL",Illinois,"Salt Lake City, UT",Utah,1178,866,-16,-15,1162,851,12,7,1174,844,2278,281,301,300,0,,0,0.0,0.0,0.0,0.0,0.0
2024,3,6,3,2024-03-06,AA,6400,IAD,PHX,"Washington, DC",District of Columbia,"Phoenix, AZ",Arizona,967,761,-7,0,960,761,18,7,978,754,1314,157,177,182,0,,0,0.0,0.0,0.0,0.0,0.0
2024,5,24,5,2024-05-24,AS,4760,PHX,MCO,"Phoenix, AZ",Arizona,"Orlando, FL",Florida,1639,886,-12,-5,1627,881,13,3,1640,878,689,80,100,96,0,,0,0.0,0.0,0.0,0.0,0.0
2024,6,10,1,2024-06-10,OH,301,DFW,STL,"Dallas/Fort Worth, TX",Texas,"St. Louis, MO",Missouri,1894,1277,2,-5,1896,1272,9,3,1905,1269,1223,150,170,162,0,,0,0.0,0.0,0.0,0.0,0.0
2024,8,21,3,2024-08-21,MQ,9490,PHL,DCA,"Philadelphia, PA",Pennsylvania,"Washington, DC",District of Columbia,1150,1485,12,10,1162,1495,10,9,1172,1486,2444,311,331,330,0,,0,0.0,0.0,0.0,0.0,0.0
2024,5,23,4,2024-05-23,WN,9559,DFW,CLT,"Dallas/Fort Worth, TX",Texas,"Charlotte, NC",North Carolina,1755,846,-10,0,1745,846,14,11,1759,835,326,38,58,63,0,,0,0.0,0.0,0.0,0.0,0.0
2024,12,23,1,2024-12-23,AA,8365,TPA,CLT,"Tampa, FL",Florida,"Charlotte, NC",North Carolina,947,773,14,5,961,778,17,18,978,760,2073,257,277,292,0,,0,0.0,0.0,0.0,0.0,0.0
2024,7,6,6,2024-07-06,G4,8387,ORD,MIA,"Chicago, IL",Illinois,"Miami, FL",Florida,1737,2019,4,5,1741,2024,14,11,1755,2013,2340,287,307,312,0,,0,0.0,0.0,0.0,0.0,0.0
2024,11,17,7,2024-11-17,YX,3577,DFW,MIA,"Dallas/Fort Worth, TX",Texas,"Miami, FL",Florida,707,1632,-10,0,697,1632,26,14,723,1618,2953,378,398,418,0,,0,0.0,0.0,0.0,0.0,0.0
2024,1,13,6,2024-01-13,WN,2302,DTW,TPA,"Detroit, MI",Michigan,"Tampa, FL",Florida,1501,1508,-4,5,1497,1513,17,13,1514,1500,2206,266,286,296,0,,0,0.0,0.0,0.0,0.0,0.0
2024,7,2,2,2024-07-02,YX,7590,SFO,DEN,"San Francisco, CA",California,"Denver, CO",Colorado,1625,2071,18,20,1643,2091,7,14,1650,2077,642,72,92,93,0,,0,7.0,3.0,1.0,0.0,9.0
2024,4,20,6,2024-04-20,AS,8549,LAS,LGA,"Las Vegas, NV",Nevada,"New York, NY",New York,509,1617,10,20,519,1637,16,12,535,1625,1788,223,243,251,0,,0,0.0,0.0,1.0,0.0,19.0
2024,10,16,3,2024-10-16,MQ,6417,SLC,SEA,"Salt Lake City, UT",Utah,"Seattle, WA",Washington,1996,1387,9,5,2005,1392,8,11,2013,1381,2222,286,306,305,0,,0,0.0,0.0,0.0,0.0,0.0
2024,10,21,1,2024-10-21,NK,4525,PHL,SAN,"Philadelphia, PA",Pennsylvania,"San Diego, CA",California,1646,2194,4,0,1650,2194,15,15,1665,2179,428,45,65,75,0,,0,0.0,0.0,0.0,0.0,0.0
2024,8,2,5,2024-08-02,F9,5450,PHX,SEA,"Phoenix, AZ",Arizona,"Seattle, WA",Washington,1286,1196,-19,-10,1267,1186,13,14,1280,1172,1639,202,222,229,0,,0,0.0,0.0,0.0,0.0,0.0
2024,4,29,1,2024-04-29,YX,2906,IAH,DTW,"Houston, TX",Texas,"Detroit, MI",Michigan,503,1261,-19,-20,484,1241,10,11,494,1230,2552,321,341,342,0,,0,0.0,0.0,0.0,0.0,0.0
2024,2,24,6,2024-02-24,MQ,7263,LGA,BWI,"New York, NY",New York,"Baltimore, MD",Maryland,966,1944,-3,-10,963,1934,16,6,979,1928,2340,301,321,323,0,,0,0.0,0.0,0.0,0.0,0.0
2024,1,27,6,2024-01-27,OO,285,LGA,MIA,"New York, NY",New York,"Miami, FL",Florida,758,2195,-6,-5,752,2190,18,3,770,2187,1735,219,239,240,0,,0,0.0,0.0,0.0,0.0,0.0
2024,4,27,6,2024-04-27,G4,8170,SEA,IAD,"Seattle, WA",Washington,"Washington, DC",District of Columbia,1220,1748,-13,-15,1207,1733,25,15,1232,1718,1608,200,220,240,0,,0,0.0,0.0,0.0,0.0,0.0
2024,8,8,4,2024-08-08,G4,8434,LAX,DEN,"Los Angeles, CA",California,"Denver, CO",Colorado,2297,640,-12,-10,2285,630,13,4,2298,626,1098,143,163,160,0,,0,0.0,0.0,0.0,0.0,0.0
2024,8,18,7,2024-08-18,F9,7150,LAX,EWR,"Los Angeles, CA",California,"Newark, NJ",New Jersey,786,936,-23,-15,763,921,12,10,775,911,2714,340,360,362,0,,0,0.0,0.0,0.0,0.0,0.0
2024,2,22,4,2024-02-22,9E,8931,SFO,STL,"San Francisco, CA",California,"St. Louis, MO",Missouri,530,2308,-3,0,527,2308,13,14,540,2294,2453,307,327,334,0,,0,0.0,0.0,0.0,0.0,0.0
2024,10,21,1,2024-10-21,OO,2174,TPA,DTW,"Tampa, FL",Florida,"Detroit, MI",Michigan,2211,925,-12,-15,2199,910,17,15,2216,895,1127,149,169,181,0,,0,0.0,0.0,0.0,0.0,0.0
2024,11,16,6,2024-11-16,HA,7754,DTW,MDW,"Detroit, MI",Michigan,"Chicago, IL",Illinois,1020,2308,10,5,1030,2313,15,15,1045,2298,478,57,77,87,0,,0,0.0,0.0,0.0,0.0,0.0
2024,8,20,2,2024-08-20,YX,301,MSP,EWR,"Minneapolis, MN",Minnesota,"Newark, NJ",New Jersey,1215,1809,-10,-5,1205,1804,13,3,1218,1801,2401,301,321,317,0,,0,0.0,0.0,0.0,0.0,0.0
2024,6,6,4,2024-06-06,YX,5810,DEN,STL,"Denver, CO",Colorado,"St. Louis, MO",Missouri,2143,1864,3,5,2146,1869,24,10,2170,1859,427,51,71,85,0,,0,0.0,0.0,0.0,0.0,0.0
2024,9,25,3,2024-09-25,HA,3265,MDW,DEN,"Chicago, IL",Illinois,"Denver, CO",Colorado,623,1962,3,10,626,1972,12,7,638,1965,2925,365,385,384,0,,0,0.0,0.0,0.0,0.0,0.0
2024,1,21,7,2024-01-21,OH,2202,IAH,PDX,"Houston, TX",Texas,"Portland, OR",Oregon,2273,1717,-7,-15,2266,1702,14,19,2280,1683,2969,369,389,402,0,,0,0.0,0.0,0.0,0.0,0.0
2024,2,22,4,2024-02-22,UA,9202,DFW,LAS,"Dallas/Fort Worth, TX",Texas,"Las Vegas, NV",Nevada,1421,1518,34,30,1455,1548,13,4,1468,1544,2003,252,272,269,0,,0,3.0,0.0,0.0,0.0,27.0
2024,10,1,2,2024-10-01,YX,1671,PHL,LAS,"Philadelphia, PA",Pennsylvania,"Las Vegas, NV",Nevada,629,2039,0,0,629,2039,25,14,654,2025,2241,282,302,321,0,,0,0.0,0.0,0.0,0.0,0.0
2024,11,8,5,2024-11-08,DL,5225,LAX,MCO,"Los Angeles, CA",California,"Orlando, FL",Florida,1245,1686,-16,-15,1229,1671,8,3,1237,1668,2822,354,374,365,0,,0,0.0,0.0,0.0,0.0,0.0
2024,10,7,1,2024-10-07,B6,6797,DCA,TPA,"Washington, DC",District of Columbia,"Tampa, FL",Florida,1015,1615,-8,-5,1007,1610,14,14,1021,1596,823,104,124,132,0,,0,0.0,0.0,0.0,0.0,0.0
2024,8,1,4,2024-08-01,AA,5269,IAD,ORD,"Washington, DC",District of Columbia,"Chicago, IL",Illinois,2003,1332,2,10,2005,1342,21,14,2026,1328,1563,191,211,226,0,,0,0.0,0.0,0.0,0.0,0.0
2024,1,31,3,2024-01-31,UA,2259,MDW,MCO,"Chicago, IL",Illinois,"Orlando, FL",Florida,2255,1119,8,0,2263,1119,23,3,2286,1116,1111,139,159,165,0,,0,0.0,0.0,0.0,0.0,0.0
2024,12,2,1,2024-12-02,AA,1429,LAS,MIA,"Las Vegas, NV",Nevada,"Miami, FL",Florida,1273,2348,-17,-10,1256,2338,14,5,1270,2333,1721,213,233,232,0,,0,0.0,0.0,0.0,0.0,0.0
2024,7,1,1,2024-07-01,MQ,3713,JFK,HNL,"New York, NY",New York,"Honolulu, HI",Hawaii,2065,1832,17,15,2082,1847,22,3,2104,1844,2360,286,306,311,0,,0,0.0,0.0,0.0,0.0,0.0
2024,1,23,2,2024-01-23,UA,8752,IAD,LGA,"Washington, DC",District of Columbia,"New York, NY",New York,1450,1832,3,5,1453,1837,20,3,1473,1834,2134,267,287,290,0,,0,0.0,0.0,0.0,0.0,0.0
2024,2,1,4,2024-02-01,MQ,9098,IAH,ATL,"Houston, TX",Texas,"Atlanta, GA",Georgia,576,1999,14,5,590,2004,27,11,617,1993,2833,347,367,385,0,,0,0.0,0.0,0.0,0.0,0.0
2024,3,14,4,2024-03-14,WN,3799,MIA,DTW,"Miami, FL",Florida,"Detroit, MI",Michigan,1706,684,12,10,1718,694,8,3,1726,691,1710,222,242,233,0,,0,0.0,0.0,0.0,0.0,0.0
2024,1,10,3,2024-01-10,NK,6127,STL,JFK,"St. Louis, MO",Missouri,"New York, NY",New York,865,806,3,5,868,811,13,14,881,797,1868,226,246,253,0,,0,0.0,0.0,0.0,0.0,0.0
2024,2,23,5,2024-02-23,YX,2373,SFO,IAH,"San Francisco, CA",California,"Houston, TX",Texas,791,1970,-1,-10,790,1960,13,7,803,1953,690,78,98,98,0,,0,0.0,0.0,0.0,0.0,0.0
2024,2,21,3,2024-02-21,HA,8350,JFK,CLT,"New York, NY",New York,"Charlotte, NC",North Carolina,2237,2288,8,0,2245,2288,6,17,2251,2271,1340,173,193,196,0,,0,0.0,0.0,0.0,0.0,0.0
2024,5,27,1,2024-05-27,YX,4923,EWR,DCA,"Newark, NJ",New Jersey,"Washington, DC",District of Columbia,1912,760,15,10,1927,770,23,17,1950,753,298,32,52,72,0,,0,0.0,0.0,0.0,0.0,0.0
2024,6,8,6,2024-06-08,B6,9447,PHX,SEA,"Phoenix, AZ",Arizona,"Seattle, WA",Washington,656,1049,-3,-10,653,1039,12,17,665,1022,1048,125,145,154,0,,0,0.0,0.0,0.0,0.0,0.0
2024,1,14,7,2024-01-14,B6,7175,EWR,JFK,"Newark, NJ",New Jersey,"New York, NY",New York,1623,715,-2,-10,1621,705,23,19,1644,686,1018,127,147,169,0,,0,0.0,0.0,0.0,0.0,0.0
2024,6,26,3,2024-06-26,MQ,597,SAN,PDX,"San Diego, CA",California,"Portland, OR",Oregon,1407,961,-4,-10,1403,951,8,11,1411,940,2544,310,330,329,0,,0,0.0,0.0,0.0,0.0,0.0
2024,2,22,4,2024-02-22,AA,7059,ATL,SAN,"Atlanta, GA",Georgia,"San Diego, CA",California,2157,1874,-9,-10,2148,1864,15,16,2163,1848,2117,265,285,296,0,,0,0.0,0.0,0.0,0.0,0.0
2024,11,30,6,2024-11-30,F9,6310,MIA,LAS,"Miami, FL",Florida,"Las Vegas, NV",Nevada,1417,1511,-15,-15,1402,1496,7,18,1409,1478,1189,143,163,168,0,,0,0.0,0.0,0.0,0.0,0.0
2024,1,22,1,2024-01-22,MQ,7226,LAS,TPA,"Las Vegas, NV",Nevada,"Tampa, FL",Florida,609,782,16,10,625,792,22,11,647,781,1099,141,161,174,0,,0,0.0,0.0,0.0,0.0,0.0
2024,1,30,2,2024-01-30,WN,4076,CLT,PDX,"Charlotte, NC",North Carolina,"Portland, OR",Oregon,2202,1275,5,10,2207,1285,21,17,2228,1268,2397,308,328,346,0,,0,0.0,0.0,0.0,0.0,0.0
2024,7,9,2,2024-07-09,9E,6520,ORD,DEN,"Chicago, IL",Illinois,"Denver, CO",Colorado,2165,1951,-6,-10,2159,1941,23,17,2182,1924,1254,165,185,205,0,,0,0.0,0.0,0.0,0.0,0.0
2024,9,16,1,2024-09-16,B6,1707,MSP,HNL,"Minneapolis, MN",Minnesota,"Honolulu, HI",Hawaii,1793,1191,-4,5,1789,1196,13,11,1802,1185,1380,164,184,188,0,,0,0.0,0.0,0.0,0.0,0.0
2024,7,23,2,2024-07-23,DL,9012,LAX,IAH,"Los Angeles, CA",California,"Houston, TX",Texas,637,1630,3,0,640,1630,20,4,660,1626,2672,337,357,361,0,,0,0.0,0.0,0.0,0.0,0.0
2024,2,28,3,2024-02-28,HA,1374,MSP,PHX,"Minneapolis, MN",Minnesota,"Phoenix, AZ",Arizona,1519,2222,-18,-10,1501,2212,12,13,1513,2199,1148,133,153,158,0,,0,0.0,0.0,0.0,0.0,0.0
2024,9,20,5,2024-09-20,YX,790,HNL,DFW,"Honolulu, HI",Hawaii,"Dallas/Fort Worth, TX",Texas,2211,2143,-9,-10,2202,2133,13,5,2215,2128,254,21,41,39,0,,0,0.0,0.0,0.0,0.0,0.0
2024,1,12,5,2024-01-12,MQ,4123,DCA,IAH,"Washington, DC",District of Columbia,"Houston, TX",Texas,563,2010,-15,-10,548,2000,9,12,557,1988,1184,139,159,160,0,,0,0.0,0.0,0.0,0.0,0.0
2024,4,28,7,2024-04-28,AA,7347,SAN,ATL,"San Diego, CA",California,"Atlanta, GA",Georgia,2166,1530,-1,5,2165,1535,9,11,2174,1524,2392,308,328,328,0,,0,0.0,0.0,0.0,0.0,0.0
2024,10,16,3,2024-10-16,G4,3537,MSP,LAX,"Minneapolis, MN",Minnesota,"Los Angeles, CA",California,1006,1993,-9,-5,997,1988,18,18,1015,1970,1241,157,177,193,0,,0,0.0,0.0,0.0,0.0,0.0
2024,12,3,2,2024-12-03,HA,2455,TPA,IAD,"Tampa, FL",Florida,"Washington, DC",District of Columbia,1339,2171,-15,-10,1324,2161,28,12,1352,2149,2156,276,296,316,0,,0,0.0,0.0,0.0,0.0,0.0
2024,9,4,3,2024-09-04,DL,5681,BOS,BWI,"Boston, MA",Massachusetts,"Baltimore, MD",Maryland,1514,1362,-12,-20,1502,1342,18,10,1520,1332,1508,187,207,215,0,,0,0.0,0.0,0.0,0.0,0.0
2024,12,19,4,2024-12-19,AS,849,MCO,PDX,"Orlando, FL",Florida,"Portland, OR",Oregon,2223,1211,18,15,2241,1226,9,6,2250,1220,2992,373,393,388,0,,0,0.0,0.0,0.0,0.0,0.0
2024,5,6,1,2024-05-06,AA,3151,HNL,EWR,"Honolulu, HI",Hawaii,"Newark, NJ",New Jersey,1476,678,12,5,1488,683,8,10,1496,673,1442,182,202,200,0,,0,0.0,0.0,0.0,0.0,0.0
2024,3,15,5,2024-03-15,AA,7863,ATL,TPA,"Atlanta, GA",Georgia,"Tampa, FL",Florida,1288,1844,3,0,1291,1844,29,17,1320,1827,2865,349,369,395,0,,0,0.0,0.0,0.0,0.0,0.0
2024,12,26,4,2024-12-26,G4,3664,MCO,SEA,"Orlando, FL",Florida,"Seattle, WA",Washington,849,2331,12,15,861,2346,21,12,882,2334,544,63,83,96,0,,0,0.0,0.0,0.0,0.0,0.0
2024,7,22,1,2024-07-22,WN,5858,MIA,STL,"Miami, FL",Florida,"St. Louis, MO",Missouri,646,2222,-7,-10,639,2212,10,14,649,2198,2653,323,343,347,0,,0,0.0,0.0,0.0,0.0,0.0
2024,2,18,7,2024-02-18,G4,1804,LAX,DCA,"Los Angeles, CA",California,"Washington, DC",District of Columbia,1858,2193,13,5,1871,2198,11,17,1882,2181,765,102,122,130,0,,0,0.0,0.0,0.0,0.0,0.0
2024,3,19,2,2024-03-19,OO,6174,PHX,TPA,"Phoenix, AZ",Arizona,"Tampa, FL",Florida,2055,2035,-13,-5,2042,2030,18,3,2060,2027,1172,149,169,170,0,,0,0.0,0.0,0.0,0.0,0.0
2024,8,28,3,2024-08-28,B6,2477,HNL,MIA,"Honolulu, HI",Hawaii,"Miami, FL",Florida,2077,2102,-1,-5,2076,2097,19,10,2095,2087,536,65,85,94,0,,0,0.0,0.0,0.0,0.0,0.0
2024,12,14,6,2024-12-14,NK,8119,IAH,ORD,"Houston, TX",Texas,"Chicago, IL",Illinois,1361,1281,15,10,1376,1291,10,17,1386,1274,1268,148,168,175,0,,0,0.0,0.0,0.0,0.0,0.0
2024,6,2,7,2024-06-02,AA,5374,BOS,MCO,"Boston, MA",Massachusetts,"Orlando, FL",Florida,906,1720,9,5,915,1725,14,17,929,1708,1838,224,244,255,0,,0,0.0,0.0,0.0,0.0,0.0
2024,9,30,1,2024-09-30,AS,3331,TPA,ORD,"Tampa, FL",Florida,"Chicago, IL",Illinois,843,2281,-7,-10,836,2271,12,13,848,2258,2171,275,295,300,0,,0,0.0,0.0,0.0,0.0,0.0
2024,4,5,5,2024-04-05,F9,6509,MSP,SLC,"Minneapolis, MN",Minnesota,"Salt Lake City, UT",Utah,1151,992,-11,-15,1140,977,12,18,1152,959,2115,260,280,290,0,,0,0.0,0.0,0.0,0.0,0.0
2024,8,1,4,2024-08-01,OH,2315,HNL,LGA,"Honolulu, HI",Hawaii,"New York, NY",New York,2044,1067,-9,-5,2035,1062,9,12,2044,1050,1665,217,237,238,0,,0,0.0,0.0,0.0,0.0,0.0
2024,10,20,7,2024-10-20,AA,6388,JFK,TPA,"New York, NY",New York,"Tampa, FL",Florida,2114,1469,-1,5,2113,1474,20,6,2133,1468,1352,170,190,196,0,,0,0.0,0.0,0.0,0.0,0.0
2024,7,27,6,2024-07-27,G4,6429,SEA,EWR,"Seattle, WA",Washington,"Newark, NJ",New Jersey,2183,1994,-17,-15,2166,1979,24,12,2190,1967,382,38,58,74,0,,0,0.0,0.0,0.0,0.0,0.0
2024,12,8,7,2024-12-08,UA,985,DCA,MCO,"Washington, DC",District of Columbia,"Orlando, FL",Florida,1204,2016,10,5,1214,2021,15,19,1229,2002,433,55,75,89,0,,0,0.0,0.0,0.0,0.0,0.0
2024,3,28,4,2024-03-28,AA,964,PDX,MCO,"Portland, OR",Oregon,"Orlando, FL",Florida,1270,617,1,10,1271,627,11,18,1282,609,1524,193,213,222,0,,0,0.0,0.0,0.0,0.0,0.0
2024,11,1,5,2024-11-01,AA,7017,DEN,IAD,"Denver, CO",Colorado,"Washington, DC",District of Columbia,1659,1807,-14,-10,1645,1797,29,9,1674,1788,2560,316,336,354,0,,0,0.0,0.0,0.0,0.0,0.0
2024,9,20,5,2024-09-20,MQ,3154,MDW,CLT,"Chicago, IL",Illinois,"Charlotte, NC",North Carolina,538,1766,11,10,549,1776,6,7,555,1769,2008,246,266,259,0,,0,0.0,0.0,0.0,0.0,0.0
2024,11,20,3,2024-11-20,OH,9077,SLC,LAX,"Salt Lake City, UT",Utah,"Los Angeles, CA",California,1843,2086,-10,-15,1833,2071,11,12,1844,2059,2532,309,329,332,0,,0,0.0,0.0,0.0,0.0,0.0
2024,11,15,5,2024-11-15,OO,8748,MSP,MCO,"Minneapolis, MN",Minnesota,"Orlando, FL",Florida,786,2130,-2,5,784,2135,10,6,794,2129,2777,349,369,365,0,,0,0.0,0.0,0.0,0.0,0.0
2024,6,5,3,2024-06-05,AS,8636,DCA,IAD,"Washington, DC",District of Columbia,"Washington, DC",District of Columbia,1467,1957,-4,5,1463,1962,23,9,1486,1953,1851,226,246,258,0,,0,0.0,0.0,0.0,0.0,0.0
2024,6,4,2,2024-06-04,OO,653,MIA,LGA,"Miami, FL",Florida,"New York, NY",New York,1986,661,1,-5,1987,656,22,13,2009,643,1616,193,213,228,0,,0,0.0,0.0,0.0,0.0,0.0
2024,5,18,6,2024-05-18,AS,5216,SLC,CLT,"Salt Lake City, UT",Utah,"Charlotte, NC",North Carolina,1390,762,-4,-10,1386,752,5,3,1391,749,2849,356,376,364,0,,0,0.0,0.0,0.0,0.0,0.0
2024,4,30,2,2024-04-30,AA,7783,TPA,DTW,"Tampa, FL",Florida,"Detroit, MI",Michigan,1161,1151,7,15,1168,1166,22,6,1190,1160,2344,298,318,326,0,,0,0.0,0.0,0.0,0.0,0.0
2024,3,5,2,2024-03-05,OH,887,IAD,TPA,"Washington, DC",District of Columbia,"Tampa, FL",Florida,1875,778,-15,-20,1860,758,16,18,1876,740,1299,169,189,203,0,,0,0.0,0.0,0.0,0.0,0.0
2024,4,16,2,2024-04-16,OH,8996,SLC,CLT,"Salt Lake City, UT",Utah,"Charlotte, NC",North Carolina,1528,1858,-6,0,1522,1858,25,3,1547,1855,2866,353,373,381,0,,0,0.0,0.0,0.0,0.0,0.0
2024,5,26,7,2024-05-26,UA,5007,LAS,BOS,"Las Vegas, NV",Nevada,"Boston, MA",Massachusetts,735,1683,-9,-5,726,1678,21,3,747,1675,854,96,116,120,0,,0,0.0,0.0,0.0,0.0,0.0
2024,5,16,4,2024-05-16,NK,7290,IAD,DEN,"Washington, DC",District of Columbia,"Denver, CO",Colorado,735,1851,2,0,737,1851,12,19,749,1832,1595,196,216,227,0,,0,0.0,0.0,0.0,0.0,0.0
2024,6,10,1,2024-06-10,9E,9244,BOS,CLT,"Boston, MA",Massachusetts,"Charlotte, NC",North Carolina,1468,838,-2,0,1466,838,24,4,1490,834,2709,335,355,363,0,,0,0.0,0.0,0.0,0.0,0.0
2024,4,9,2,2024-04-09,UA,914,DTW,MDW,"Detroit, MI",Michigan,"Chicago, IL",Illinois,1000,1167,-3,0,997,1167,7,5,1004,1162,208,28,48,40,0,,0,0.0,0.0,0.0,0.0,0.0
2024,12,3,2,2024-12-03,UA,9840,BOS,DCA,"Boston, MA",Massachusetts,"Washington, DC",District of Columbia,1628,1345,-20,-10,1608,1335,14,19,1622,1316,1382,177,197,210,0,,0,0.0,0.0,0.0,0.0,0.0
2024,11,2,6,2024-11-02,UA,8435,CLT,LGA,"Charlotte, NC",North Carolina,"New York, NY",New York,1730,683,-2,5,1728,688,20,4,1748,684,1833,228,248,252,0,,0,0.0,0.0,0.0,0.0,0.0
2024,5,20,1,2024-05-20,YX,2877,PDX,LAX,"Portland, OR",Oregon,"Los Angeles, CA",California,738,2338,-24,-20,714,2318,22,4,736,2314,1609,207,227,233,0,,0,0.0,0.0,0.0,0.0,0.0
2024,3,23,6,2024-03-23,NK,3866,DEN,CLT,"Denver, CO",Colorado,"Charlotte, NC",North Carolina,1328,1664,-20,-20,1308,1644,5,10,1313,1634,301,39,59,54,0,,0,0.0,0.0,0.0,0.0,0.0
2024,6,25,2,2024-06-25,WN,5058,SLC,PHX,"Salt Lake City, UT",Utah,"Phoenix, AZ",Arizona,551,1037,-3,0,548,1037,12,9,560,1028,308,35,55,56,0,,0,0.0,0.0,0.0,0.0,0.0
2024,7,16,2,2024-07-16,WN,3925,DTW,MSP,"Detroit, MI",Michigan,"Minneapolis, MN",Minnesota,607,1128,-3,0,604,1128,29,13,633,1115,813,108,128,150,0,,0,0.0,0.0,0.0,0.0,0.0
2024,4,21,7,2024-04-21,UA,1316,DEN,DCA,"Denver, CO",Colorado,"Washington, DC",District of Columbia,1880,704,-1,-10,1879,694,23,13,1902,681,2625,337,357,373,0,,0,0.0,0.0,0.0,0.0,0.0
2024,2,25,7,2024-02-25,9E,4570,SLC,IAD,"Salt Lake City, UT",Utah,"Washington, DC",District of Columbia,1556,1136,0,0,1556,1136,7,13,1563,1123,840,111,131,131,0,,0,0.0,0.0,0.0,0.0,0.0
2024,6,27,4,2024-06-27,OO,6872,DCA,MSP,"Washington, DC",District of Columbia,"Minneapolis, MN",Minnesota,521,981,-4,0,517,981,20,15,537,966,2880,350,370,385,0,,0,0.0,0.0,0.0,0.0,0.0
2024,7,4,4,2024-07-04,G4,9581,STL,HNL,"St. Louis, MO",Missouri,"Honolulu, HI",Hawaii,806,1716,-5,-5,801,1711,20,5,821,1706,1798,225,245,250,0,,0,0.0,0.0,0.0,0.0,0.0
2024,8,5,1,2024-08-05,DL,7817,SLC,MIA,"Salt Lake City, UT",Utah,"Miami, FL",Florida,510,1838,12,5,522,1843,20,3,542,1840,1987,248,268,271,0,,0,0.0,0.0,0.0,0.0,0.0
2024,11,11,1,2024-11-11,WN,8847,MIA,SLC,"Miami, FL",Florida,"Salt Lake City, UT",Utah,2162,2319,13,20,2175,2339,29,7,2204,2332,1204,158,178,194,0,,0,0.0,3.0,2.0,0.0,15.0
2024,8,4,7,2024-08-04,F9,962,DEN,MSP,"Denver, CO",Colorado,"Minneapolis, MN",Minnesota,1965,816,-5,0,1960,816,27,5,1987,811,2281,286,306,318,0,,0,0.0,0.0,0.0,0.0,0.0
2024,4,29,1,2024-04-29,AS,6317,SEA,BWI,"Seattle, WA",Washington,"Baltimore, MD",Maryland,1061,1088,1,5,1062,1093,16,5,1078,1088,2952,360,380,381,0,,0,0.0,0.0,0.0,0.0,0.0
2024,6,23,7,2024-06-23,OH,6038,STL,DFW,"St. Louis, MO",Missouri,"Dallas/Fort Worth, TX",Texas,697,750,-11,-10,686,740,13,14,699,726,1960,248,268,275,0,,0,0.0,0.0,0.0,0.0,0.0
2024,1,23,2,2024-01-23,NK,2455,DCA,MSP,"Washington, DC",District of Columbia,"Minneapolis, MN",Minnesota,2052,1997,2,5,2054,2002,22,6,2076,1996,567,77,97,105,0,,0,0.0,0.0,0.0,0.0,0.0
2024,7,31,3,2024-07-31,MQ,9257,CLT,SLC,"Charlotte, NC",North Carolina,"Salt Lake City, UT",Utah,1567,1412,-7,0,1560,1412,27,6,1587,1406,1744,222,242,255,0,,0,0.0,0.0,0.0,0.0,0.0
2024,8,22,4,2024-08-22,NK,2495,SFO,PHL,"San Francisco, CA",California,"Philadelphia, PA",Pennsylvania,1708,1230,-2,0,1706,1230,28,4,1734,1226,462,58,78,90,0,,0,0.0,0.0,0.0,0.0,0.0
2024,1,13,6,2024-01-13,DL,8767,JFK,LAX,"New York, NY",New York,"Los Angeles, CA",California,888,2072,5,10,893,2082,15,7,908,2075,1781,214,234,236,0,,0,0.0,0.0,0.0,0.0,0.0
2024,4,10,3,2024-04-10,WN,9630,PHX,CLT,"Phoenix, AZ",Arizona,"Charlotte, NC",North Carolina,1050,1021,-4,-10,1046,1011,24,14,1070,997,2591,327,347,365,0,,0,0.0,0.0,0.0,0.0,0.0
2024,1,24,3,2024-01-24,9E,624,LAX,PHX,"Los Angeles, CA",California,"Phoenix, AZ",Arizona,2030,1245,3,-5,2033,1240,15,11,2048,1229,888,113,133,139,0,,0,0.0,0.0,0.0,0.0,0.0
2024,12,29,7,2024-12-29,9E,661,ORD,LAX,"Chicago, IL",Illinois,"Los Angeles, CA",California,1965,806,-12,-15,1953,791,24,14,1977,777,975,120,140,158,0,,0,0.0,0.0,0.0,0.0,0.0
2024,1,11,4,2024-01-11,AS,8267,MDW,EWR,"Chicago, IL",Illinois,"Newark, NJ",New Jersey,995,1374,-5,5,990,1379,16,15,1006,1364,1028,127,147,158,0,,0,0.0,0.0,0.0,0.0,0.0
2024,9,29,7,2024-09-29,UA,8213,EWR,PHL,"Newark, NJ",New Jersey,"Philadelphia, PA",Pennsylvania,1004,1433,5,10,1009,1443,22,15,1031,1428,2411,298,318,335,1,,0,0.0,0.0,0.0,0.0,0.0
2024,10,7,1,2024-10-07,G4,7516,DCA,DTW,"Washington, DC",District of Columbia,"Detroit, MI",Michigan,636,2325,-9,-5,627,2320,6,3,633,2317,2121,264,284,273,0,,0,0.0,0.0,0.0,0.0,0.0
2024,4,3,3,2024-04-03,MQ,4764,SFO,TPA,"San Francisco, CA",California,"Tampa, FL",Florida,1488,2293,-15,-5,1473,2288,8,14,1481,2274,574,66,86,88,0,,0,0.0,0.0,0.0,0.0,0.0
2024,7,19,5,2024-07-19,WN,1305,DFW,PHL,"Dallas/Fort Worth, TX",Texas,"Philadelphia, PA",Pennsylvania,1802,2100,11,5,1813,2105,8,4,1821,2101,1723,210,230,222,0,,0,0.0,0.0,0.0,0.0,0.0
2024,1,21,7,2024-01-21,9E,2338,DCA,SEA,"Washington, DC",District of Columbia,"Seattle, WA",Washington,663,1187,-9,-15,654,1172,25,6,679,1166,2292,284,304,315,0,,0,0.0,0.0,0.0,0.0,0.0
2024,12,5,4,2024-12-05,MQ,1260,MIA,PHL,"Miami, FL",Florida,"Philadelphia, PA",Pennsylvania,2066,1163,-14,-10,2052,1153,18,7,2070,1146,827,100,120,125,0,,0,0.0,0.0,0.0,0.0,0.0
2024,7,29,1,2024-07-29,DL,5339,TPA,MDW,"Tampa, FL",Florida,"Chicago, IL",Illinois,1351,825,-2,-5,1349,820,17,12,1366,808,1465,173,193,202,0,,0,0.0,0.0,0.0,0.0,0.0
2024,5,19,7,2024-05-19,AS,7074,SLC,PDX,"Salt Lake City, UT",Utah,"Portland, OR",Oregon,1546,2229,-4,0,1542,2229,13,3,1555,2226,2707,346,366,362,0,,0,0.0,0.0,0.0,0.0,0.0
2024,10,19,6,2024-10-19,AA,171,DCA,BWI,"Washington, DC",District of Columbia,"Baltimore, MD",Maryland,1210,1403,2,0,1212,1403,19,12,1231,1391,2266,273,293,304,0,,0,0.0,0.0,0.0,0.0,0.0
2024,10,24,4,2024-10-24,AS,854,DEN,IAH,"Denver, CO",Colorado,"Houston, TX",Texas,1006,1289,-3,-10,1003,1279,29,17,1032,1262,1531,188,208,234,0,,0,0.0,0.0,0.0,0.0,0.0
2024,4,10,3,2024-04-10,MQ,7398,EWR,ATL,"Newark, NJ",New Jersey,"Atlanta, GA",Georgia,1185,2010,-4,0,1181,2010,27,10,1208,2000,1956,248,268,285,0,,0,0.0,0.0,0.0,0.0,0.0
2024,10,30,3,2024-10-30,YX,6700,STL,MSP,"St. Louis, MO",Missouri,"Minneapolis, MN",Minnesota,2033,705,6,15,2039,720,26,19,2065,701,1946,244,264,289,0,,0,0.0,0.0,0.0,0.0,0.0
2024,12,24,2,2024-12-24,9E,9196,SAN,LAS,"San Diego, CA",California,"Las Vegas, NV",Nevada,2093,1699,-12,-20,2081,1679,14,14,2095,1665,246,22,42,50,0,,0,0.0,0.0,0.0,0.0,0.0
2024,1,28,7,2024-01-28,AA,8252,STL,ORD,"St. Louis, MO",Missouri,"Chicago, IL",Illinois,1207,1115,8,5,1215,1120,9,7,1224,1113,1956,247,267,263,0,,0,0.0,0.0,0.0,0.0,0.0
2024,2,10,6,2024-02-10,OH,8343,IAH,EWR,"Houston, TX",Texas,"Newark, NJ",New Jersey,2123,1547,-10,0,2113,1547,8,8,2121,1539,2730,332,352,348,0,,0,0.0,0.0,0.0,0.0,0.0
2024,12,20,5,2024-12-20,F9,2721,IAH,SEA,"Houston, TX",Texas,"Seattle, WA",Washington,1967,786,20,15,1987,801,22,18,2009,783,476,50,70,90,0,,0,0.0,0.0,0.0,0.0,0.0
2024,10,29,2,2024-10-29,B6,3290,DCA,IAH,"Washington, DC",District of Columbia,"Houston, TX",Texas,641,1131,-4,0,637,1131,8,9,645,1122,1600,208,228,225,0,,0,0.0,0.0,0.0,0.0,0.0
2024,5,25,6,2024-05-25,AS,4048,EWR,ATL,"Newark, NJ",New Jersey,"Atlanta, GA",Georgia,780,874,5,0,785,874,20,11,805,863,2769,354,374,385,0,,0,0.0,0.0,0.0,0.0,0.0
2024,9,12,4,2024-09-12,DL,1387,DCA,TPA,"Washington, DC",District of Columbia,"Tampa, FL",Florida,1466,2271,14,5,1480,2276,15,19,1495,2257,1363,177,197,211,0,,0,0.0,0.0,0.0,0.0,0.0
2024,8,14,3,2024-08-14,DL,5458,CLT,DFW,"Charlotte, NC",North Carolina,"Dallas/Fort Worth, TX",Texas,1730,1138,-9,-10,1721,1128,11,12,1732,1116,834,101,121,124,0,,0,0.0,0.0,0.0,0.0,0.0
2024,8,23,5,2024-08-23,YX,7618,EWR,IAH,"Newark, NJ",New Jersey,"Houston, TX",Texas,2207,1247,-6,0,2201,1247,5,19,2206,1228,778,103,123,127,0,,0,0.0,0.0,0.0,0.0,0.0
2024,12,26,4,2024-12-26,G4,7136,EWR,TPA,"Newark, NJ",New Jersey,"Tampa, FL",Florida,801,617,6,0,807,617,7,16,814,601,335,33,53,56,0,,0,0.0,0.0,0.0,0.0,0.0
2024,1,13,6,2024-01-13,UA,4880,IAD,IAH,"Washington, DC",District of Columbia,"Houston, TX",Texas,896,884,-3,-5,893,879,20,16,913,863,2572,326,346,362,0,,0,0.0,0.0,0.0,0.0,0.0
2024,7,28,7,2024-07-28,AS,1872,DTW,MIA,"Detroit, MI",Michigan,"Miami, FL",Florida,817,1925,-12,-15,805,1910,8,17,813,1893,1835,235,255,260,0,,0,0.0,0.0,0.0,0.0,0.0
2024,8,16,5,2024-08-16,9E,4002,PHX,HNL,"Phoenix, AZ",Arizona,"Honolulu, HI",Hawaii,1407,2122,-5,-10,1402,2112,27,9,1429,2103,1463,175,195,211,0,,0,0.0,0.0,0.0,0.0,0.0
2024,4,9,2,2024-04-09,B6,5826,ORD,SLC,"Chicago, IL",Illinois,"Salt Lake City, UT",Utah,1379,1531,-8,-10,1371,1521,7,18,1378,1503,234,35,55,60,0,,0,0.0,0.0,0.0,0.0,0.0
2024,1,31,3,2024-01-31,OH,6300,DTW,LAX,"Detroit, MI",Michigan,"Los Angeles, CA",California,1357,1613,12,5,1369,1618,24,11,1393,1607,2206,281,301,316,0,,0,0.0,0.0,0.0,0.0,0.0
2024,1,16,2,2024-01-16,YX,9241,SEA,IAH,"Seattle, WA",Washington,"Houston, TX",Texas,1571,1504,22,15,1593,1519,5,19,1598,1500,1867,226,246,250,0,,0,0.0,0.0,0.0,0.0,0.0
2024,5,16,4,2024-05-16,WN,3238,SAN,TPA,"San Diego, CA",California,"Tampa, FL",Florida,1172,1249,-12,-10,1160,1239,5,14,1165,1225,1111,133,153,152,0,,0,0.0,0.0,0.0,0.0,0.0
2024,11,24,7,2024-11-24,9E,7313,DCA,PHL,"Washington, DC",District of Columbia,"Philadelphia, PA",Pennsylvania,1474,1451,-25,-15,1449,1436,14,4,1463,1432,2013,252,272,270,0,,0,0.0,0.0,0.0,0.0,0.0
2024,6,14,5,2024-06-14,DL,2516,PHX,CLT,"Phoenix, AZ",Arizona,"Charlotte, NC",North Carolina,1176,856,111,120,1287,976,16,6,1303,970,773,105,125,127,0,,0,18.0,25.0,10.0,2.0,65.0
2024,11,5,2,2024-11-05,F9,9717,LAX,JFK,"Los Angeles, CA",California,"New York, NY",New York,1913,1842,2,5,1915,1847,7,10,1922,1837,2371,292,312,309,0,,0,0.0,0.0,0.0,0.0,0.0
2024,4,9,2,2024-04-09,9E,7151,LAX,PHX,"Los Angeles, CA",California,"Phoenix, AZ",Arizona,878,1243,12,10,890,1253,27,13,917,1240,2947,365,385,405,0,,0,0.0,0.0,0.0,0.0,0.0
2024,4,18,4,2024-04-18,NK,1684,MDW,LGA,"Chicago, IL",Illinois,"New York, NY",New York,716,956,-20,-15,696,941,17,13,713,928,891,118,138,148,0,,0,0.0,0.0,0.0,0.0,0.0
2024,12,8,7,2024-12-08,OO,1146,MCO,BWI,"Orlando, FL",Florida,"Baltimore, MD",Maryland,2152,855,18,10,2170,865,10,14,2180,851,2287,279,299,303,0,,0,0.0,0.0,0.0,0.0,0.0
2024,6,21,5,2024-06-21,DL,7084,PDX,ORD,"Portland, OR",Oregon,"Chicago, IL",Illinois,1348,1207,18,10,1366,1217,25,7,1391,1210,2703,332,352,364,0,,0,0.0,0.0,0.0,0.0,0.0
2024,8,24,6,2024-08-24,AS,2265,PDX,LGA,"Portland, OR",Oregon,"New York, NY",New York,1774,1897,-19,-10,1755,1887,28,17,1783,1870,2609,332,352,377,0,,0,0.0,0.0,0.0,0.0,0.0
2024,6,10,1,2024-06-10,OH,5819,SLC,IAD,"Salt Lake City, UT",Utah,"Washington, DC",District of Columbia,1367,933,-11,-10,1356,923,28,19,1384,904,1449,183,203,230,0,,0,0.0,0.0,0.0,0.0,0.0
2024,8,3,6,2024-08-03,F9,7322,STL,BOS,"St. Louis, MO",Missouri,"Boston, MA",Massachusetts,933,1991,-16,-10,917,1981,24,11,941,1970,2555,323,343,358,0,,0,0.0,0.0,0.0,0.0,0.0
2024,9,20,5,2024-09-20,NK,1276,DFW,MCO,"Dallas/Fort Worth, TX",Texas,"Orlando, FL",Florida,1255,614,-20,-10,1235,604,14,6,1249,598,1440,173,193,193,0,,0,0.0,0.0,0.0,0.0,0.0
2024,9,19,4,2024-09-19,HA,6511,DCA,STL,"Washington, DC",District of Columbia,"St. Louis, MO",Missouri,1441,778,22,20,1463,798,10,16,1473,782,2541,312,332,338,0,,0,7.0,0.0,3.0,0.0,10.0
2024,10,18,5,2024-10-18,AA,8174,BWI,MDW,"Baltimore, MD",Maryland,"Chicago, IL",Illinois,2282,2068,-4,-5,2278,2063,5,11,2283,2052,2741,333,353,349,0,,0,0.0,0.0,0.0,0.0,0.0
2024,9,30,1,2024-09-30,B6,9323,LAX,PDX,"Los Angeles, CA",California,"Portland, OR",Oregon,2108,2026,4,5,2112,2031,19,11,2131,2020,2543,313,333,343,0,,0,0.0,0.0,0.0,0.0,0.0
2024,1,3,3,2024-01-03,DL,3388,LAS,MCO,"Las Vegas, NV",Nevada,"Orlando, FL",Florida,1807,687,2,10,1809,697,18,19,1827,678,272,32,52,69,0,,0,0.0,0.0,0.0,0.0,0.0
2024,1,28,7,2024-01-28,AS,1415,SEA,ATL,"Seattle, WA",Washington,"Atlanta, GA",Georgia,2006,693,-1,-5,2005,688,16,14,2021,674,2380,305,325,335,0,,0,0.0,0.0,0.0,0.0,0.0
2024,11,21,4,2024-11-21,NK,992,LAS,BOS,"Las Vegas, NV",Nevada,"Boston, MA",Massachusetts,1206,1444,-1,5,1205,1449,14,9,1219,1440,684,91,111,114,0,,0,0.0,0.0,0.0,0.0,0.0
2024,5,28,2,2024-05-28,OH,5269,CLT,SEA,"Charlotte, NC",North Carolina,"Seattle, WA",Washington,1790,2018,-7,-15,1783,2003,13,14,1796,1989,688,79,99,106,0,,0,0.0,0.0,0.0,0.0,0.0
2024,1,28,7,2024-01-28,OH,8398,IAH,LAS,"Houston, TX",Texas,"Las Vegas, NV",Nevada,1098,627,3,-5,1101,622,25,14,1126,608,2461,299,319,338,0,,0,0.0,0.0,0.0,0.0,0.0
2024,11,5,2,2024-11-05,NK,3180,DTW,LGA,"Detroit, MI",Michigan,"New York, NY",New York,1769,1296,22,20,1791,1316,19,8,1810,1308,622,71,91,98,0,,0,1.0,2.0,1.0,0.0,16.0
2024,3,5,2,2024-03-05,UA,9036,LAX,PDX,"Los Angeles, CA",California,"Portland, OR",Oregon,1681,674,-13,-10,1668,664,18,18,1686,646,2607,330,350,366,0,,0,0.0,0.0,0.0,0.0,0.0
2024,12,21,6,2024-12-21,NK,6566,BOS,MSP,"Boston, MA",Massachusetts,"Minneapolis, MN",Minnesota,1880,653,-8,-5,1872,648,28,4,1900,644,2627,336,356,368,1,,0,0.0,0.0,0.0,0.0,0.0
2024,1,21,7,2024-01-21,HA,8913,PDX,CLT,"Portland, OR",Oregon,"Charlotte, NC",North Carolina,2071,920,0,5,2071,925,14,12,2085,913,2559,310,330,336,0,,0,0.0,0.0,0.0,0.0,0.0
2024,9,8,7,2024-09-08,B6,5190,MCO,DEN,"Orlando, FL",Florida,"Denver, CO",Colorado,735,2182,3,5,738,2187,5,6,743,2181,2582,320,340,331,0,,0,0.0,0.0,0.0,0.0,0.0
2024,8,22,4,2024-08-22,F9,4340,DCA,PHL,"Washington, DC",District of Columbia,"Philadelphia, PA",Pennsylvania,2283,1359,3,0,2286,1359,24,7,2310,1352,580,72,92,103,0,,0,0.0,0.0,0.0,0.0,0.0
2024,8,14,3,2024-08-14,HA,9112,MIA,STL,"Miami, FL",Florida,"St. Louis, MO",Missouri,1983,1857,4,10,1987,1867,6,7,1993,1860,1724,219,239,232,0,,0,0.0,0.0,0.0,0.0,0.0
2024,1,13,6,2024-01-13,YX,511,PDX,ATL,"Portland, OR",Oregon,"Atlanta, GA",Georgia,599,1229,-15,-20,584,1209,6,9,590,1200,1186,150,170,165,0,,0,0.0,0.0,0.0,0.0,0.0
2024,11,8,5,2024-11-08,F9,8405,EWR,BOS,"Newark, NJ",New Jersey,"Boston, MA",Massachusetts,1238,1853,8,5,1246,1858,6,4,1252,1854,346,38,58,48,0,,0,0.0,0.0,0.0,0.0,0.0
2024,2,18,7,2024-02-18,NK,2546,JFK,PHL,"New York, NY",New York,"Philadelphia, PA",Pennsylvania,618,931,9,10,627,941,6,9,633,932,2521,310,330,325,0,,0,0.0,0.0,0.0,0.0,0.0
2024,4,27,6,2024-04-27,AS,3446,DTW,PHL,"Detroit, MI",Michigan,"Philadelphia, PA",Pennsylvania,1877,2317,-14,-20,1863,2297,12,16,1875,2281,1041,137,157,165,0,,0,0.0,0.0,0.0,0.0,0.0
2024,2,23,5,2024-02-23,DL,185,IAD,SAN,"Washington, DC",District of Columbia,"San Diego, CA",California,1207,2095,5,0,1212,2095,26,17,1238,2078,585,70,90,113,0,,0,0.0,0.0,0.0,0.0,0.0
2024,5,17,5,2024-05-17,AS,7849,MCO,CLT,"Orlando, FL",Florida,"Charlotte, NC",North Carolina,587,916,4,-5,591,911,29,17,620,894,265,27,47,73,0,,0,0.0,0.0,0.0,0.0,0.0
2024,2,22,4,2024-02-22,MQ,4242,CLT,SFO,"Charlotte, NC",North Carolina,"San Francisco, CA",California,535,700,-9,-15,526,685,22,16,548,669,1912,238,258,276,0,,0,0.0,0.0,0.0,0.0,0.0
2024,2,13,2,2024-02-13,YX,7187,LAX,HNL,"Los Angeles, CA",California,"Honolulu, HI",Hawaii,813,847,0,-5,813,842,17,5,830,837,2742,340,360,362,0,,0,0.0,0.0,0.0,0.0,0.0
2024,10,29,2,2024-10-29,HA,7468,HNL,TPA,"Honolulu, HI",Hawaii,"Tampa, FL",Florida,2063,2103,-1,0,2062,2103,21,5,2083,2098,2466,304,324,330,0,,0,0.0,0.0,0.0,0.0,0.0
2024,2,22,4,2024-02-22,OO,9864,MIA,TPA,"Miami, FL",Florida,"Tampa, FL",Florida,1050,1460,22,15,1072,1475,12,14,1084,1461,2327,280,300,306,0,,0,0.0,0.0,0.0,0.0,0.0
2024,3,14,4,2024-03-14,G4,5934,SLC,DTW,"Salt Lake City, UT",Utah,"Detroit, MI",Michigan,1845,1469,-5,0,1840,1469,14,4,1854,1465,2535,317,337,335,0,,0,0.0,0.0,0.0,0.0,0.0
2024,2,15,4,2024-02-15,HA,903,BOS,MDW,"Boston, MA",Massachusetts,"Chicago, IL",Illinois,926,2248,16,10,942,2258,18,6,960,2252,621,83,103,107,0,,0,0.0,0.0,0.0,0.0,0.0
2024,1,13,6,2024-01-13,DL,6819,ORD,PHL,"Chicago, IL",Illinois,"Philadelphia, PA",Pennsylvania,1016,820,-17,-15,999,805,23,10,1022,795,699,80,100,113,0,,0,0.0,0.0,0.0,0.0,0.0
2024,6,13,4,2024-06-13,AA,6185,TPA,DEN,"Tampa, FL",Florida,"Denver, CO",Colorado,1152,1962,-13,-10,1139,1952,23,11,1162,1941,481,51,71,85,0,,0,0.0,0.0,0.0,0.0,0.0
2024,4,11,4,2024-04-11,OO,9361,PHL,LAX,"Philadelphia, PA",Pennsylvania,"Los Angeles, CA",California,2263,747,17,20,2280,767,28,5,2308,762,2089,270,290,303,0,,0,7.0,5.0,3.0,0.0,5.0
2024,10,6,7,2024-10-06,MQ,4282,PDX,JFK,"Portland, OR",Oregon,"New York, NY",New York,508,1612,11,10,519,1622,9,5,528,1617,1462,189,209,203,0,,0,0.0,0.0,0.0,0.0,0.0
2024,9,14,6,2024-09-14,B6,9700,BWI,DTW,"Baltimore, MD",Maryland,"Detroit, MI",Michigan,1882,1919,-3,-10,1879,1909,28,13,1907,1896,1935,245,265,286,0,,0,0.0,0.0,0.0,0.0,0.0
2024,12,2,1,2024-12-02,OO,364,IAD,PHL,"Washington, DC",District of Columbia,"Philadelphia, PA",Pennsylvania,2001,2332,-9,0,1992,2332,22,8,2014,2324,2731,339,359,369,0,,0,0.0,0.0,0.0,0.0,0.0
2024,12,21,6,2024-12-21,AS,3193,IAD,LAS,"Washington, DC",District of Columbia,"Las Vegas, NV",Nevada,556,2030,-13,-5,543,2025,14,3,557,2022,2981,377,397,394,0,,0,0.0,0.0,0.0,0.0,0.0
2024,5,17,5,2024-05-17,UA,4898,SFO,CLT,"San Francisco, CA",California,"Charlotte, NC",North Carolina,782,1180,0,0,782,1180,20,11,802,1169,271,30,50,61,0,,0,0.0,0.0,0.0,0.0,0.0
2024,6,11,2,2024-06-11,F9,9765,LAX,CLT,"Los Angeles, CA",California,"Charlotte, NC",North Carolina,1968,1077,12,10,1980,1087,29,14,2009,1073,861,108,128,151,0,,0,0.0,0.0,0.0,0.0,0.0
2024,4,20,6,2024-04-20,NK,8243,TPA,STL,"Tampa, FL",Florida,"St. Louis, MO",Missouri,960,1647,12,5,972,1652,22,15,994,1637,2806,346,366,383,0,,0,0.0,0.0,0.0,0.0,0.0
2024,4,11,4,2024-04-11,DL,425,IAD,STL,"Washington, DC",District of Columbia,"St. Louis, MO",Missouri,2013,1482,-10,-10,2003,1472,13,16,2016,1456,456,54,74,83,0,,0,0.0,0.0,0.0,0.0,0.0
2024,1,17,3,2024-01-17,YX,1306,PHX,SFO,"Phoenix, AZ",Arizona,"San Francisco, CA",California,1882,1809,-2,-5,1880,1804,14,10,1894,1794,1810,225,245,249,0,,0,0.0,0.0,0.0,0.0,0.0
2024,9,24,2,2024-09-24,NK,9796,SAN,JFK,"San Diego, CA",California,"New York, NY",New York,2213,769,-1,-10,2212,759,26,17,2238,742,1517,193,213,236,0,,0,0.0,0.0,0.0,0.0,0.0
2024,6,30,7,2024-06-30,HA,1540,SLC,SEA,"Salt Lake City, UT",Utah,"Seattle, WA",Washington,1093,2167,-2,5,1091,2172,16,12,1107,2160,1918,235,255,263,0,,0,0.0,0.0,0.0,0.0,0.0
2024,1,24,3,2024-01-24,HA,5284,STL,IAH,"St. Louis, MO",Missouri,"Houston, TX",Texas,1429,1037,-7,0,1422,1037,9,8,1431,1029,2893,360,380,377,0,,0,0.0,0.0,0.0,0.0,0.0
2024,1,29,1,2024-01-29,AA,9247,BOS,IAD,"Boston, MA",Massachusetts,"Washington, DC",District of Columbia,2120,1616,19,20,2139,1636,19,18,2158,1618,2843,364,384,401,0,,0,3.0,5.0,3.0,0.0,9.0
2024,6,19,3,2024-06-19,G4,8846,STL,JFK,"St. Louis, MO",Missouri,"New York, NY",New York,564,900,1,10,565,910,27,12,592,898,1479,180,200,219,0,,0,0.0,0.0,0.0,0.0,0.0
2024,8,15,4,2024-08-15,MQ,5236,DEN,PHX,"Denver, CO",Colorado,"Phoenix, AZ",Arizona,1952,1287,-3,-10,1949,1277,11,15,1960,1262,2053,255,275,281,0,,0,0.0,0.0,0.0,0.0,0.0
2024,7,6,6,2024-07-06,NK,8240,CLT,LAS,"Charlotte, NC",North Carolina,"Las Vegas, NV",Nevada,1354,1987,5,5,1359,1992,24,10,1383,1982,1497,186,206,220,0,,0,0.0,0.0,0.0,0.0,0.0
2024,12,11,3,2024-12-11,AS,5919,PDX,BOS,"Portland, OR",Oregon,"Boston, MA",Massachusetts,1301,1587,-6,0,1295,1587,11,6,1306,1581,1049,126,146,143,0,,0,0.0,0.0,0.0,0.0,0.0
2024,8,17,6,2024-08-17,MQ,8169,TPA,DFW,"Tampa, FL",Florida,"Dallas/Fort Worth, TX",Texas,1980,1800,-4,-10,1976,1790,7,10,1983,1780,223,31,51,48,0,,0,0.0,0.0,0.0,0.0,0.0
2024,11,16,6,2024-11-16,DL,2136,LGA,JFK,"New York, NY",New York,"New York, NY",New York,635,743,-14,-5,621,738,7,10,628,728,695,95,115,112,0,,0,0.0,0.0,0.0,0.0,0.0
2024,12,5,4,2024-12-05,UA,9578,MCO,PHX,"Orlando, FL",Florida,"Phoenix, AZ",Arizona,1261,1122,12,20,1273,1142,11,13,1284,1129,1085,140,160,164,0,,0,6.0,2.0,0.0,0.0,12.0
2024,4,28,7,2024-04-28,AA,9489,PHL,TPA,"Philadelphia, PA",Pennsylvania,"Tampa, FL",Florida,1509,2104,-4,0,1505,2104,5,3,1510,2101,1470,177,197,185,0,,0,0.0,0.0,0.0,0.0,0.0
2024,6,4,2,2024-06-04,HA,5660,SAN,HNL,"San Diego, CA",California,"Honolulu, HI",Hawaii,2129,2115,-4,5,2125,2120,28,13,2153,2107,1146,136,156,177,0,,0,0.0,0.0,0.0,0.0,0.0
2024,9,28,6,2024-09-28,9E,3729,CLT,PHX,"Charlotte, NC",North Carolina,"Phoenix, AZ",Arizona,1571,2109,-9,0,1562,2109,22,7,1584,2102,595,81,101,110,0,,0,0.0,0.0,0.0,0.0,0.0
2024,6,23,7,2024-06-23,MQ,9063,DEN,PDX,"Denver, CO",Colorado,"Portland, OR",Oregon,1111,1258,-8,-5,1103,1253,5,17,1108,1236,1057,130,150,152,0,,0,0.0,0.0,0.0,0.0,0.0
2024,4,13,6,2024-04-13,B6,5414,SLC,BWI,"Salt Lake City, UT",Utah,"Baltimore, MD",Maryland,1349,1084,10,5,1359,1089,10,11,1369,1078,665,77,97,98,0,,0,0.0,0.0,0.0,0.0,0.0
2024,4,1,1,2024-04-01,G4,2556,HNL,ATL,"Honolulu, HI",Hawaii,"Atlanta, GA",Georgia,1717,1421,2,10,1719,1431,24,13,1743,1418,1769,221,241,258,0,,0,0.0,0.0,0.0,0.0,0.0
2024,7,4,4,2024-07-04,MQ,8762,DEN,SLC,"Denver, CO",Colorado,"Salt Lake City, UT",Utah,616,2060,-20,-15,596,2045,11,13,607,2032,414,53,73,77,0,,0,0.0,0.0,0.0,0.0,0.0
2024,10,9,3,2024-10-09,AS,1470,PHX,JFK,"Phoenix, AZ",Arizona,"New York, NY",New York,1278,794,-2,-10,1276,784,16,17,1292,767,2180,267,287,300,0,,0,0.0,0.0,0.0,0.0,0.0
2024,6,29,6,2024-06-29,B6,7729,SAN,MIA,"San Diego, CA",California,"Miami, FL",Florida,1319,1065,2,0,1321,1065,7,14,1328,1051,1030,118,138,139,0,,0,0.0,0.0,0.0,0.0,0.0
2024,6,18,2,2024-06-18,YX,8963,IAH,PDX,"Houston, TX",Texas,"Portland, OR",Oregon,1522,1577,-12,-5,1510,1572,6,16,1516,1556,2064,251,271,273,0,,0,0.0,0.0,0.0,0.0,0.0
2024,7,5,5,2024-07-05,UA,1274,MSP,MDW,"Minneapolis, MN",Minnesota,"Chicago, IL",Illinois,1687,1699,11,5,1698,1704,19,8,1717,1696,595,78,98,105,0,,0,0.0,0.0,0.0,0.0,0.0
2024,6,23,7,2024-06-23,B6,210,IAH,ORD,"Houston, TX",Texas,"Chicago, IL",Illinois,978,1783,-17,-15,961,1768,24,18,985,1750,2519,323,343,365,0,,0,0.0,0.0,0.0,0.0,0.0
2024,8,9,5,2024-08-09,F9,3659,PDX,MDW,"Portland, OR",Oregon,"Chicago, IL",Illinois,1810,1089,-3,5,1807,1094,8,15,1815,1079,2138,274,294,297,0,,0,0.0,0.0,0.0,0.0,0.0
2024,8,20,2,2024-08-20,YX,6792,MSP,MCO,"Minneapolis, MN",Minnesota,"Orlando, FL",Florida,1035,699,-10,0,1025,699,24,7,1049,692,1043,136,156,167,0,,0,0.0,0.0,0.0,0.0,0.0
2024,6,10,1,2024-06-10,DL,9318,PHX,BWI,"Phoenix, AZ",Arizona,"Baltimore, MD",Maryland,993,715,-20,-10,973,705,23,11,996,694,1864,231,251,265,0,,0,0.0,0.0,0.0,0.0,0.0
2024,5,13,1,2024-05-13,B6,3333,DTW,PHX,"Detroit, MI",Michigan,"Phoenix, AZ",Arizona,904,979,1,-5,905,974,27,14,932,960,2266,287,307,328,0,,0,0.0,0.0,0.0,0.0,0.0
2024,8,11,7,2024-08-11,AS,1572,STL,MDW,"St. Louis, MO",Missouri,"Chicago, IL",Illinois,595,2218,-8,-10,587,2208,25,11,612,2197,2043,248,268,284,0,,0,0.0,0.0,0.0,0.0,0.0
2024,6,1,6,2024-06-01,9E,4972,ATL,IAH,"Atlanta, GA",Georgia,"Houston, TX",Texas,2020,1423,-16,-10,2004,1413,15,19,2019,1394,1861,232,252,266,0,,0,0.0,0.0,0.0,0.0,0.0
2024,2,2,5,2024-02-02,F9,4853,HNL,DEN,"Honolulu, HI",Hawaii,"Denver, CO",Colorado,753,662,13,5,766,667,24,16,790,651,1452,182,202,222,1,,0,0.0,0.0,0.0,0.0,0.0
2024,2,24,6,2024-02-24,F9,1933,LGA,DFW,"New York, NY",New York,"Dallas/Fort Worth, TX",Texas,913,731,-6,-5,907,726,9,15,916,711,1348,169,189,193,0,,0,0.0,0.0,0.0,0.0,0.0
2024,1,7,7,2024-01-07,HA,6028,JFK,ORD,"New York, NY",New York,"Chicago, IL",Illinois,2156,1871,3,5,2159,1876,27,7,2186,1869,2480,303,323,337,0,,0,0.0,0.0,0.0,0.0,0.0
2024,8,31,6,2024-08-31,B6,8745,DTW,CLT,"Detroit, MI",Michigan,"Charlotte, NC",North Carolina,1083,994,-5,0,1078,994,24,12,1102,982,2121,262,282,298,0,,0,0.0,0.0,0.0,0.0,0.0
2024,11,8,5,2024-11-08,G4,6916,DTW,CLT,"Detroit, MI",Michigan,"Charlotte, NC",North Carolina,1894,1242,-9,-15,1885,1227,16,11,1901,1216,404,51,71,78,0,,0,0.0,0.0,0.0,0.0,0.0
2024,5,5,7,2024-05-05,WN,840,PDX,DTW,"Portland, OR",Oregon,"Detroit, MI",Michigan,1075,2034,-4,0,1071,2034,20,15,1091,2019,459,66,86,101,0,,0,0.0,0.0,0.0,0.0,0.0
2024,1,12,5,2024-01-12,YX,7356,SEA,PDX,"Seattle, WA",Washington,"Portland, OR",Oregon,742,1575,10,5,752,1580,14,9,766,1571,2735,336,356,359,0,,0,0.0,0.0,0.0,0.0,0.0
2024,1,16,2,2024-01-16,G4,2480,SEA,DTW,"Seattle, WA",Washington,"Detroit, MI",Michigan,1138,2051,-2,-10,1136,2041,25,16,1161,2025,1396,176,196,217,0,,0,0.0,0.0,0.0,0.0,0.0
2024,7,26,5,2024-07-26,OO,9735,PHX,TPA,"Phoenix, AZ",Arizona,"Tampa, FL",Florida,1896,1513,-6,0,1890,1513,26,6,1916,1507,1384,167,187,199,0,,0,0.0,0.0,0.0,0.0,0.0
2024,2,12,1,2024-02-12,NK,3780,LAS,PDX,"Las Vegas, NV",Nevada,"Portland, OR",Oregon,538,1269,-3,-10,535,1259,10,10,545,1249,1496,190,210,210,0,,0,0.0,0.0,0.0,0.0,0.0
2024,5,14,2,2024-05-14,AS,2501,IAH,ATL,"Houston, TX",Texas,"Atlanta, GA",Georgia,852,1327,-19,-15,833,1312,16,7,849,1305,1920,244,264,267,0,,0,0.0,0.0,0.0,0.0,0.0
2024,8,15,4,2024-08-15,WN,7277,DFW,EWR,"Dallas/Fort Worth, TX",Texas,"Newark, NJ",New Jersey,925,1949,-11,-5,914,1944,11,15,925,1929,2507,319,339,345,0,,0,0.0,0.0,0.0,0.0,0.0
2024,4,20,6,2024-04-20,DL,2106,DTW,PHL,"Detroit, MI",Michigan,"Philadelphia, PA",Pennsylvania,1600,1145,-8,-5,1592,1140,14,17,1606,1123,975,125,145,156,0,,0,0.0,0.0,0.0,0.0,0.0
2024,11,2,6,2024-11-02,F9,1509,PHL,BWI,"Philadelphia, PA",Pennsylvania,"Baltimore, MD",Maryland,1481,974,3,5,1484,979,20,9,1504,970,1339,167,187,196,1,,0,0.0,0.0,0.0,0.0,0.0
2024,6,8,6,2024-06-08,AS,1862,IAH,SAN,"Houston, TX",Texas,"San Diego, CA",California,1009,1443,9,0,1018,1443,7,19,1025,1424,1388,176,196,202,0,,0,0.0,0.0,0.0,0.0,0.0
2024,11,26,2,2024-11-26,YX,1009,PDX,CLT,"Portland, OR",Oregon,"Charlotte, NC",North Carolina,2040,897,-22,-15,2018,882,20,8,2038,874,1847,232,252,260,0,,0,0.0,0.0,0.0,0.0,0.0
2024,9,20,5,2024-09-20,HA,860,TPA,ATL,"Tampa, FL",Florida,"Atlanta, GA",Georgia,639,1902,-8,0,631,1902,16,16,647,1886,2087,258,278,290,0,,0,0.0,0.0,0.0,0.0,0.0
2024,8,12,1,2024-08-12,UA,6738,HNL,MSP,"Honolulu, HI",Hawaii,"Minneapolis, MN",Minnesota,751,1595,1,0,752,1595,12,16,764,1579,1609,210,230,238,0,,0,0.0,0.0,0.0,0.0,0.0
2024,8,4,7,2024-08-04,NK,5712,MIA,SEA,"Miami, FL",Florida,"Seattle, WA",Washington,1168,895,-7,-5,1161,890,9,12,1170,878,2145,277,297,298,0,,0,0.0,0.0,0.0,0.0,0.0
2024,2,14,3,2024-02-14,9E,3340,BWI,DEN,"Baltimore, MD",Maryland,"Denver, CO",Colorado,2294,2150,9,10,2303,2160,21,16,2324,2144,496,55,75,92,0,,0,0.0,0.0,0.0,0.0,0.0
2024,8,1,4,2024-08-01,NK,630,JFK,DFW,"New York, NY",New York,"Dallas/Fort Worth, TX",Texas,816,714,-10,-10,806,704,24,13,830,691,2644,335,355,372,0,,0,0.0,0.0,0.0,0.0,0.0
2024,2,28,3,2024-02-28,AS,9651,MSP,SAN,"Minneapolis, MN",Minnesota,"San Diego, CA",California,919,1092,20,15,939,1107,24,12,963,1095,351,50,70,86,0,,0,0.0,0.0,0.0,0.0,0.0
2024,5,11,6,2024-05-11,DL,2660,MDW,EWR,"Chicago, IL",Illinois,"Newark, NJ",New Jersey,1378,1680,-5,-5,1373,1675,18,17,1391,1658,1936,234,254,269,0,,0,0.0,0.0,0.0,0.0,0.0
2024,4,13,6,2024-04-13,F9,2277,PDX,PHL,"Portland, OR",Oregon,"Philadelphia, PA",Pennsylvania,1248,1478,-3,0,1245,1478,28,4,1273,1474,2346,295,315,327,0,,0,0.0,0.0,0.0,0.0,0.0
2024,7,13,6,2024-07-13,AA,5203,EWR,MSP,"Newark, NJ",New Jersey,"Minneapolis, MN",Minnesota,1598,1765,18,15,1616,1780,13,14,1629,1766,2693,340,360,367,0,,0,0.0,0.0,0.0,0.0,0.0
2024,6,5,3,2024-06-05,MQ,7806,MCO,SAN,"Orlando, FL",Florida,"San Diego, CA",California,1397,1318,-4,5,1393,1323,23,16,1416,1307,807,109,129,148,0,,0,0.0,0.0,0.0,0.0,0.0
2024,4,7,7,2024-04-07,AA,1637,LGA,CLT,"New York, NY",New York,"Charlotte, NC",North Carolina,1552,1251,-22,-15,1530,1236,16,4,1546,1232,1288,167,187,187,0,,0,0.0,0.0,0.0,0.0,0.0
2024,8,13,2,2024-08-13,AS,9565,LAS,PHX,"Las Vegas, NV",Nevada,"Phoenix, AZ",Arizona,1564,1218,4,0,1568,1218,15,14,1583,1204,1638,201,221,230,0,,0,0.0,0.0,0.0,0.0,0.0
2024,7,23,2,2024-07-23,B6,2881,STL,MIA,"St. Louis, MO",Missouri,"Miami, FL",Florida,1040,1008,2,-5,1042,1003,5,3,1047,1000,2393,308,328,316,0,,0,0.0,0.0,0.0,0.0,0.0
2024,3,19,2,2024-03-19,G4,1046,DTW,SAN,"Detroit, MI",Michigan,"San Diego, CA",California,2015,1701,0,0,2015,1701,15,14,2030,1687,776,106,126,135,0,,0,0.0,0.0,0.0,0.0,0.0
2024,5,3,5,2024-05-03,MQ,5357,IAH,ATL,"Houston, TX",Texas,"Atlanta, GA",Georgia,1623,1625,13,5,1636,1630,12,14,1648,1616,2902,357,377,383,0,,0,0.0,0.0,0.0,0.0,0.0
2024,8,5,1,2024-08-05,YX,9590,IAH,HNL,"Houston, TX",Texas,"Honolulu, HI",Hawaii,1843,1385,7,0,1850,1385,29,6,1879,1379,1018,130,150,165,0,,0,0.0,0.0,0.0,0.0,0.0
2024,1,4,4,2024-01-04,NK,5197,STL,BWI,"St. Louis, MO",Missouri,"Baltimore, MD",Maryland,1069,634,-17,-15,1052,619,24,19,1076,600,731,82,102,125,0,,0,0.0,0.0,0.0,0.0,0.0
2024,3,30,6,2024-03-30,DL,2611,DFW,LAX,"Dallas/Fort Worth, TX",Texas,"Los Angeles, CA",California,1222,994,-6,0,1216,994,25,18,1241,976,549,61,81,104,0,,0,0.0,0.0,0.0,0.0,0.0
2024,4,13,6,2024-04-13,MQ,2288,MSP,TPA,"Minneapolis, MN",Minnesota,"Tampa, FL",Florida,2173,1841,-21,-20,2152,1821,8,3,2160,1818,2234,280,300,291,0,,0,0.0,0.0,0.0,0.0,0.0
2024,4,28,7,2024-04-28,YX,6163,SEA,CLT,"Seattle, WA",Washington,"Charlotte, NC",North Carolina,2046,1690,1,-5,2047,1685,8,19,2055,1666,2452,297,317,324,0,,0,0.0,0.0,0.0,0.0,0.0
2024,5,12,7,2024-05-12,NK,981,BOS,DCA,"Boston, MA",Massachusetts,"Washington, DC",District of Columbia,1500,1692,9,0,1509,1692,15,4,1524,1688,964,125,145,144,0,,0,0.0,0.0,0.0,0.0,0.0
2024,11,7,4,2024-11-07,HA,1947,PHL,TPA,"Philadelphia, PA",Pennsylvania,"Tampa, FL",Florida,1375,1847,2,0,1377,1847,23,13,1400,1834,320,41,61,77,0,,0,0.0,0.0,0.0,0.0,0.0
2024,4,5,5,2024-04-05,UA,6699,DEN,MSP,"Denver, CO",Colorado,"Minneapolis, MN",Minnesota,688,960,-7,0,681,960,8,9,689,951,261,24,44,41,0,,0,0.0,0.0,0.0,0.0,0.0
2024,11,26,2,2024-11-26,AA,2075,DCA,HNL,"Washington, DC",District of Columbia,"Honolulu, HI",Hawaii,949,1057,-7,-10,942,1047,29,3,971,1044,1234,154,174,186,0,,0,0.0,0.0,0.0,0.0,0.0
2024,5,22,3,2024-05-22,OO,6677,TPA,ATL,"Tampa, FL",Florida,"Atlanta, GA",Georgia,593,893,12,15,605,908,27,8,632,900,753,96,116,131,0,,0,0.0,0.0,0.0,0.0,0.0
2024,10,14,1,2024-10-14,F9,5826,LAS,TPA,"Las Vegas, NV",Nevada,"Tampa, FL",Florida,1704,1949,9,5,1713,1954,10,8,1723,1946,1472,182,202,200,0,,0,0.0,0.0,0.0,0.0,0.0
2024,1,28,7,2024-01-28,OH,4668,MIA,SLC,"Miami, FL",Florida,"Salt Lake City, UT",Utah,1844,1826,-13,-5,1831,1821,13,7,1844,1814,2893,351,371,371,0,,0,0.0,0.0,0.0,0.0,0.0
2024,10,4,5,2024-10-04,YX,7263,IAD,BOS,"Washington, DC",District of Columbia,"Boston, MA",Massachusetts,782,1192,26,20,808,1212,15,13,823,1199,2477,302,322,330,0,,0,4.0,0.0,0.0,0.0,16.0
2024,8,20,2,2024-08-20,UA,6682,LAX,DFW,"Los Angeles, CA",California,"Dallas/Fort Worth, TX",Texas,1914,1554,14,10,1928,1564,16,7,1944,1557,288,39,59,62,0,,0,0.0,0.0,0.0,0.0,0.0
2024,1,17,3,2024-01-17,OO,8789,EWR,ATL,"Newark, NJ",New Jersey,"Atlanta, GA",Georgia,1844,2201,-25,-15,1819,2186,22,4,1841,2182,1726,220,240,246,0,,0,0.0,0.0,0.0,0.0,0.0
2024,2,28,3,2024-02-28,F9,2316,MIA,PHX,"Miami, FL",Florida,"Phoenix, AZ",Arizona,1069,896,-1,5,1068,901,24,12,1092,889,2420,299,319,335,0,,0,0.0,0.0,0.0,0.0,0.0
2024,3,30,6,2024-03-30,NK,9280,LAX,BWI,"Los Angeles, CA",California,"Baltimore, MD",Maryland,524,1545,-3,0,521,1545,13,16,534,1529,2221,279,299,308,0,,0,0.0,0.0,0.0,0.0,0.0
2024,7,17,3,2024-07-17,YX,5801,IAH,DEN,"Houston, TX",Texas,"Denver, CO",Colorado,759,860,-12,-10,747,850,28,15,775,835,640,89,109,132,0,,0,0.0,0.0,0.0,0.0,0.0
2024,12,27,5,2024-12-27,HA,8117,PHL,SEA,"Philadelphia, PA",Pennsylvania,"Seattle, WA",Washington,996,1388,-19,-10,977,1378,19,5,996,1373,878,99,119,123,0,,0,0.0,0.0,0.0,0.0,0.0
2024,1,26,5,2024-01-26,DL,2708,STL,MDW,"St. Louis, MO",Missouri,"Chicago, IL",Illinois,1736,2141,-6,0,1730,2141,21,6,1751,2135,1841,229,249,256,0,,0,0.0,0.0,0.0,0.0,0.0
2024,1,25,4,2024-01-25,MQ,9662,HNL,ORD,"Honolulu, HI",Hawaii,"Chicago, IL",Illinois,614,1755,-12,-5,602,1750,13,14,615,1736,2610,319,339,346,0,,0,0.0,0.0,0.0,0.0,0.0
2024,10,27,7,2024-10-27,OH,4909,STL,DTW,"St. Louis, MO",Missouri,"Detroit, MI",Michigan,951,1948,11,10,962,1958,17,16,979,1942,2799,345,365,378,0,,0,0.0,0.0,0.0,0.0,0.0
2024,12,4,3,2024-12-04,OH,6445,DTW,TPA,"Detroit, MI",Michigan,"Tampa, FL",Florida,1199,1691,-7,-15,1192,1676,6,6,1198,1670,2638,329,349,341,0,,0,0.0,0.0,0.0,0.0,0.0
2024,9,23,1,2024-09-23,AA,278,MIA,PHX,"Miami, FL",Florida,"Phoenix, AZ",Arizona,1271,1749,6,15,1277,1764,21,12,1298,1752,665,75,95,108,0,,0,0.0,0.0,0.0,0.0,0.0
2024,6,29,6,2024-06-29,NK,7871,LGA,SEA,"New York, NY",New York,"Seattle, WA",Washington,2171,2016,15,10,2186,2026,22,11,2208,2015,563,64,84,97,0,,0,0.0,0.0,0.0,0.0,0.0
2024,12,25,3,2024-12-25,MQ,8071,JFK,BOS,"New York, NY",New York,"Boston, MA",Massachusetts,2013,1001,-4,5,2009,1006,10,18,2019,988,2234,280,300,308,0,,0,0.0,0.0,0.0,0.0,0.0
2024,3,8,5,2024-03-08,AA,2029,PDX,DTW,"Portland, OR",Oregon,"Detroit, MI",Michigan,2125,1426,-11,-10,2114,1416,6,13,2120,1403,618,77,97,96,0,,0,0.0,0.0,0.0,0.0,0.0
2024,12,16,1,2024-12-16,AS,2648,CLT,ATL,"Charlotte, NC",North Carolina,"Atlanta, GA",Georgia,2256,2306,4,5,2260,2311,5,3,2265,2308,1937,232,252,240,0,,0,0.0,0.0,0.0,0.0,0.0
2024,11,16,6,2024-11-16,MQ,4934,LAX,BOS,"Los Angeles, CA",California,"Boston, MA",Massachusetts,2051,935,1,-5,2052,930,9,12,2061,918,725,91,111,112,0,,0,0.0,0.0,0.0,0.0,0.0
2024,2,18,7,2024-02-18,OO,211,STL,DCA,"St. Louis, MO",Missouri,"Washington, DC",District of Columbia,2182,1561,1,0,2183,1561,18,12,2201,1549,2970,369,389,399,0,,0,0.0,0.0,0.0,0.0,0.0
2024,6,23,7,2024-06-23,9E,8048,IAD,ORD,"Washington, DC",District of Columbia,"Chicago, IL",Illinois,884,628,-9,-5,875,623,22,11,897,612,2234,284,304,317,0,,0,0.0,0.0,0.0,0.0,0.0
2024,2,21,3,2024-02-21,OO,814,MDW,DEN,"Chicago, IL",Illinois,"Denver, CO",Colorado,1112,2311,8,10,1120,2321,8,3,1128,2318,421,52,72,63,0,,0,0.0,0.0,0.0,0.0,0.0
2024,4,11,4,2024-04-11,9E,9693,MDW,BWI,"Chicago, IL",Illinois,"Baltimore, MD",Maryland,1941,1403,-17,-20,1924,1383,18,4,1942,1379,2384,290,310,312,0,,0,0.0,0.0,0.0,0.0,0.0
2024,8,3,6,2024-08-03,F9,6134,ATL,DFW,"Atlanta, GA",Georgia,"Dallas/Fort Worth, TX",Texas,1488,1443,12,5,1500,1448,19,17,1519,1431,2316,286,306,322,0,,0,0.0,0.0,0.0,0.0,0.0
2024,7,6,6,2024-07-06,NK,1481,DTW,DCA,"Detroit, MI",Michigan,"Washington, DC",District of Columbia,718,2240,9,10,727,2250,28,10,755,2240,1006,132,152,170,0,,0,0.0,0.0,0.0,0.0,0.0
2024,2,26,1,2024-02-26,WN,3227,DTW,TPA,"Detroit, MI",Michigan,"Tampa, FL",Florida,1379,644,5,0,1384,644,26,17,1410,627,1412,169,189,212,0,,0,0.0,0.0,0.0,0.0,0.0
2024,2,16,5,2024-02-16,AA,7583,ATL,BOS,"Atlanta, GA",Georgia,"Boston, MA",Massachusetts,1056,1724,-20,-10,1036,1714,12,19,1048,1695,879,107,127,138,0,,0,0.0,0.0,0.0,0.0,0.0
2024,6,7,5,2024-06-07,AA,1308,MDW,JFK,"Chicago, IL",Illinois,"New York, NY",New York,1586,1849,-12,-10,1574,1839,25,12,1599,1827,355,37,57,74,0,,0,0.0,0.0,0.0,0.0,0.0
2024,6,22,6,2024-06-22,WN,136,ATL,STL,"Atlanta, GA",Georgia,"St. Louis, MO",Missouri,849,1018,2,0,851,1018,6,7,857,1011,2744,333,353,346,0,,0,0.0,0.0,0.0,0.0,0.0
2024,8,29,4,2024-08-29,B6,1928,DCA,IAH,"Washington, DC",District of Columbia,"Houston, TX",Texas,889,1215,0,-5,889,1210,21,7,910,1203,395,41,61,69,0,,0,0.0,0.0,0.0,0.0,0.0
2024,10,8,2,2024-10-08,YX,3441,SLC,BWI,"Salt Lake City, UT",Utah,"Baltimore, MD",Maryland,1303,861,-15,-20,1288,841,28,13,1316,828,2924,365,385,406,0,,0,0.0,0.0,0.0,0.0,0.0
2024,8,28,3,2024-08-28,NK,7106,MCO,ATL,"Orlando, FL",Florida,"Atlanta, GA",Georgia,876,1364,-29,-20,847,1344,21,12,868,1332,962,119,139,152,0,,0,0.0,0.0,0.0,0.0,0.0
2024,1,5,5,2024-01-05,OH,7775,TPA,MSP,"Tampa, FL",Florida,"Minneapolis, MN",Minnesota,1370,2300,3,5,1373,2305,29,5,1402,2300,675,91,111,125,0,,0,0.0,0.0,0.0,0.0,0.0
2024,3,24,7,2024-03-24,WN,5447,MDW,LAS,"Chicago, IL",Illinois,"Las Vegas, NV",Nevada,565,891,-13,-15,552,876,24,11,576,865,2476,314,334,349,0,,0,0.0,0.0,0.0,0.0,0.0
2024,11,3,7,2024-11-03,9E,7990,DEN,LAS,"Denver, CO",Colorado,"Las Vegas, NV",Nevada,1642,1835,12,15,1654,1850,10,7,1664,1843,1209,154,174,171,0,,0,0.0,0.0,0.0,0.0,0.0
2024,12,26,4,2024-12-26,OH,909,MCO,STL,"Orlando, FL",Florida,"St. Louis, MO",Missouri,1245,2279,-5,-5,1240,2274,10,3,1250,2271,1129,138,158,151,0,,0,0.0,0.0,0.0,0.0,0.0
2024,9,4,3,2024-09-04,YX,4218,SFO,DCA,"San Francisco, CA",California,"Washington, DC",District of Columbia,507,2079,11,5,518,2084,23,7,541,2077,690,86,106,116,0,,0,0.0,0.0,0.0,0.0,0.0
2024,2,23,5,2024-02-23,AA,1626,BOS,PDX,"Boston, MA",Massachusetts,"Portland, OR",Oregon,2230,1859,-6,-15,2224,1844,5,13,2229,1831,2466,298,318,316,0,,0,0.0,0.0,0.0,0.0,0.0
2024,6,9,7,2024-06-09,OO,595,MSP,BWI,"Minneapolis, MN",Minnesota,"Baltimore, MD",Maryland,2262,1133,15,15,2277,1148,10,3,2287,1145,712,89,109,102,0,,0,0.0,0.0,0.0,0.0,0.0
2024,8,13,2,2024-08-13,9E,524,MSP,CLT,"Minneapolis, MN",Minnesota,"Charlotte, NC",North Carolina,526,1692,-20,-20,506,1672,9,18,515,1654,2268,285,305,312,0,,0,0.0,0.0,0.0,0.0,0.0
2024,1,15,1,2024-01-15,NK,2847,EWR,IAD,"Newark, NJ",New Jersey,"Washington, DC",District of Columbia,789,2204,-15,-20,774,2184,8,10,782,2174,2931,368,388,386,0,,0,0.0,0.0,0.0,0.0,0.0
2024,8,11,7,2024-08-11,DL,2082,SFO,PHX,"San Francisco, CA",California,"Phoenix, AZ",Arizona,527,1869,-19,-15,508,1854,29,18,537,1836,2355,285,305,332,0,,0,0.0,0.0,0.0,0.0,0.0
2024,3,1,5,2024-03-01,MQ,1568,SLC,TPA,"Salt Lake City, UT",Utah,"Tampa, FL",Florida,1682,1174,-25,-15,1657,1159,17,3,1674,1156,2555,309,329,329,0,,0,0.0,0.0,0.0,0.0,0.0
2024,5,1,3,2024-05-01,OO,7828,PHL,CLT,"Philadelphia, PA",Pennsylvania,"Charlotte, NC",North Carolina,1668,836,4,0,1672,836,24,10,1696,826,2504,316,336,350,0,,0,0.0,0.0,0.0,0.0,0.0
2024,10,3,4,2024-10-03,DL,6870,MCO,SAN,"Orlando, FL",Florida,"San Diego, CA",California,966,1954,12,5,978,1959,21,6,999,1953,2684,334,354,361,0,,0,0.0,0.0,0.0,0.0,0.0
2024,2,15,4,2024-02-15,F9,1333,DCA,LGA,"Washington, DC",District of Columbia,"New York, NY",New York,2269,962,-7,-10,2262,952,17,6,2279,946,778,90,110,113,0,,0,0.0,0.0,0.0,0.0,0.0
2024,10,20,7,2024-10-20,YX,8856,MCO,DFW,"Orlando, FL",Florida,"Dallas/Fort Worth, TX",Texas,607,1130,7,5,614,1135,26,6,640,1129,2664,337,357,369,0,,0,0.0,0.0,0.0,0.0,0.0
2024,3,2,6,2024-03-02,9E,3119,PHL,BWI,"Philadelphia, PA",Pennsylvania,"Baltimore, MD",Maryland,1390,1342,-4,5,1386,1347,20,11,1406,1336,210,31,51,62,0,,0,0.0,0.0,0.0,0.0,0.0
2024,3,26,2,2024-03-26,9E,1404,DEN,DFW,"Denver, CO",Colorado,"Dallas/Fort Worth, TX",Texas,938,1064,24,15,962,1079,17,4,979,1075,1566,185,205,206,0,,0,0.0,0.0,0.0,0.0,0.0
2024,7,28,7,2024-07-28,9E,8134,CLT,PHL,"Charlotte, NC",North Carolina,"Philadelphia, PA",Pennsylvania,702,1852,-15,-15,687,1837,27,5,714,1832,1528,195,215,227,0,,0,0.0,0.0,0.0,0.0,0.0
2024,3,18,1,2024-03-18,B6,232,DFW,LAS,"Dallas/Fort Worth, TX",Texas,"Las Vegas, NV",Nevada,1276,2132,-7,-15,1269,2117,5,15,1274,2102,387,50,70,70,0,,0,0.0,0.0,0.0,0.0,0.0
2024,7,20,6,2024-07-20,9E,548,PHL,DTW,"Philadelphia, PA",Pennsylvania,"Detroit, MI",Michigan,1489,981,-20,-15,1469,966,29,11,1498,955,1703,206,226,246,0,,0,0.0,0.0,0.0,0.0,0.0
2024,10,28,1,2024-10-28,DL,6507,MCO,LGA,"Orlando, FL",Florida,"New York, NY",New York,800,726,1,-5,801,721,14,7,815,714,629,75,95,96,0,,0,0.0,0.0,0.0,0.0,0.0
2024,8,10,6,2024-08-10,B6,949,LGA,CLT,"New York, NY",New York,"Charlotte, NC",North Carolina,937,1257,-10,0,927,1257,22,17,949,1240,1691,211,231,250,0,,0,0.0,0.0,0.0,0.0,0.0
2024,8,9,5,2024-08-09,F9,5457,MSP,PHX,"Minneapolis, MN",Minnesota,"Phoenix, AZ",Arizona,1534,1737,9,0,1543,1737,27,11,1570,1726,215,30,50,68,0,,0,0.0,0.0,0.0,0.0,0.0
2024,1,3,3,2024-01-03,AS,4062,MSP,STL,"Minneapolis, MN",Minnesota,"St. Louis, MO",Missouri,1336,842,-16,-10,1320,832,28,8,1348,824,2971,368,388,404,0,,0,0.0,0.0,0.0,0.0,0.0
2024,1,6,6,2024-01-06,UA,9772,DTW,EWR,"Detroit, MI",Michigan,"Newark, NJ",New Jersey,1106,1768,-10,0,1096,1768,28,12,1124,1756,2117,263,283,303,0,,0,0.0,0.0,0.0,0.0,0.0
2024,4,2,2,2024-04-02,F9,9192,JFK,PHX,"New York, NY",New York,"Phoenix, AZ",Arizona,1141,1152,-3,-5,1138,1147,21,3,1159,1144,1231,155,175,179,0,,0,0.0,0.0,0.0,0.0,0.0
2024,1,8,1,2024-01-08,HA,4954,CLT,EWR,"Charlotte, NC",North Carolina,"Newark, NJ",New Jersey,1626,2296,-15,-5,1611,2291,21,15,1632,2276,2878,359,379,395,0,,0,0.0,0.0,0.0,0.0,0.0
2024,8,22,4,2024-08-22,OH,1639,PHL,SFO,"Philadelphia, PA",Pennsylvania,"San Francisco, CA",California,2009,1038,-14,-15,1995,1023,14,19,2009,1004,2742,343,363,376,0,,0,0.0,0.0,0.0,0.0,0.0
2024,4,17,3,2024-04-17,G4,1999,LGA,DTW,"New York, NY",New York,"Detroit, MI",Michigan,609,1961,-2,0,607,1961,24,16,631,1945,1547,195,215,235,0,,0,0.0,0.0,0.0,0.0,0.0
2024,6,9,7,2024-06-09,B6,3044,SLC,DCA,"Salt Lake City, UT",Utah,"Washington, DC",District of Columbia,1142,1007,7,5,1149,1012,6,5,1155,1007,1125,142,162,153,0,,0,0.0,0.0,0.0,0.0,0.0
2024,7,27,6,2024-07-27,MQ,5057,BOS,PDX,"Boston, MA",Massachusetts,"Portland, OR",Oregon,1202,1188,4,5,1206,1193,14,15,1220,1178,508,70,90,99,0,,0,0.0,0.0,0.0,0.0,0.0
2024,8,27,2,2024-08-27,DL,6043,BOS,STL,"Boston, MA",Massachusetts,"St. Louis, MO",Missouri,1616,1791,20,15,1636,1806,24,10,1660,1796,1890,226,246,260,0,,0,0.0,0.0,0.0,0.0,0.0
2024,11,26,2,2024-11-26,DL,3344,MIA,SAN,"Miami, FL",Florida,"San Diego, CA",California,1300,1395,0,5,1300,1400,10,3,1310,1397,2726,344,364,357,0,,0,0.0,0.0,0.0,0.0,0.0
2024,11,28,4,2024-11-28,NK,6436,IAH,MCO,"Houston, TX",Texas,"Orlando, FL",Florida,2241,2245,-13,-10,2228,2235,7,4,2235,2231,2004,247,267,258,0,,0,0.0,0.0,0.0,0.0,0.0
2024,2,19,1,2024-02-19,AA,8806,SLC,TPA,"Salt Lake City, UT",Utah,"Tampa, FL",Florida,1369,2330,-14,-10,1355,2320,14,4,1369,2316,413,49,69,67,0,,0,0.0,0.0,0.0,0.0,0.0
2024,1,11,4,2024-01-11,9E,1691,MSP,LAX,"Minneapolis, MN",Minnesota,"Los Angeles, CA",California,2064,1790,17,15,2081,1805,23,11,2104,1794,334,42,62,76,0,,0,0.0,0.0,0.0,0.0,0.0
2024,12,16,1,2024-12-16,YX,8053,CLT,HNL,"Charlotte, NC",North Carolina,"Honolulu, HI",Hawaii,1418,2156,11,5,1429,2161,21,3,1450,2158,1175,144,164,168,0,,0,0.0,0.0,0.0,0.0,0.0
2024,6,4,2,2024-06-04,DL,7955,MCO,DEN,"Orlando, FL",Florida,"Denver, CO",Colorado,2222,1788,6,5,2228,1793,16,13,2244,1780,610,75,95,104,0,,0,0.0,0.0,0.0,0.0,0.0
2024,3,10,7,2024-03-10,9E,7895,BOS,PHX,"Boston, MA",Massachusetts,"Phoenix, AZ",Arizona,1348,1241,5,5,1353,1246,25,9,1378,1237,2826,355,375,389,0,,0,0.0,0.0,0.0,0.0,0.0
2024,6,17,1,2024-06-17,WN,8375,SLC,MIA,"Salt Lake City, UT",Utah,"Miami, FL",Florida,1006,1885,-15,-10,991,1875,16,8,1007,1867,1535,190,210,214,0,,0,0.0,0.0,0.0,0.0,0.0
2024,9,28,6,2024-09-28,AA,3842,HNL,PDX,"Honolulu, HI",Hawaii,"Portland, OR",Oregon,676,1163,14,10,690,1173,27,19,717,1154,793,108,128,154,0,,0,0.0,0.0,0.0,0.0,0.0
2024,3,8,5,2024-03-08,WN,2227,LAX,PHX,"Los Angeles, CA",California,"Phoenix, AZ",Arizona,1962,1884,-21,-15,1941,1869,10,8,1951,1861,469,66,86,84,0,,0,0.0,0.0,0.0,0.0,0.0
2024,12,20,5,2024-12-20,MQ,1701,BWI,HNL,"Baltimore, MD",Maryland,"Honolulu, HI",Hawaii,1167,1798,0,-5,1167,1793,16,18,1183,1775,584,66,86,100,0,,0,0.0,0.0,0.0,0.0,0.0
2024,9,8,7,2024-09-08,YX,1322,ORD,DCA,"Chicago, IL",Illinois,"Washington, DC",District of Columbia,2281,1410,-5,-5,2276,1405,24,3,2300,1402,218,35,55,62,0,,0,0.0,0.0,0.0,0.0,0.0
2024,2,17,6,2024-02-17,OO,5790,SLC,SFO,"Salt Lake City, UT",Utah,"San Francisco, CA",California,2234,1719,-1,0,2233,1719,10,6,2243,1713,2570,328,348,344,0,,0,0.0,0.0,0.0,0.0,0.0
2024,7,2,2,2024-07-02,MQ,1942,MSP,CLT,"Minneapolis, MN",Minnesota,"Charlotte, NC",North Carolina,1010,1980,-3,0,1007,1980,7,4,1014,1976,1053,121,141,132,0,,0,0.0,0.0,0.0,0.0,0.0
2024,11,15,5,2024-11-15,9E,8158,JFK,MIA,"New York, NY",New York,"Miami, FL",Florida,608,969,-6,0,602,969,7,3,609,966,2934,375,395,385,0,,0,0.0,0.0,0.0,0.0,0.0
2024,7,5,5,2024-07-05,HA,9881,MSP,DFW,"Minneapolis, MN",Minnesota,"Dallas/Fort Worth, TX",Texas,1371,2175,-1,0,1370,2175,27,9,1397,2166,2938,367,387,403,0,,0,0.0,0.0,0.0,0.0,0.0
2024,3,30,6,2024-03-30,B6,5665,LAX,IAD,"Los Angeles, CA",California,"Washington, DC",District of Columbia,1595,1506,-6,-5,1589,1501,13,18,1602,1483,1200,147,167,178,0,,0,0.0,0.0,0.0,0.0,0.0
2024,11,27,3,2024-11-27,G4,4588,ATL,MCO,"Atlanta, GA",Georgia,"Orlando, FL",Florida,988,2344,-20,-10,968,2334,5,15,973,2319,2745,343,363,363,0,,0,0.0,0.0,0.0,0.0,0.0
2024,5,18,6,2024-05-18,AA,8300,LGA,SLC,"New York, NY",New York,"Salt Lake City, UT",Utah,1232,1765,7,5,1239,1770,8,9,1247,1761,392,44,64,61,0,,0,0.0,0.0,0.0,0.0,0.0
2024,12,22,7,2024-12-22,YX,7050,CLT,LAX,"Charlotte, NC",North Carolina,"Los Angeles, CA",California,780,1369,14,5,794,1374,16,9,810,1365,1102,132,152,157,0,,0,0.0,0.0,0.0,0.0,0.0
2024,3,29,5,2024-03-29,B6,9006,PHL,STL,"Philadelphia, PA",Pennsylvania,"St. Louis, MO",Missouri,1402,1790,7,0,1409,1790,9,6,1418,1784,1188,148,168,163,0,,0,0.0,0.0,0.0,0.0,0.0
2024,9,30,1,2024-09-30,DL,2027,STL,BWI,"St. Louis, MO",Missouri,"Baltimore, MD",Maryland,1737,2326,-6,0,1731,2326,22,19,1753,2307,1486,179,199,220,0,,0,0.0,0.0,0.0,0.0,0.0
2024,1,19,5,2024-01-19,G4,8401,EWR,TPA,"Newark, NJ",New Jersey,"Tampa, FL",Florida,1980,1942,5,0,1985,1942,20,7,2005,1935,1552,194,214,221,0,,0,0.0,0.0,0.0,0.0,0.0
2024,11,6,3,2024-11-06,AS,5029,DCA,PHL,"Washington, DC",District of Columbia,"Philadelphia, PA",Pennsylvania,2110,2254,-20,-15,2090,2239,14,9,2104,2230,2620,320,340,343,0,,0,0.0,0.0,0.0,0.0,0.0
2024,12,23,1,2024-12-23,DL,8557,IAD,STL,"Washington, DC",District of Columbia,"St. Louis, MO",Missouri,917,1257,-6,-5,911,1252,16,8,927,1244,1335,163,183,187,0,,0,0.0,0.0,0.0,0.0,0.0
2024,6,2,7,2024-06-02,OH,5592,DCA,CLT,"Washington, DC",District of Columbia,"Charlotte, NC",North Carolina,1253,1592,-24,-20,1229,1572,15,7,1244,1565,1210,151,171,173,0,,0,0.0,0.0,0.0,0.0,0.0
2024,9,16,1,2024-09-16,UA,3323,DCA,PDX,"Washington, DC",District of Columbia,"Portland, OR",Oregon,2033,1958,14,5,2047,1963,23,15,2070,1948,1587,197,217,235,0,,0,0.0,0.0,0.0,0.0,0.0
2024,4,17,3,2024-04-17,OH,6227,MIA,IAH,"Miami, FL",Florida,"Houston, TX",Texas,1161,1588,5,0,1166,1588,9,14,1175,1574,551,68,88,91,0,,0,0.0,0.0,0.0,0.0,0.0
2024,10,11,5,2024-10-11,F9,5171,BOS,SLC,"Boston, MA",Massachusetts,"Salt Lake City, UT",Utah,1846,2097,-25,-15,1821,2082,28,7,1849,2075,2060,265,285,300,0,,0,0.0,0.0,0.0,0.0,0.0
2024,2,28,3,2024-02-28,AA,1054,ORD,CLT,"Chicago, IL",Illinois,"Charlotte, NC",North Carolina,1701,2264,-4,0,1697,2264,7,6,1704,2258,375,36,56,49,0,,0,0.0,0.0,0.0,0.0,0.0
2024,5,4,6,2024-05-04,YX,7150,PHX,HNL,"Phoenix, AZ",Arizona,"Honolulu, HI",Hawaii,1187,1768,11,10,1198,1778,23,10,1221,1768,1063,129,149,162,0,,0,0.0,0.0,0.0,0.0,0.0
2024,12,19,4,2024-12-19,UA,9641,PHL,STL,"Philadelphia, PA",Pennsylvania,"St. Louis, MO",Missouri,603,1677,-1,-5,602,1672,10,17,612,1655,365,41,61,68,0,,0,0.0,0.0,0.0,0.0,0.0
2024,9,29,7,2024-09-29,MQ,1674,MIA,HNL,"Miami, FL",Florida,"Honolulu, HI",Hawaii,1642,721,21,30,1663,751,28,13,1691,738,623,82,102,123,0,,0,5.0,3.0,2.0,0.0,20.0
2024,4,16,2,2024-04-16,9E,6768,BOS,MSP,"Boston, MA",Massachusetts,"Minneapolis, MN",Minnesota,1211,1747,27,20,1238,1767,21,7,1259,1760,1050,125,145,153,0,,0,4.0,4.0,0.0,0.0,12.0
2024,10,25,5,2024-10-25,AA,7195,MCO,ATL,"Orlando, FL",Florida,"Atlanta, GA",Georgia,1081,766,-2,5,1079,771,27,13,1106,758,2856,351,371,391,0,,0,0.0,0.0,0.0,0.0,0.0
2024,9,1,7,2024-09-01,OO,7820,SEA,IAD,"Seattle, WA",Washington,"Washington, DC",District of Columbia,556,1543,12,10,568,1553,17,12,585,1541,2660,337,357,366,0,,0,0.0,0.0,0.0,0.0,0.0
2024,12,1,7,2024-12-01,OO,3355,SAN,LAX,"San Diego, CA",California,"Los Angeles, CA",California,1932,1433,-7,-5,1925,1428,11,4,1936,1424,1855,235,255,250,0,,0,0.0,0.0,0.0,0.0,0.0
2024,9,3,2,2024-09-03,F9,1158,TPA,BOS,"Tampa, FL",Florida,"Boston, MA",Massachusetts,1077,2278,-12,-5,1065,2273,23,10,1088,2263,2924,367,387,400,0,,0,0.0,0.0,0.0,0.0,0.0
2024,1,8,1,2024-01-08,AA,2057,DEN,LAX,"Denver, CO",Colorado,"Los Angeles, CA",California,1581,621,18,20,1599,641,23,6,1622,635,954,118,138,147,0,,0,6.0,1.0,2.0,0.0,11.0
2024,5,20,1,2024-05-20,MQ,6748,PDX,LGA,"Portland, OR",Oregon,"New York, NY",New York,616,1899,-15,-5,601,1894,29,18,630,1876,1870,239,259,286,0,,1,0.0,0.0,0.0,0.0,0.0
2024,12,27,5,2024-12-27,B6,5044,DCA,STL,"Washington, DC",District of Columbia,"St. Louis, MO",Missouri,1948,1007,-18,-15,1930,992,16,16,1946,976,1457,179,199,211,0,,0,0.0,0.0,0.0,0.0,0.0
2024,1,8,1,2024-01-08,WN,5158,TPA,CLT,"Tampa, FL",Florida,"Charlotte, NC",North Carolina,1318,1081,-20,-10,1298,1071,15,5,1313,1066,2708,341,361,361,0,,0,0.0,0.0,0.0,0.0,0.0
2024,12,17,2,2024-12-17,NK,2619,IAD,DCA,"Washington, DC",District of Columbia,"Washington, DC",District of Columbia,1544,898,10,5,1554,903,21,10,1575,893,1734,216,236,247,0,,0,0.0,0.0,0.0,0.0,0.0
2024,4,3,3,2024-04-03,OH,8013,SFO,STL,"San Francisco, CA",California,"St. Louis, MO",Missouri,578,876,-1,-5,577,871,21,6,598,865,2604,328,348,355,0,,0,0.0,0.0,0.0,0.0,0.0
2024,11,16,6,2024-11-16,B6,2670,SLC,ORD,"Salt Lake City, UT",Utah,"Chicago, IL",Illinois,1058,1415,-6,-10,1052,1405,22,9,1074,1396,345,42,62,73,0,,0,0.0,0.0,0.0,0.0,0.0
2024,2,8,4,2024-02-08,F9,7550,DFW,PHX,"Dallas/Fort Worth, TX",Texas,"Phoenix, AZ",Arizona,1385,921,4,10,1389,931,19,11,1408,920,383,51,71,81,0,,0,0.0,0.0,0.0,0.0,0.0
2024,3,21,4,2024-03-21,YX,3987,TPA,JFK,"Tampa, FL",Florida,"New York, NY",New York,2206,714,8,0,2214,714,10,4,2224,710,2014,254,274,268,0,,0,0.0,0.0,0.0,0.0,0.0
2024,7,5,5,2024-07-05,OH,7803,PHL,IAD,"Philadelphia, PA",Pennsylvania,"Washington, DC",District of Columbia,2119,871,0,0,2119,871,12,5,2131,866,798,97,117,114,0,,0,0.0,0.0,0.0,0.0,0.0
2024,3,24,7,2024-03-24,OO,6517,DTW,PHX,"Detroit, MI",Michigan,"Phoenix, AZ",Arizona,607,1791,-2,-10,605,1781,15,11,620,1770,1199,156,176,182,0,,0,0.0,0.0,0.0,0.0,0.0
2024,3,28,4,2024-03-28,AA,9179,HNL,STL,"Honolulu, HI",Hawaii,"St. Louis, MO",Missouri,1298,2059,-18,-10,1280,2049,17,9,1297,2040,2475,310,330,336,0,,0,0.0,0.0,0.0,0.0,0.0
2024,8,29,4,2024-08-29,B6,844,EWR,CLT,"Newark, NJ",New Jersey,"Charlotte, NC",North Carolina,1794,863,-22,-15,1772,848,21,17,1793,831,1299,167,187,205,0,,0,0.0,0.0,0.0,0.0,0.0
2024,12,7,6,2024-12-07,WN,6520,IAH,MSP,"Houston, TX",Texas,"Minneapolis, MN",Minnesota,1187,849,5,0,1192,849,21,19,1213,830,1435,173,193,213,0,,0,0.0,0.0,0.0,0.0,0.0
2024,4,2,2,2024-04-02,UA,3614,SEA,IAD,"Seattle, WA",Washington,"Washington, DC",District of Columbia,1999,2085,6,5,2005,2090,22,14,2027,2076,1602,203,223,239,0,,0,0.0,0.0,0.0,0.0,0.0
2024,3,26,2,2024-03-26,B6,3030,SEA,STL,"Seattle, WA",Washington,"St. Louis, MO",Missouri,569,1477,1,5,570,1482,20,6,590,1476,2125,258,278,284,0,,0,0.0,0.0,0.0,0.0,0.0
2024,2,13,2,2024-02-13,9E,5637,SEA,MCO,"Seattle, WA",Washington,"Orlando, FL",Florida,886,1038,-20,-10,866,1028,27,19,893,1009,831,99,119,145,0,,0,0.0,0.0,0.0,0.0,0.0
2024,5,16,4,2024-05-16,HA,6813,TPA,EWR,"Tampa, FL",Florida,"Newark, NJ",New Jersey,1689,1965,10,10,1699,1975,20,11,1719,1964,2129,258,278,289,0,,0,0.0,0.0,0.0,0.0,0.0
2024,3,14,4,2024-03-14,UA,275,ORD,LGA,"Chicago, IL",Illinois,"New York, NY",New York,1354,2089,-11,-15,1343,2074,8,8,1351,2066,1937,235,255,251,0,,0,0.0,0.0,0.0,0.0,0.0
2024,2,5,1,2024-02-05,F9,665,STL,MDW,"St. Louis, MO",Missouri,"Chicago, IL",Illinois,1581,1681,-7,-15,1574,1666,21,19,1595,1647,2058,250,270,290,0,,0,0.0,0.0,0.0,0.0,0.0
2024,4,10,3,2024-04-10,MQ,3317,CLT,LAS,"Charlotte, NC",North Carolina,"Las Vegas, NV",Nevada,1974,604,14,10,1988,614,12,5,2000,609,1389,168,188,185,0,,0,0.0,0.0,0.0,0.0,0.0
2024,6,4,2,2024-06-04,UA,4457,DCA,ORD,"Washington, DC",District of Columbia,"Chicago, IL",Illinois,744,2246,-12,-10,732,2236,24,19,756,2217,1046,125,145,168,0,,0,0.0,0.0,0.0,0.0,0.0
2024,9,11,3,2024-09-11,AA,6073,MCO,DTW,"Orlando, FL",Florida,"Detroit, MI",Michigan,1568,1462,7,5,1575,1467,11,19,1586,1448,2000,256,276,286,0,,0,0.0,0.0,0.0,0.0,0.0
2024,6,19,3,2024-06-19,G4,9686,ATL,TPA,"Atlanta, GA",Georgia,"Tampa, FL",Florida,1183,864,-13,-20,1170,844,12,15,1182,829,395,40,60,67,0,,0,0.0,0.0,0.0,0.0,0.0
2024,8,3,6,2024-08-03,HA,5902,STL,ORD,"St. Louis, MO",Missouri,"Chicago, IL",Illinois,2299,1872,-9,-15,2290,1857,5,17,2295,1840,1837,219,239,241,0,,0,0.0,0.0,0.0,0.0,0.0
2024,6,18,2,2024-06-18,G4,7134,DEN,LAX,"Denver, CO",Colorado,"Los Angeles, CA",California,1906,694,-6,0,1900,694,6,14,1906,680,2105,257,277,277,0,,0,0.0,0.0,0.0,0.0,0.0
2024,9,8,7,2024-09-08,AS,9512,DCA,ORD,"Washington, DC",District of Columbia,"Chicago, IL",Illinois,2101,1418,-5,-10,2096,1408,17,16,2113,1392,2498,303,323,336,0,,0,0.0,0.0,0.0,0.0,0.0
2024,12,25,3,2024-12-25,9E,1047,SFO,JFK,"San Francisco, CA",California,"New York, NY",New York,2224,1296,-24,-20,2200,1276,6,17,2206,1259,613,80,100,103,0,,0,0.0,0.0,0.0,0.0,0.0
2024,11,17,7,2024-11-17,AA,8876,MSP,PHX,"Minneapolis, MN",Minnesota,"Phoenix, AZ",Arizona,1284,2080,-6,0,1278,2080,9,16,1287,2064,517,70,90,95,0,,0,0.0,0.0,0.0,0.0,0.0
2024,2,24,6,2024-02-24,F9,9912,MDW,CLT,"Chicago, IL",Illinois,"Charlotte, NC",North Carolina,570,1340,-5,-5,565,1335,9,6,574,1329,744,97,117,112,0,,0,0.0,0.0,0.0,0.0,0.0
2024,3,31,7,2024-03-31,DL,3455,JFK,SFO,"New York, NY",New York,"San Francisco, CA",California,2071,916,15,10,2086,926,10,18,2096,908,2899,371,391,399,0,,0,0.0,0.0,0.0,0.0,0.0
2024,10,4,5,2024-10-04,G4,5351,ORD,PDX,"Chicago, IL",Illinois,"Portland, OR",Oregon,1762,1373,12,10,1774,1383,22,10,1796,1373,2366,300,320,332,0,,0,0.0,0.0,0.0,0.0,0.0
2024,4,10,3,2024-04-10,OH,3291,PHX,MSP,"Phoenix, AZ",Arizona,"Minneapolis, MN",Minnesota,2103,718,-9,0,2094,718,20,13,2114,705,2730,338,358,371,0,,0,0.0,0.0,0.0,0.0,0.0
2024,6,3,1,2024-06-03,F9,5947,DFW,SLC,"Dallas/Fort Worth, TX",Texas,"Salt Lake City, UT",Utah,607,1393,-9,-10,598,1383,28,7,626,1376,903,108,128,143,0,,0,0.0,0.0,0.0,0.0,0.0
2024,12,14,6,2024-12-14,UA,6816,BWI,SEA,"Baltimore, MD",Maryland,"Seattle, WA",Washington,1731,801,1,0,1732,801,21,5,1753,796,1220,142,162,168,0,,0,0.0,0.0,0.0,0.0,0.0
2024,12,29,7,2024-12-29,MQ,631,LGA,BWI,"New York, NY",New York,"Baltimore, MD",Maryland,1221,1676,4,5,1225,1681,13,12,1238,1669,787,90,110,115,0,,0,0.0,0.0,0.0,0.0,0.0
2024,5,20,1,2024-05-20,B6,1331,EWR,MIA,"Newark, NJ",New Jersey,"Miami, FL",Florida,801,916,-13,-15,788,901,25,7,813,894,2410,296,316,328,0,,0,0.0,0.0,0.0,0.0,0.0
2024,6,21,5,2024-06-21,G4,1797,DTW,ATL,"Detroit, MI",Michigan,"Atlanta, GA",Georgia,1953,2296,-4,-5,1949,2291,12,11,1961,2280,301,32,52,55,0,,0,0.0,0.0,0.0,0.0,0.0
2024,1,10,3,2024-01-10,MQ,3470,SFO,SAN,"San Francisco, CA",California,"San Diego, CA",California,1871,1867,18,10,1889,1877,12,5,1901,1872,773,87,107,104,0,,0,0.0,0.0,0.0,0.0,0.0
2024,8,15,4,2024-08-15,AA,1645,HNL,IAH,"Honolulu, HI",Hawaii,"Houston, TX",Texas,1630,1717,1,-5,1631,1712,6,7,1637,1705,572,68,88,81,0,,0,0.0,0.0,0.0,0.0,0.0
2024,9,21,6,2024-09-21,G4,1537,SLC,DCA,"Salt Lake City, UT",Utah,"Washington, DC",District of Columbia,1027,2175,5,0,1032,2175,13,18,1045,2157,2904,371,391,402,0,,0,0.0,0.0,0.0,0.0,0.0
2024,9,4,3,2024-09-04,HA,8662,MIA,PHX,"Miami, FL",Florida,"Phoenix, AZ",Arizona,2274,1903,-9,-15,2265,1888,10,15,2275,1873,1513,198,218,223,0,,0,0.0,0.0,0.0,0.0,0.0
2024,9,3,2,2024-09-03,WN,4604,MSP,SEA,"Minneapolis, MN",Minnesota,"Seattle, WA",Washington,1929,1715,0,5,1929,1720,23,13,1952,1707,1668,198,218,234,0,,0,0.0,0.0,0.0,0.0,0.0
2024,6,3,1,2024-06-03,WN,5602,MIA,PHL,"Miami, FL",Florida,"Philadelphia, PA",Pennsylvania,2257,1412,-8,-15,2249,1397,5,19,2254,1378,2721,345,365,369,0,,0,0.0,0.0,0.0,0.0,0.0
2024,2,3,6,2024-02-03,HA,7708,STL,MSP,"St. Louis, MO",Missouri,"Minneapolis, MN",Minnesota,1451,637,10,10,1461,647,29,6,1490,641,261,24,44,59,0,,0,0.0,0.0,0.0,0.0,0.0
2024,5,8,3,2024-05-08,WN,6097,JFK,HNL,"New York, NY",New York,"Honolulu, HI",Hawaii,755,1012,-14,-15,741,997,23,19,764,978,2861,357,377,399,0,,0,0.0,0.0,0.0,0.0,0.0
2024,6,8,6,2024-06-08,9E,5666,ORD,LGA,"Chicago, IL",Illinois,"New York, NY",New York,1824,842,16,10,1840,852,5,3,1845,849,294,41,61,49,0,,0,0.0,0.0,0.0,0.0,0.0
2024,3,29,5,2024-03-29,YX,7886,DCA,SEA,"Washington, DC",District of Columbia,"Seattle, WA",Washington,1453,1987,-14,-5,1439,1982,25,8,1464,1974,2513,308,328,341,0,,0,0.0,0.0,0.0,0.0,0.0
2024,4,2,2,2024-04-02,G4,8908,PHL,BWI,"Philadelphia, PA",Pennsylvania,"Baltimore, MD",Maryland,1423,2271,2,0,1425,2271,28,3,1453,2268,633,84,104,115,0,,0,0.0,0.0,0.0,0.0,0.0
2024,11,22,5,2024-11-22,OH,4266,IAH,ORD,"Houston, TX",Texas,"Chicago, IL",Illinois,1668,1687,18,10,1686,1697,17,9,1703,1688,2126,268,288,294,0,,0,0.0,0.0,0.0,0.0,0.0
2024,8,28,3,2024-08-28,AS,4114,SFO,HNL,"San Francisco, CA",California,"Honolulu, HI",Hawaii,2199,1454,-12,-20,2187,1434,11,13,2198,1421,1137,145,165,169,0,,0,0.0,0.0,0.0,0.0,0.0
2024,11,18,1,2024-11-18,OO,2356,ORD,IAH,"Chicago, IL",Illinois,"Houston, TX",Texas,2047,800,-17,-10,2030,790,25,12,2055,778,512,63,83,100,0,,0,0.0,0.0,0.0,0.0,0.0
2024,4,26,5,2024-04-26,F9,4454,EWR,MCO,"Newark, NJ",New Jersey,"Orlando, FL",Florida,1061,906,5,15,1066,921,17,12,1083,909,872,115,135,144,0,,0,0.0,0.0,0.0,0.0,0.0
2024,4,3,3,2024-04-03,YX,3410,CLT,HNL,"Charlotte, NC",North Carolina,"Honolulu, HI",Hawaii,859,774,-14,-5,845,769,22,4,867,765,438,60,80,86,0,,0,0.0,0.0,0.0,0.0,0.0
2024,6,11,2,2024-06-11,OH,7499,IAH,LGA,"Houston, TX",Texas,"New York, NY",New York,2047,2312,12,5,2059,2317,6,3,2065,2314,945,115,135,124,0,,0,0.0,0.0,0.0,0.0,0.0
2024,4,8,1,2024-04-08,WN,1031,LAS,CLT,"Las Vegas, NV",Nevada,"Charlotte, NC",North Carolina,2007,1571,-14,-15,1993,1556,7,16,2000,1540,2986,377,397,400,0,,0,0.0,0.0,0.0,0.0,0.0
2024,4,22,1,2024-04-22,UA,2429,EWR,SAN,"Newark, NJ",New Jersey,"San Diego, CA",California,1713,1615,3,5,1716,1620,10,14,1726,1606,1150,134,154,158,0,,0,0.0,0.0,0.0,0.0,0.0
2024,12,24,2,2024-12-24,OH,493,SAN,IAH,"San Diego, CA",California,"Houston, TX",Texas,795,1593,-21,-15,774,1578,17,17,791,1561,372,46,66,80,0,,0,0.0,0.0,0.0,0.0,0.0
2024,3,31,7,2024-03-31,AA,2565,HNL,ATL,"Honolulu, HI",Hawaii,"Atlanta, GA",Georgia,592,1196,10,5,602,1201,24,19,626,1182,1005,121,141,164,0,,0,0.0,0.0,0.0,0.0,0.0
2024,12,11,3,2024-12-11,9E,3377,IAD,LAX,"Washington, DC",District of Columbia,"Los Angeles, CA",California,1653,1271,-12,-5,1641,1266,13,11,1654,1255,1370,171,191,195,0,,0,0.0,0.0,0.0,0.0,0.0
2024,7,24,3,2024-07-24,HA,5530,TPA,MSP,"Tampa, FL",Florida,"Minneapolis, MN",Minnesota,1360,1293,9,0,1369,1293,7,3,1376,1290,2727,343,363,353,0,,0,0.0,0.0,0.0,0.0,0.0
2024,1,17,3,2024-01-17,HA,7102,LGA,SFO,"New York, NY",New York,"San Francisco, CA",California,1489,1147,-18,-10,1471,1137,26,3,1497,1134,2601,331,351,360,0,,0,0.0,0.0,0.0,0.0,0.0
2024,9,30,1,2024-09-30,NK,8917,IAD,TPA,"Washington, DC",District of Columbia,"Tampa, FL",Florida,983,1722,7,0,990,1722,19,11,1009,1711,517,60,80,90,0,,0,0.0,0.0,0.0,0.0,0.0
2024,6,21,5,2024-06-21,WN,6088,BOS,EWR,"Boston, MA",Massachusetts,"Newark, NJ",New Jersey,1375,1849,-8,-5,1367,1844,8,8,1375,1836,2994,365,385,381,0,,0,0.0,0.0,0.0,0.0,0.0
2024,4,25,4,2024-04-25,OH,7609,SLC,HNL,"Salt Lake City, UT",Utah,"Honolulu, HI",Hawaii,1932,1148,-14,-5,1918,1143,21,5,1939,1138,1108,134,154,160,0,,0,0.0,0.0,0.0,0.0,0.0
2024,12,14,6,2024-12-14,F9,6032,ORD,SEA,"Chicago, IL",Illinois,"Seattle, WA",Washington,840,872,6,5,846,877,21,6,867,871,1008,133,153,160,0,,1,0.0,0.0,0.0,0.0,0.0
2024,6,29,6,2024-06-29,OH,9457,SLC,BWI,"Salt Lake City, UT",Utah,"Baltimore, MD",Maryland,1737,1575,-20,-10,1717,1565,17,13,1734,1552,1790,232,252,262,0,,0,0.0,0.0,0.0,0.0,0.0
2024,3,31,7,2024-03-31,UA,2881,LAX,IAD,"Los Angeles, CA",California,"Washington, DC",District of Columbia,829,1383,17,10,846,1393,15,19,861,1374,918,104,124,138,0,,0,0.0,0.0,0.0,0.0,0.0
2024,3,22,5,2024-03-22,AA,1739,LGA,EWR,"New York, NY",New York,"Newark, NJ",New Jersey,1298,1809,4,5,1302,1814,12,5,1314,1809,2646,322,342,339,0,,0,0.0,0.0,0.0,0.0,0.0
2024,11,19,2,2024-11-19,B6,9073,ATL,PDX,"Atlanta, GA",Georgia,"Portland, OR",Oregon,1698,1539,-3,0,1695,1539,7,4,1702,1535,555,64,84,75,0,,0,0.0,0.0,0.0,0.0,0.0
2024,4,23,2,2024-04-23,OH,2374,LAS,MSP,"Las Vegas, NV",Nevada,"Minneapolis, MN",Minnesota,1967,1051,-22,-15,1945,1036,22,6,1967,1030,295,44,64,72,0,,0,0.0,0.0,0.0,0.0,0.0
2024,9,13,5,2024-09-13,DL,2580,JFK,MDW,"New York, NY",New York,"Chicago, IL",Illinois,700,1160,12,5,712,1165,5,13,717,1152,2389,290,310,308,1,,0,0.0,0.0,0.0,0.0,0.0
2024,2,27,2,2024-02-27,UA,6899,ATL,TPA,"Atlanta, GA",Georgia,"Tampa, FL",Florida,2140,2128,-28,-20,2112,2108,12,5,2124,2103,739,97,117,114,0,,0,0.0,0.0,0.0,0.0,0.0
2024,6,2,7,2024-06-02,OH,8647,ATL,PDX,"Atlanta, GA",Georgia,"Portland, OR",Oregon,1242,693,2,10,1244,703,13,9,1257,694,1922,242,262,264,0,,0,0.0,0.0,0.0,0.0,0.0
2024,12,30,1,2024-12-30,AS,4774,LAS,DTW,"Las Vegas, NV",Nevada,"Detroit, MI",Michigan,597,1930,-4,-5,593,1925,21,8,614,1917,2233,282,302,311,0,,0,0.0,0.0,0.0,0.0,0.0
2024,4,25,4,2024-04-25,UA,3622,PDX,EWR,"Portland, OR",Oregon,"Newark, NJ",New Jersey,1626,1116,-7,-15,1619,1101,12,18,1631,1083,2858,356,376,386,0,,0,0.0,0.0,0.0,0.0,0.0
2024,12,8,7,2024-12-08,UA,6204,DTW,IAH,"Detroit, MI",Michigan,"Houston, TX",Texas,2076,1553,-4,-10,2072,1543,15,13,2087,1530,2157,271,291,299,0,,0,0.0,0.0,0.0,0.0,0.0
2024,9,22,7,2024-09-22,YX,5919,MDW,JFK,"Chicago, IL",Illinois,"New York, NY",New York,1674,773,26,20,1700,793,5,3,1705,790,1705,208,228,216,0,,0,4.0,2.0,1.0,0.0,13.0
2024,11,10,7,2024-11-10,AS,263,PHX,BWI,"Phoenix, AZ",Arizona,"Baltimore, MD",Maryland,1791,1294,-2,5,1789,1299,6,10,1795,1289,2384,300,320,316,0,,0,0.0,0.0,0.0,0.0,0.0
2024,7,21,7,2024-07-21,B6,7022,BWI,HNL,"Baltimore, MD",Maryland,"Honolulu, HI",Hawaii,1338,1696,-14,-10,1324,1686,19,6,1343,1680,2103,269,289,294,0,,0,0.0,0.0,0.0,0.0,0.0
2024,2,10,6,2024-02-10,9E,3481,SEA,TPA,"Seattle, WA",Washington,"Tampa, FL",Florida,851,1768,16,20,867,1788,21,5,888,1783,475,66,86,92,0,,0,1.0,0.0,0.0,0.0,19.0
2024,4,14,7,2024-04-14,G4,2164,BWI,BOS,"Baltimore, MD",Maryland,"Boston, MA",Massachusetts,966,1507,-19,-15,947,1492,19,15,966,1477,1513,182,202,216,0,,0,0.0,0.0,0.0,0.0,0.0
2024,7,11,4,2024-07-11,AA,6689,BOS,CLT,"Boston, MA",Massachusetts,"Charlotte, NC",North Carolina,1801,2287,2,5,1803,2292,22,8,1825,2284,942,123,143,153,0,,0,0.0,0.0,0.0,0.0,0.0
2024,10,4,5,2024-10-04,MQ,7547,EWR,IAD,"Newark, NJ",New Jersey,"Washington, DC",District of Columbia,2091,655,13,5,2104,660,16,5,2120,655,2316,284,304,305,0,,0,0.0,0.0,0.0,0.0,0.0
2024,12,19,4,2024-12-19,UA,4084,SEA,DEN,"Seattle, WA",Washington,"Denver, CO",Colorado,1539,1294,8,10,1547,1304,18,16,1565,1288,355,49,69,83,0,,0,0.0,0.0,0.0,0.0,0.0
2024,8,24,6,2024-08-24,UA,3987,HNL,PHX,"Honolulu, HI",Hawaii,"Phoenix, AZ",Arizona,955,1233,-7,-5,948,1228,16,9,964,1219,2428,304,324,329,0,,0,0.0,0.0,0.0,0.0,0.0
2024,8,8,4,2024-08-08,OO,439,PHL,IAH,"Philadelphia, PA",Pennsylvania,"Houston, TX",Texas,2257,843,-2,-5,2255,838,6,6,2261,832,2923,364,384,376,0,,0,0.0,0.0,0.0,0.0,0.0
2024,3,8,5,2024-03-08,AS,4921,ORD,MDW,"Chicago, IL",Illinois,"Chicago, IL",Illinois,1702,1493,7,0,1709,1493,25,15,1734,1478,1893,238,258,278,0,,0,0.0,0.0,0.0,0.0,0.0
2024,7,15,1,2024-07-15,F9,3881,PHL,LAS,"Philadelphia, PA",Pennsylvania,"Las Vegas, NV",Nevada,1657,803,-7,-5,1650,798,20,13,1670,785,1462,187,207,220,0,,0,0.0,0.0,0.0,0.0,0.0
2024,9,12,4,2024-09-12,UA,3690,JFK,HNL,"New York, NY",New York,"Honolulu, HI",Hawaii,757,2214,-26,-20,731,2194,23,12,754,2182,1250,165,185,200,0,,0,0.0,0.0,0.0,0.0,0.0
2024,5,18,6,2024-05-18,UA,5230,PDX,SEA,"Portland, OR",Oregon,"Seattle, WA",Washington,561,615,2,5,563,620,5,18,568,602,2225,268,288,291,0,,0,0.0,0.0,0.0,0.0,0.0
2024,11,7,4,2024-11-07,AS,7791,DEN,LGA,"Denver, CO",Colorado,"New York, NY",New York,981,725,-7,0,974,725,6,13,980,712,1987,244,264,263,0,,0,0.0,0.0,0.0,0.0,0.0
2024,5,28,2,2024-05-28,F9,9937,CLT,LGA,"Charlotte, NC",North Carolina,"New York, NY",New York,2000,1198,4,-5,2004,1193,16,16,2020,1177,1874,227,247,259,0,,0,0.0,0.0,0.0,0.0,0.0
2024,4,8,1,2024-04-08,AS,7415,MIA,BWI,"Miami, FL",Florida,"Baltimore, MD",Maryland,1499,1065,-2,-5,1497,1060,8,10,1505,1050,2136,268,288,286,0,,0,0.0,0.0,0.0,0.0,0.0
2024,3,16,6,2024-03-16,MQ,7833,HNL,DEN,"Honolulu, HI",Hawaii,"Denver, CO",Colorado,1134,1389,1,-5,1135,1384,11,10,1146,1374,2881,358,378,379,0,,0,0.0,0.0,0.0,0.0,0.0
2024,10,8,2,2024-10-08,YX,5149,PHL,ATL,"Philadelphia, PA",Pennsylvania,"Atlanta, GA",Georgia,1565,2051,10,5,1575,2056,21,8,1596,2048,2937,376,396,405,0,,0,0.0,0.0,0.0,0.0,0.0
2024,4,18,4,2024-04-18,OH,4804,PHX,LAX,"Phoenix, AZ",Arizona,"Los Angeles, CA",California,1896,1974,3,5,1899,1979,9,3,1908,1976,819,102,122,114,0,,0,0.0,0.0,0.0,0.0,0.0
2024,7,6,6,2024-07-06,9E,738,PHX,IAH,"Phoenix, AZ",Arizona,"Houston, TX",Texas,1896,2178,4,10,1900,2188,6,8,1906,2180,2279,274,294,288,0,,0,0.0,0.0,0.0,0.0,0.0
2024,7,17,3,2024-07-17,UA,7809,MCO,STL,"Orlando, FL",Florida,"St. Louis, MO",Missouri,1822,678,-1,5,1821,683,17,16,1838,667,2420,301,321,334,0,,0,0.0,0.0,0.0,0.0,0.0
2024,10,29,2,2024-10-29,WN,5243,BWI,TPA,"Baltimore, MD",Maryland,"Tampa, FL",Florida,1575,2124,0,5,1575,2129,12,8,1587,2121,1753,223,243,243,0,,0,0.0,0.0,0.0,0.0,0.0
2024,11,22,5,2024-11-22,AA,1324,EWR,MIA,"Newark, NJ",New Jersey,"Miami, FL",Florida,1902,1388,-15,-10,1887,1378,22,17,1909,1361,2653,340,360,379,0,,0,0.0,0.0,0.0,0.0,0.0
2024,6,2,7,2024-06-02,MQ,4345,HNL,PHL,"Honolulu, HI",Hawaii,"Philadelphia, PA",Pennsylvania,1415,2002,-18,-15,1397,1987,8,17,1405,1970,227,19,39,44,0,,0,0.0,0.0,0.0,0.0,0.0
2024,2,9,5,2024-02-09,F9,9841,LAX,IAD,"Los Angeles, CA",California,"Washington, DC",District of Columbia,811,863,10,5,821,868,10,14,831,854,2523,322,342,346,0,,0,0.0,0.0,0.0,0.0,0.0
2024,5,12,7,2024-05-12,WN,5523,PHX,SLC,"Phoenix, AZ",Arizona,"Salt Lake City, UT",Utah,1078,904,-12,-15,1066,889,13,13,1079,876,1639,205,225,231,0,,0,0.0,0.0,0.0,0.0,0.0
2024,5,11,6,2024-05-11,AS,6707,DEN,SEA,"Denver, CO",Colorado,"Seattle, WA",Washington,558,2111,20,30,578,2141,14,4,592,2137,2556,323,343,341,0,,0,4.0,1.0,0.0,0.0,25.0
2024,10,5,6,2024-10-05,OO,7507,PHX,MIA,"Phoenix, AZ",Arizona,"Miami, FL",Florida,803,1339,15,10,818,1349,8,4,826,1345,1650,213,233,225,0,,0,0.0,0.0,0.0,0.0,0.0
2024,12,27,5,2024-12-27,UA,9797,JFK,MDW,"New York, NY",New York,"Chicago, IL",Illinois,534,724,4,0,538,724,8,14,546,710,1323,155,175,177,0,,0,0.0,0.0,0.0,0.0,0.0
2024,3,24,7,2024-03-24,OO,8173,PDX,LAS,"Portland, OR",Oregon,"Las Vegas, NV",Nevada,1147,1217,-11,-5,1136,1212,11,8,1147,1204,964,124,144,143,0,,0,0.0,0.0,0.0,0.0,0.0
2024,8,29,4,2024-08-29,YX,8252,EWR,DTW,"Newark, NJ",New Jersey,"Detroit, MI",Michigan,1510,1341,-2,0,1508,1341,18,8,1526,1333,286,37,57,63,0,,0,0.0,0.0,0.0,0.0,0.0
2024,4,25,4,2024-04-25,OO,9667,DCA,ATL,"Washington, DC",District of Columbia,"Atlanta, GA",Georgia,2111,2269,-3,5,2108,2274,16,14,2124,2260,2345,291,311,321,0,,0,0.0,0.0,0.0,0.0,0.0
2024,4,18,4,2024-04-18,AS,8959,DFW,PDX,"Dallas/Fort Worth, TX",Texas,"Portland, OR",Oregon,2277,680,1,5,2278,685,19,6,2297,679,1687,215,235,240,0,,0,0.0,0.0,0.0,0.0,0.0
2024,8,8,4,2024-08-08,YX,5868,HNL,ATL,"Honolulu, HI",Hawaii,"Atlanta, GA",Georgia,992,1471,-19,-15,973,1456,21,9,994,1447,1208,157,177,187,0,,0,0.0,0.0,0.0,0.0,0.0
2024,2,10,6,2024-02-10,OO,2474,CLT,EWR,"Charlotte, NC",North Carolina,"Newark, NJ",New Jersey,990,2244,15,10,1005,2254,25,14,1030,2240,1265,165,185,204,0,,0,0.0,0.0,0.0,0.0,0.0
2024,5,26,7,2024-05-26,G4,4190,DEN,DTW,"Denver, CO",Colorado,"Detroit, MI",Michigan,720,774,-8,0,712,774,25,11,737,763,2836,355,375,391,0,,0,0.0,0.0,0.0,0.0,0.0
2024,4,21,7,2024-04-21,G4,1115,MDW,LAX,"Chicago, IL",Illinois,"Los Angeles, CA",California,2120,1275,-16,-20,2104,1255,17,9,2121,1246,2726,330,350,356,0,,0,0.0,0.0,0.0,0.0,0.0
2024,4,12,5,2024-04-12,9E,435,BOS,SFO,"Boston, MA",Massachusetts,"San Francisco, CA",California,622,1748,-9,-5,613,1743,5,18,618,1725,2229,280,300,303,0,,0,0.0,0.0,0.0,0.0,0.0
2024,2,15,4,2024-02-15,UA,180,SEA,LGA,"Seattle, WA",Washington,"New York, NY",New York,1206,947,-8,0,1198,947,26,17,1224,930,2743,339,359,382,0,,0,0.0,0.0,0.0,0.0,0.0
2024,11,19,2,2024-11-19,UA,2234,BOS,MCO,"Boston, MA",Massachusetts,"Orlando, FL",Florida,1625,1990,-5,-10,1620,1980,17,5,1637,1975,2017,253,273,275,0,,0,0.0,0.0,0.0,0.0,0.0
2024,9,27,5,2024-09-27,WN,357,STL,ORD,"St. Louis, MO",Missouri,"Chicago, IL",Illinois,1386,2158,-15,-10,1371,2148,20,8,1391,2140,415,57,77,85,0,,0,0.0,0.0,0.0,0.0,0.0
2024,7,13,6,2024-07-13,YX,284,PHL,SEA,"Philadelphia, PA",Pennsylvania,"Seattle, WA",Washington,2038,2038,-23,-20,2015,2018,17,16,2032,2002,1187,146,166,179,0,,0,0.0,0.0,0.0,0.0,0.0
2024,10,6,7,2024-10-06,NK,6941,MDW,SAN,"Chicago, IL",Illinois,"San Diego, CA",California,1836,1477,20,15,1856,1492,13,10,1869,1482,2182,275,295,298,0,,1,0.0,0.0,0.0,0.0,0.0
2024,10,9,3,2024-10-09,UA,222,SAN,CLT,"San Diego, CA",California,"Charlotte, NC",North Carolina,2029,1442,-20,-15,2009,1427,27,6,2036,1421,680,90,110,123,0,,0,0.0,0.0,0.0,0.0,0.0
2024,2,9,5,2024-02-09,9E,8156,STL,ORD,"St. Louis, MO",Missouri,"Chicago, IL",Illinois,993,1173,0,-5,993,1168,22,15,1015,1153,1823,234,254,271,0,,0,0.0,0.0,0.0,0.0,0.0
2024,7,7,7,2024-07-07,F9,7363,SAN,BOS,"San Diego, CA",California,"Boston, MA",Massachusetts,1258,1323,-19,-10,1239,1313,20,7,1259,1306,1337,175,195,202,0,,0,0.0,0.0,0.0,0.0,0.0
2024,6,12,3,2024-06-12,OO,4800,CLT,DEN,"Charlotte, NC",North Carolina,"Denver, CO",Colorado,2183,1875,-5,5,2178,1880,24,13,2202,1867,522,64,84,101,0,,0,0.0,0.0,0.0,0.0,0.0
2024,1,24,3,2024-01-24,F9,6758,SEA,BWI,"Seattle, WA",Washington,"Baltimore, MD",Maryland,1722,1207,13,5,1735,1212,16,7,1751,1205,2180,265,285,288,0,,0,0.0,0.0,0.0,0.0,0.0
2024,1,24,3,2024-01-24,AS,3614,SAN,SLC,"San Diego, CA",California,"Salt Lake City, UT",Utah,1132,2344,13,10,1145,2354,12,19,1157,2335,2805,342,362,373,0,,0,0.0,0.0,0.0,0.0,0.0
2024,1,4,4,2024-01-04,WN,5733,SLC,DEN,"Salt Lake City, UT",Utah,"Denver, CO",Colorado,2204,1168,8,0,2212,1168,5,4,2217,1164,1269,149,169,158,0,,0,0.0,0.0,0.0,0.0,0.0
2024,11,18,1,2024-11-18,OO,6177,IAH,SAN,"Houston, TX",Texas,"San Diego, CA",California,2036,833,-7,0,2029,833,17,7,2046,826,838,98,118,122,0,,0,0.0,0.0,0.0,0.0,0.0
2024,10,16,3,2024-10-16,YX,1494,PHL,MCO,"Philadelphia, PA",Pennsylvania,"Orlando, FL",Florida,829,957,-14,-5,815,952,26,10,841,942,700,94,114,130,0,,0,0.0,0.0,0.0,0.0,0.0
2024,6,29,6,2024-06-29,OO,2452,PHL,EWR,"Philadelphia, PA",Pennsylvania,"Newark, NJ",New Jersey,2144,1949,-9,0,2135,1949,23,8,2158,1941,1295,164,184,195,0,,0,0.0,0.0,0.0,0.0,0.0
2024,9,4,3,2024-09-04,B6,9600,DFW,MIA,"Dallas/Fort Worth, TX",Texas,"Miami, FL",Florida,1471,1688,-14,-15,1457,1673,17,10,1474,1663,1715,205,225,232,0,,0,0.0,0.0,0.0,0.0,0.0
2024,4,25,4,2024-04-25,YX,6061,LAS,BOS,"Las Vegas, NV",Nevada,"Boston, MA",Massachusetts,1850,892,5,5,1855,897,7,4,1862,893,1109,129,149,140,0,,0,0.0,0.0,0.0,0.0,0.0
2024,10,5,6,2024-10-05,DL,4044,JFK,SAN,"New York, NY",New York,"San Diego, CA",California,509,1947,-8,-15,501,1932,5,10,506,1922,2121,268,288,283,0,,0,0.0,0.0,0.0,0.0,0.0
2024,12,30,1,2024-12-30,MQ,6505,TPA,DFW,"Tampa, FL",Florida,"Dallas/Fort Worth, TX",Texas,626,1590,18,10,644,1600,18,9,662,1591,1734,206,226,233,0,,0,0.0,0.0,0.0,0.0,0.0
2024,3,9,6,2024-03-09,AS,590,PDX,DFW,"Portland, OR",Oregon,"Dallas/Fort Worth, TX",Texas,1484,1954,6,0,1490,1954,28,10,1518,1944,2381,300,320,338,0,,0,0.0,0.0,0.0,0.0,0.0
2024,12,16,1,2024-12-16,UA,1154,DFW,PHL,"Dallas/Fort Worth, TX",Texas,"Philadelphia, PA",Pennsylvania,1168,1128,-7,0,1161,1128,25,9,1186,1119,2308,288,308,322,0,,0,0.0,0.0,0.0,0.0,0.0
2024,9,10,2,2024-09-10,HA,801,BOS,DTW,"Boston, MA",Massachusetts,"Detroit, MI",Michigan,730,734,1,0,731,734,5,17,736,717,1899,241,261,263,0,,0,0.0,0.0,0.0,0.0,0.0
2024,6,29,6,2024-06-29,AS,3034,ORD,CLT,"Chicago, IL",Illinois,"Charlotte, NC",North Carolina,1538,1419,-3,5,1535,1424,9,11,1544,1413,1675,206,226,226,0,,0,0.0,0.0,0.0,0.0,0.0
2024,11,13,3,2024-11-13,YX,5487,BOS,SFO,"Boston, MA",Massachusetts,"San Francisco, CA",California,986,2042,5,0,991,2042,9,16,1000,2026,2115,263,283,288,0,,0,0.0,0.0,0.0,0.0,0.0
2024,6,17,1,2024-06-17,B6,6137,EWR,DCA,"Newark, NJ",New Jersey,"Washington, DC",District of Columbia,941,729,-12,-5,929,724,15,15,944,709,2491,303,323,333,0,,0,0.0,0.0,0.0,0.0,0.0
2024,11,8,5,2024-11-08,OH,4795,IAD,MSP,"Washington, DC",District of Columbia,"Minneapolis, MN",Minnesota,1377,2172,-15,-10,1362,2162,29,5,1391,2157,2007,257,277,291,0,,0,0.0,0.0,0.0,0.0,0.0
2024,9,5,4,2024-09-05,DL,9426,BWI,MCO,"Baltimore, MD",Maryland,"Orlando, FL",Florida,2081,1168,-25,-15,2056,1153,23,8,2079,1145,2567,310,330,341,0,,0,0.0,0.0,0.0,0.0,0.0
2024,7,6,6,2024-07-06,HA,8371,CLT,MDW,"Charlotte, NC",North Carolina,"Chicago, IL",Illinois,773,1980,-16,-10,757,1970,16,6,773,1964,831,100,120,122,0,,0,0.0,0.0,0.0,0.0,0.0
2024,2,23,5,2024-02-23,YX,9127,IAD,DCA,"Washington, DC",District of Columbia,"Washington, DC",District of Columbia,1117,1121,-21,-20,1096,1101,29,13,1125,1088,975,113,133,155,0,,0,0.0,0.0,0.0,0.0,0.0
2024,11,21,4,2024-11-21,MQ,8943,IAD,HNL,"Washington, DC",District of Columbia,"Honolulu, HI",Hawaii,1526,1059,13,10,1539,1069,12,9,1551,1060,2087,250,270,271,0,,0,0.0,0.0,0.0,0.0,0.0
2024,12,22,7,2024-12-22,OH,516,IAD,LAX,"Washington, DC",District of Columbia,"Los Angeles, CA",California,825,1192,-1,5,824,1197,14,17,838,1180,1642,201,221,232,0,,0,0.0,0.0,0.0,0.0,0.0
2024,11,8,5,2024-11-08,B6,5666,IAD,EWR,"Washington, DC",District of Columbia,"Newark, NJ",New Jersey,752,1541,-11,-10,741,1531,22,13,763,1518,2271,283,303,318,0,,0,0.0,0.0,0.0,0.0,0.0
2024,5,17,5,2024-05-17,B6,5273,IAH,MSP,"Houston, TX",Texas,"Minneapolis, MN",Minnesota,2057,2225,-22,-20,2035,2205,13,11,2048,2194,820,95,115,119,0,,0,0.0,0.0,0.0,0.0,0.0
2024,6,16,7,2024-06-16,OH,6099,MSP,SAN,"Minneapolis, MN",Minnesota,"San Diego, CA",California,1578,1500,2,0,1580,1500,15,8,1595,1492,814,108,128,131,0,,0,0.0,0.0,0.0,0.0,0.0
2024,4,12,5,2024-04-12,G4,3966,PDX,DEN,"Portland, OR",Oregon,"Denver, CO",Colorado,1385,2255,1,-5,1386,2250,9,9,1395,2241,1385,173,193,191,0,,0,0.0,0.0,0.0,0.0,0.0
2024,3,25,1,2024-03-25,OO,9037,MDW,SFO,"Chicago, IL",Illinois,"San Francisco, CA",California,947,1213,13,5,960,1218,28,10,988,1208,2636,319,339,357,0,,0,0.0,0.0,0.0,0.0,0.0
2024,11,12,2,2024-11-12,F9,2102,MSP,PHL,"Minneapolis, MN",Minnesota,"Philadelphia, PA",Pennsylvania,1820,2118,4,-5,1824,2113,17,14,1841,2099,2028,253,273,284,0,,0,0.0,0.0,0.0,0.0,0.0
2024,7,30,2,2024-07-30,YX,339,ORD,MDW,"Chicago, IL",Illinois,"Chicago, IL",Illinois,2145,1138,0,10,2145,1148,17,16,2162,1132,280,33,53,66,0,,0,0.0,0.0,0.0,0.0,0.0
2024,1,3,3,2024-01-03,YX,2044,MCO,PHL,"Orlando, FL",Florida,"Philadelphia, PA",Pennsylvania,872,860,-17,-15,855,845,28,9,883,836,1627,194,214,231,0,,0,0.0,0.0,0.0,0.0,0.0
2024,6,27,4,2024-06-27,NK,6661,IAH,LAS,"Houston, TX",Texas,"Las Vegas, NV",Nevada,2258,2196,2,-5,2260,2191,8,4,2268,2187,2903,360,380,372,0,,0,0.0,0.0,0.0,0.0,0.0
2024,12,7,6,2024-12-07,HA,9147,MIA,DEN,"Miami, FL",Florida,"Denver, CO",Colorado,968,1759,9,15,977,1774,21,13,998,1761,1074,143,163,177,0,,0,0.0,0.0,0.0,0.0,0.0
2024,10,29,2,2024-10-29,HA,5967,SAN,PDX,"San Diego, CA",California,"Portland, OR",Oregon,1259,1208,-17,-20,1242,1188,18,13,1260,1175,798,102,122,133,0,,0,0.0,0.0,0.0,0.0,0.0
2024,11,27,3,2024-11-27,YX,3294,ATL,JFK,"Atlanta, GA",Georgia,"New York, NY",New York,1659,2284,3,-5,1662,2279,13,10,1675,2269,1848,235,255,258,0,,0,0.0,0.0,0.0,0.0,0.0
2024,2,7,3,2024-02-07,MQ,7833,HNL,SAN,"Honolulu, HI",Hawaii,"San Diego, CA",California,1332,1850,-6,-10,1326,1840,26,8,1352,1832,1291,159,179,193,0,,0,0.0,0.0,0.0,0.0,0.0
2024,8,26,1,2024-08-26,HA,6459,PHL,MCO,"Philadelphia, PA",Pennsylvania,"Orlando, FL",Florida,1769,827,-7,0,1762,827,6,13,1768,814,2615,330,350,349,0,,0,0.0,0.0,0.0,0.0,0.0
2024,6,17,1,2024-06-17,OH,7687,MIA,DEN,"Miami, FL",Florida,"Denver, CO",Colorado,569,1360,-17,-10,552,1350,8,13,560,1337,1139,141,161,162,0,,0,0.0,0.0,0.0,0.0,0.0
2024,12,8,7,2024-12-08,UA,4904,JFK,DFW,"New York, NY",New York,"Dallas/Fort Worth, TX",Texas,980,857,17,10,997,867,15,7,1012,860,926,106,126,128,0,,0,0.0,0.0,0.0,0.0,0.0
2024,11,9,6,2024-11-09,9E,1453,SAN,LGA,"San Diego, CA",California,"New York, NY",New York,1029,2037,22,15,1051,2052,14,12,1065,2040,2978,376,396,402,0,,0,0.0,0.0,0.0,0.0,0.0
2024,11,1,5,2024-11-01,WN,2980,PHL,MCO,"Philadelphia, PA",Pennsylvania,"Orlando, FL",Florida,989,1425,7,10,996,1435,9,3,1005,1432,420,42,62,54,0,,0,0.0,0.0,0.0,0.0,0.0
2024,1,30,2,2024-01-30,AS,779,STL,IAH,"St. Louis, MO",Missouri,"Houston, TX",Texas,1002,1843,-14,-5,988,1838,20,9,1008,1829,1428,179,199,208,0,,0,0.0,0.0,0.0,0.0,0.0
2024,7,8,1,2024-07-08,UA,8778,BOS,TPA,"Boston, MA",Massachusetts,"Tampa, FL",Florida,1508,1859,35,30,1543,1889,10,6,1553,1883,1716,223,243,239,0,,0,3.0,3.0,5.0,0.0,19.0
2024,12,22,7,2024-12-22,OO,3720,IAD,LAS,"Washington, DC",District of Columbia,"Las Vegas, NV",Nevada,2221,1643,8,5,2229,1648,9,15,2238,1633,682,78,98,102,0,,0,0.0,0.0,0.0,0.0,0.0
2024,1,25,4,2024-01-25,G4,9730,MCO,LAS,"Orlando, FL",Florida,"Las Vegas, NV",Nevada,616,1023,-15,-5,601,1018,17,17,618,1001,2820,354,374,388,0,,0,0.0,0.0,0.0,0.0,0.0
2024,4,21,7,2024-04-21,F9,4414,MCO,DEN,"Orlando, FL",Florida,"Denver, CO",Colorado,1780,1012,-9,-15,1771,997,13,18,1784,979,2640,329,349,360,0,,0,0.0,0.0,0.0,0.0,0.0
2024,7,24,3,2024-07-24,AS,6964,ATL,BWI,"Atlanta, GA",Georgia,"Baltimore, MD",Maryland,1106,2012,4,5,1110,2017,14,5,1124,2012,857,110,130,129,0,,0,0.0,0.0,0.0,0.0,0.0
2024,7,3,3,2024-07-03,WN,1584,LAS,EWR,"Las Vegas, NV",Nevada,"Newark, NJ",New Jersey,1418,944,10,5,1428,949,6,5,1434,944,1732,215,235,226,0,,0,0.0,0.0,0.0,0.0,0.0
2024,2,16,5,2024-02-16,NK,790,SEA,PHL,"Seattle, WA",Washington,"Philadelphia, PA",Pennsylvania,1403,1249,-23,-15,1380,1234,19,10,1399,1224,214,26,46,55,0,,0,0.0,0.0,0.0,0.0,0.0
2024,8,15,4,2024-08-15,MQ,8183,TPA,PHX,"Tampa, FL",Florida,"Phoenix, AZ",Arizona,927,1066,8,0,935,1066,16,18,951,1048,2527,319,339,353,0,,0,0.0,0.0,0.0,0.0,0.0
2024,2,8,4,2024-02-08,HA,6225,IAD,SEA,"Washington, DC",District of Columbia,"Seattle, WA",Washington,1638,788,30,30,1668,818,16,4,1684,814,1062,122,142,142,0,,0,3.0,5.0,5.0,0.0,17.0
2024,1,16,2,2024-01-16,OO,9304,CLT,HNL,"Charlotte, NC",North Carolina,"Honolulu, HI",Hawaii,993,2240,-1,-5,992,2235,7,9,999,2226,956,111,131,127,0,,0,0.0,0.0,0.0,0.0,0.0
2024,1,22,1,2024-01-22,UA,6768,LGA,PHL,"New York, NY",New York,"Philadelphia, PA",Pennsylvania,561,1991,2,-5,563,1986,19,3,582,1983,1398,170,190,192,0,,0,0.0,0.0,0.0,0.0,0.0
2024,7,31,3,2024-07-31,9E,2447,STL,DEN,"St. Louis, MO",Missouri,"Denver, CO",Colorado,996,2008,24,15,1020,2023,23,11,1043,2012,1936,245,265,279,0,,0,0.0,0.0,0.0,0.0,0.0
2024,11,5,2,2024-11-05,HA,3808,MSP,ORD,"Minneapolis, MN",Minnesota,"Chicago, IL",Illinois,1135,1721,-7,-15,1128,1706,17,11,1145,1695,834,110,130,138,0,,0,0.0,0.0,0.0,0.0,0.0
2024,5,28,2,2024-05-28,F9,6476,PHX,MSP,"Phoenix, AZ",Arizona,"Minneapolis, MN",Minnesota,579,1552,11,15,590,1567,7,14,597,1553,2711,335,355,356,0,,0,0.0,0.0,0.0,0.0,0.0
2024,8,28,3,2024-08-28,AA,8030,MIA,IAD,"Miami, FL",Florida,"Washington, DC",District of Columbia,2182,869,0,5,2182,874,17,14,2199,860,2727,338,358,369,0,,0,0.0,0.0,0.0,0.0,0.0
2024,9,28,6,2024-09-28,UA,737,LGA,PHX,"New York, NY",New York,"Phoenix, AZ",Arizona,984,1264,-7,-5,977,1259,26,7,1003,1252,1502,196,216,229,0,,0,0.0,0.0,0.0,0.0,0.0
2024,2,28,3,2024-02-28,OO,5966,MDW,JFK,"Chicago, IL",Illinois,"New York, NY",New York,1545,1841,-13,-15,1532,1826,28,13,1560,1813,1726,209,229,250,0,,0,0.0,0.0,0.0,0.0,0.0
2024,10,13,7,2024-10-13,B6,6893,STL,PHL,"St. Louis, MO",Missouri,"Philadelphia, PA",Pennsylvania,1094,620,-23,-20,1071,600,9,6,1080,594,1883,244,264,259,0,,0,0.0,0.0,0.0,0.0,0.0
2024,7,20,6,2024-07-20,B6,3108,LGA,DCA,"New York, NY",New York,"Washington, DC",District of Columbia,1847,1895,2,-5,1849,1890,15,18,1864,1872,756,88,108,121,0,,0,0.0,0.0,0.0,0.0,0.0
2024,2,1,4,2024-02-01,9E,7316,JFK,LAX,"New York, NY",New York,"Los Angeles, CA",California,2040,1313,-3,5,2037,1318,26,14,2063,1304,318,30,50,70,0,,0,0.0,0.0,0.0,0.0,0.0
2024,6,10,1,2024-06-10,OH,7472,MDW,DEN,"Chicago, IL",Illinois,"Denver, CO",Colorado,760,1783,-10,0,750,1783,21,4,771,1779,491,68,88,93,0,,0,0.0,0.0,0.0,0.0,0.0
2024,9,11,3,2024-09-11,DL,5700,BOS,MIA,"Boston, MA",Massachusetts,"Miami, FL",Florida,628,2115,12,5,640,2120,23,7,663,2113,2128,256,276,286,0,,0,0.0,0.0,0.0,0.0,0.0
2024,9,10,2,2024-09-10,9E,1499,TPA,MIA,"Tampa, FL",Florida,"Miami, FL",Florida,1125,1028,-2,5,1123,1033,24,10,1147,1023,2517,307,327,341,0,,0,0.0,0.0,0.0,0.0,0.0
2024,1,9,2,2024-01-09,F9,8103,STL,MCO,"St. Louis, MO",Missouri,"Orlando, FL",Florida,783,1175,7,0,790,1175,27,18,817,1157,1650,205,225,250,0,,0,0.0,0.0,0.0,0.0,0.0
2024,5,18,6,2024-05-18,B6,1605,MSP,DFW,"Minneapolis, MN",Minnesota,"Dallas/Fort Worth, TX",Texas,1570,1195,25,20,1595,1215,16,5,1611,1210,2580,321,341,342,0,,0,4.0,4.0,0.0,0.0,12.0
2024,1,10,3,2024-01-10,NK,5942,SFO,MIA,"San Francisco, CA",California,"Miami, FL",Florida,1711,1184,12,5,1723,1189,9,8,1732,1181,644,84,104,101,0,,0,0.0,0.0,0.0,0.0,0.0
2024,8,1,4,2024-08-01,HA,8541,IAH,ORD,"Houston, TX",Texas,"Chicago, IL",Illinois,518,2195,7,15,525,2210,21,6,546,2204,2584,330,350,357,0,,0,0.0,0.0,0.0,0.0,0.0
2024,9,29,7,2024-09-29,NK,5420,IAH,CLT,"Houston, TX",Texas,"Charlotte, NC",North Carolina,1098,1617,-7,-10,1091,1607,23,13,1114,1594,1117,142,162,178,0,,0,0.0,0.0,0.0,0.0,0.0
2024,11,19,2,2024-11-19,OH,8827,ORD,MDW,"Chicago, IL",Illinois,"Chicago, IL",Illinois,1153,1590,4,5,1157,1595,15,4,1172,1591,2892,357,377,376,0,,0,0.0,0.0,0.0,0.0,0.0
2024,2,17,6,2024-02-17,B6,6543,PHX,SAN,"Phoenix, AZ",Arizona,"San Diego, CA",California,1262,1258,-6,0,1256,1258,6,15,1262,1243,811,102,122,123,0,,0,0.0,0.0,0.0,0.0,0.0
2024,4,20,6,2024-04-20,F9,3649,EWR,CLT,"Newark, NJ",New Jersey,"Charlotte, NC",North Carolina,1337,1670,12,15,1349,1685,10,15,1359,1670,1026,125,145,150,0,,0,0.0,0.0,0.0,0.0,0.0
2024,6,1,6,2024-06-01,G4,7052,EWR,MIA,"Newark, NJ",New Jersey,"Miami, FL",Florida,1531,822,7,0,1538,822,25,15,1563,807,2023,251,271,291,0,,0,0.0,0.0,0.0,0.0,0.0
2024,5,2,4,2024-05-02,WN,8749,PHL,DFW,"Philadelphia, PA",Pennsylvania,"Dallas/Fort Worth, TX",Texas,1560,1559,-16,-10,1544,1549,7,14,1551,1535,1188,138,158,159,0,,0,0.0,0.0,0.0,0.0,0.0
2024,12,22,7,2024-12-22,WN,2838,HNL,DTW,"Honolulu, HI",Hawaii,"Detroit, MI",Michigan,2121,757,-4,-5,2117,752,19,11,2136,741,1427,170,190,200,0,,0,0.0,0.0,0.0,0.0,0.0
2024,4,11,4,2024-04-11,F9,3469,SEA,MIA,"Seattle, WA",Washington,"Miami, FL",Florida,571,1670,-17,-10,554,1660,22,3,576,1657,1770,216,236,241,0,,0,0.0,0.0,0.0,0.0,0.0
2024,8,28,3,2024-08-28,AA,4235,ORD,JFK,"Chicago, IL",Illinois,"New York, NY",New York,1904,1400,-9,-10,1895,1390,21,7,1916,1383,2507,316,336,344,0,,0,0.0,0.0,0.0,0.0,0.0
2024,11,16,6,2024-11-16,HA,8083,PHL,LGA,"Philadelphia, PA",Pennsylvania,"New York, NY",New York,1789,1321,2,0,1791,1321,19,6,1810,1315,2716,344,364,369,0,,0,0.0,0.0,0.0,0.0,0.0
2024,7,9,2,2024-07-09,WN,3511,BWI,DEN,"Baltimore, MD",Maryland,"Denver, CO",Colorado,1590,2156,13,10,1603,2166,6,6,1609,2160,537,69,89,81,0,,0,0.0,0.0,0.0,0.0,0.0
2024,8,4,7,2024-08-04,AS,5735,MDW,ORD,"Chicago, IL",Illinois,"Chicago, IL",Illinois,1152,1974,-7,-10,1145,1964,9,16,1154,1948,1526,185,205,210,0,,0,0.0,0.0,0.0,0.0,0.0
2024,2,20,2,2024-02-20,MQ,4169,SEA,MDW,"Seattle, WA",Washington,"Chicago, IL",Illinois,563,918,-2,-10,561,908,9,13,570,895,1326,161,181,183,0,,0,0.0,0.0,0.0,0.0,0.0
2024,10,18,5,2024-10-18,WN,6351,DTW,SFO,"Detroit, MI",Michigan,"San Francisco, CA",California,529,1854,9,10,538,1864,13,16,551,1848,272,43,63,72,0,,0,0.0,0.0,0.0,0.0,0.0
2024,3,21,4,2024-03-21,AS,3285,PHX,HNL,"Phoenix, AZ",Arizona,"Honolulu, HI",Hawaii,1056,897,-7,-5,1049,892,10,14,1059,878,1301,153,173,177,0,,0,0.0,0.0,0.0,0.0,0.0
2024,3,28,4,2024-03-28,B6,3338,LAS,MSP,"Las Vegas, NV",Nevada,"Minneapolis, MN",Minnesota,1145,1044,27,20,1172,1064,23,18,1195,1046,1725,221,241,262,0,,0,7.0,5.0,3.0,0.0,5.0
2024,7,12,5,2024-07-12,OH,8552,PDX,STL,"Portland, OR",Oregon,"St. Louis, MO",Missouri,1539,704,-4,-10,1535,694,14,17,1549,677,2691,329,349,360,0,,0,0.0,0.0,0.0,0.0,0.0
2024,4,13,6,2024-04-13,G4,5837,PHX,DFW,"Phoenix, AZ",Arizona,"Dallas/Fort Worth, TX",Texas,777,2261,-11,-5,766,2256,23,12,789,2244,2097,271,291,306,0,,0,0.0,0.0,0.0,0.0,0.0
2024,9,27,5,2024-09-27,9E,9539,PHL,HNL,"Philadelphia, PA",Pennsylvania,"Honolulu, HI",Hawaii,2254,1482,-24,-15,2230,1467,23,6,2253,1461,1786,229,249,258,0,,0,0.0,0.0,0.0,0.0,0.0
2024,4,5,5,2024-04-05,G4,2673,PDX,BWI,"Portland, OR",Oregon,"Baltimore, MD",Maryland,776,1922,44,45,820,1967,20,3,840,1964,1311,160,180,183,0,,0,0.0,5.0,4.0,1.0,35.0
2024,7,16,2,2024-07-16,WN,6953,DEN,DCA,"Denver, CO",Colorado,"Washington, DC",District of Columbia,720,1691,0,10,720,1701,16,10,736,1691,1108,129,149,155,0,,0,0.0,0.0,0.0,0.0,0.0
2024,1,1,1,2024-01-01,MQ,225,PHL,TPA,"Philadelphia, PA",Pennsylvania,"Tampa, FL",Florida,1716,1137,7,10,1723,1147,28,12,1751,1135,1386,166,186,206,0,,0,0.0,0.0,0.0,0.0,0.0
2024,6,15,6,2024-06-15,OH,9521,MCO,SFO,"Orlando, FL",Florida,"San Francisco, CA",California,1169,1272,-13,-10,1156,1262,13,9,1169,1253,2519,312,332,334,0,,0,0.0,0.0,0.0,0.0,0.0
2024,5,5,7,2024-05-05,WN,1406,LAX,DCA,"Los Angeles, CA",California,"Washington, DC",District of Columbia,1547,2243,15,20,1562,2263,7,4,1569,2259,2315,285,305,296,0,,0,1.0,2.0,3.0,0.0,14.0
2024,11,8,5,2024-11-08,YX,2201,CLT,SFO,"Charlotte, NC",North Carolina,"San Francisco, CA",California,1331,1400,9,15,1340,1415,21,4,1361,1411,2582,329,349,354,0,,0,0.0,0.0,0.0,0.0,0.0
2024,3,21,4,2024-03-21,F9,235,BOS,LGA,"Boston, MA",Massachusetts,"New York, NY",New York,640,1416,2,-5,642,1411,28,14,670,1397,1254,159,179,201,0,,0,0.0,0.0,0.0,0.0,0.0
2024,9,7,6,2024-09-07,9E,7411,IAH,DCA,"Houston, TX",Texas,"Washington, DC",District of Columbia,1233,2219,1,5,1234,2224,14,14,1248,2210,2376,287,307,315,0,,0,0.0,0.0,0.0,0.0,0.0
2024,6,17,1,2024-06-17,HA,1559,DCA,BWI,"Washington, DC",District of Columbia,"Baltimore, MD",Maryland,525,1664,38,45,563,1709,22,15,585,1694,517,63,83,100,0,,0,3.0,9.0,4.0,0.0,29.0
2024,3,13,3,2024-03-13,WN,4331,DEN,SLC,"Denver, CO",Colorado,"Salt Lake City, UT",Utah,597,1823,-15,-5,582,1818,11,18,593,1800,1992,245,265,274,0,,0,0.0,0.0,0.0,0.0,0.0
2024,5,20,1,2024-05-20,DL,7756,SAN,LAS,"San Diego, CA",California,"Las Vegas, NV",Nevada,775,2171,-24,-15,751,2156,11,10,762,2146,1384,180,200,201,0,,0,0.0,0.0,0.0,0.0,0.0
2024,3,10,7,2024-03-10,MQ,912,LAX,IAD,"Los Angeles, CA",California,"Washington, DC",District of Columbia,1072,1567,18,10,1090,1577,13,12,1103,1565,2929,374,394,399,0,,0,0.0,0.0,0.0,0.0,0.0
2024,9,18,3,2024-09-18,MQ,8000,LAS,DTW,"Las Vegas, NV",Nevada,"Detroit, MI",Michigan,1391,1462,-8,0,1383,1462,20,8,1403,1454,2440,307,327,335,0,,0,0.0,0.0,0.0,0.0,0.0
2024,12,5,4,2024-12-05,OH,9143,PHX,DTW,"Phoenix, AZ",Arizona,"Detroit, MI",Michigan,1766,1998,20,30,1786,2028,28,17,1814,2011,620,81,101,126,0,,0,10.0,8.0,5.0,0.0,7.0
2024,11,3,7,2024-11-03,HA,7668,EWR,DCA,"Newark, NJ",New Jersey,"Washington, DC",District of Columbia,932,2029,2,0,934,2029,15,19,949,2010,2811,360,380,394,0,,0,0.0,0.0,0.0,0.0,0.0
2024,9,1,7,2024-09-01,DL,970,LGA,TPA,"New York, NY",New York,"Tampa, FL",Florida,508,1857,-23,-20,485,1837,13,13,498,1824,234,25,45,51,0,,0,0.0,0.0,0.0,0.0,0.0
2024,1,3,3,2024-01-03,AA,8926,CLT,PHX,"Charlotte, NC",North Carolina,"Phoenix, AZ",Arizona,1395,2131,1,0,1396,2131,5,12,1401,2119,2319,280,300,297,0,,0,0.0,0.0,0.0,0.0,0.0
2024,12,2,1,2024-12-02,B6,768,BOS,PHX,"Boston, MA",Massachusetts,"Phoenix, AZ",Arizona,1368,841,2,5,1370,846,16,11,1386,835,886,119,139,146,0,,0,0.0,0.0,0.0,0.0,0.0
2024,3,3,7,2024-03-03,HA,1393,DFW,LAX,"Dallas/Fort Worth, TX",Texas,"Los Angeles, CA",California,1432,1542,-24,-20,1408,1522,7,11,1415,1511,1578,206,226,224,0,,0,0.0,0.0,0.0,0.0,0.0
2024,2,18,7,2024-02-18,AS,8560,JFK,DFW,"New York, NY",New York,"Dallas/Fort Worth, TX",Texas,771,1962,-8,-5,763,1957,24,8,787,1949,2618,336,356,368,0,,0,0.0,0.0,0.0,0.0,0.0
2024,3,16,6,2024-03-16,G4,9152,SFO,ATL,"San Francisco, CA",California,"Atlanta, GA",Georgia,2295,619,-6,-10,2289,609,23,18,2312,591,2377,293,313,334,0,,0,0.0,0.0,0.0,0.0,0.0
2024,6,23,7,2024-06-23,B6,8773,DFW,DEN,"Dallas/Fort Worth, TX",Texas,"Denver, CO",Colorado,531,2287,-4,0,527,2287,12,14,539,2273,2675,329,349,355,0,,0,0.0,0.0,0.0,0.0,0.0
2024,4,18,4,2024-04-18,MQ,3490,MIA,BWI,"Miami, FL",Florida,"Baltimore, MD",Maryland,1351,1493,21,20,1372,1513,11,4,1383,1509,1140,149,169,164,0,,0,2.0,5.0,3.0,0.0,10.0
2024,7,1,1,2024-07-01,AS,9553,CLT,MCO,"Charlotte, NC",North Carolina,"Orlando, FL",Florida,1104,1794,7,0,1111,1794,9,19,1120,1775,531,69,89,97,0,,0,0.0,0.0,0.0,0.0,0.0
2024,7,10,3,2024-07-10,AS,8394,STL,SFO,"St. Louis, MO",Missouri,"San Francisco, CA",California,2002,1839,-2,5,2000,1844,9,11,2009,1833,385,48,68,68,0,,0,0.0,0.0,0.0,0.0,0.0
2024,3,5,2,2024-03-05,UA,5649,DTW,BWI,"Detroit, MI",Michigan,"Baltimore, MD",Maryland,1651,1440,-10,-5,1641,1435,24,7,1665,1428,1119,139,159,170,0,,0,0.0,0.0,0.0,0.0,0.0
2024,12,2,1,2024-12-02,YX,4987,EWR,MDW,"Newark, NJ",New Jersey,"Chicago, IL",Illinois,2272,1343,0,0,2272,1343,9,19,2281,1324,477,58,78,86,0,,0,0.0,0.0,0.0,0.0,0.0
2024,9,27,5,2024-09-27,WN,4434,MDW,IAD,"Chicago, IL",Illinois,"Washington, DC",District of Columbia,516,1639,-1,0,515,1639,16,17,531,1622,1776,213,233,246,0,,0,0.0,0.0,0.0,0.0,0.0
2024,4,9,2,2024-04-09,AA,5784,ORD,BWI,"Chicago, IL",Illinois,"Baltimore, MD",Maryland,2076,1906,13,5,2089,1911,25,9,2114,1902,1740,209,229,243,0,,0,0.0,0.0,0.0,0.0,0.0
2024,2,1,4,2024-02-01,WN,9173,PDX,SAN,"Portland, OR",Oregon,"San Diego, CA",California,1996,900,17,10,2013,910,24,8,2037,902,843,104,124,136,0,,0,0.0,0.0,0.0,0.0,0.0
2024,12,17,2,2024-12-17,AA,6850,EWR,TPA,"Newark, NJ",New Jersey,"Tampa, FL",Florida,800,764,6,5,806,769,9,6,815,763,921,105,125,120,0,,0,0.0,0.0,0.0,0.0,0.0
2024,5,7,2,2024-05-07,HA,2335,LGA,STL,"New York, NY",New York,"St. Louis, MO",Missouri,541,1380,26,20,567,1400,27,14,594,1386,2357,299,319,340,0,,0,7.0,0.0,2.0,0.0,11.0
2024,12,4,3,2024-12-04,B6,5083,LAX,SFO,"Los Angeles, CA",California,"San Francisco, CA",California,551,2314,19,10,570,2324,29,8,599,2316,2216,280,300,317,0,,0,0.0,0.0,0.0,0.0,0.0
2024,2,12,1,2024-02-12,OO,7852,MSP,DCA,"Minneapolis, MN",Minnesota,"Washington, DC",District of Columbia,687,1881,-24,-15,663,1866,11,16,674,1850,2269,281,301,308,0,,0,0.0,0.0,0.0,0.0,0.0
2024,3,18,1,2024-03-18,OO,5119,CLT,DTW,"Charlotte, NC",North Carolina,"Detroit, MI",Michigan,650,2211,8,0,658,2211,5,18,663,2193,685,81,101,104,0,,0,0.0,0.0,0.0,0.0,0.0
2024,11,9,6,2024-11-09,F9,8141,SEA,STL,"Seattle, WA",Washington,"St. Louis, MO",Missouri,1767,2240,16,15,1783,2255,29,7,1812,2248,571,67,87,103,0,,0,0.0,0.0,0.0,0.0,0.0
2024,10,15,2,2024-10-15,F9,2677,BWI,IAH,"Baltimore, MD",Maryland,"Houston, TX",Texas,2014,952,15,15,2029,967,23,7,2052,960,2002,240,260,270,0,,0,0.0,0.0,0.0,0.0,0.0
2024,9,26,4,2024-09-26,B6,775,EWR,MDW,"Newark, NJ",New Jersey,"Chicago, IL",Illinois,1650,1710,-1,-5,1649,1705,6,19,1655,1686,1397,183,203,208,0,,0,0.0,0.0,0.0,0.0,0.0
2024,6,10,1,2024-06-10,OH,2539,PHL,TPA,"Philadelphia, PA",Pennsylvania,"Tampa, FL",Florida,2240,1620,5,5,2245,1625,16,6,2261,1619,2928,369,389,391,0,,0,0.0,0.0,0.0,0.0,0.0
2024,7,7,7,2024-07-07,9E,9973,MSP,DTW,"Minneapolis, MN",Minnesota,"Detroit, MI",Michigan,908,2149,-5,-5,903,2144,14,13,917,2131,2382,294,314,321,0,,0,0.0,0.0,0.0,0.0,0.0
2024,9,3,2,2024-09-03,DL,5687,SLC,TPA,"Salt Lake City, UT",Utah,"Tampa, FL",Florida,2135,1470,-16,-15,2119,1455,29,8,2148,1447,479,51,71,88,0,,0,0.0,0.0,0.0,0.0,0.0
2024,8,3,6,2024-08-03,YX,6045,PHL,MCO,"Philadelphia, PA",Pennsylvania,"Orlando, FL",Florida,843,1358,18,10,861,1368,20,14,881,1354,1359,164,184,198,0,,0,0.0,0.0,0.0,0.0,0.0
2024,11,10,7,2024-11-10,AS,9568,SAN,MCO,"San Diego, CA",California,"Orlando, FL",Florida,1090,1477,7,15,1097,1492,15,13,1112,1479,467,62,82,90,0,,0,0.0,0.0,0.0,0.0,0.0
2024,12,4,3,2024-12-04,AA,4867,ATL,MDW,"Atlanta, GA",Georgia,"Chicago, IL",Illinois,2218,1352,-7,0,2211,1352,22,11,2233,1341,593,83,103,116,0,,0,0.0,0.0,0.0,0.0,0.0
2024,6,16,7,2024-06-16,NK,7104,SLC,IAD,"Salt Lake City, UT",Utah,"Washington, DC",District of Columbia,1621,1465,-28,-20,1593,1445,16,15,1609,1430,594,78,98,109,0,,0,0.0,0.0,0.0,0.0,0.0
2024,12,4,3,2024-12-04,OO,7828,MCO,TPA,"Orlando, FL",Florida,"Tampa, FL",Florida,1591,1632,14,10,1605,1642,13,17,1618,1625,2139,264,284,294,0,,0,0.0,0.0,0.0,0.0,0.0
2024,7,11,4,2024-07-11,WN,6709,MSP,DFW,"Minneapolis, MN",Minnesota,"Dallas/Fort Worth, TX",Texas,1345,2086,-5,0,1340,2086,25,5,1365,2081,477,67,87,97,0,,0,0.0,0.0,0.0,0.0,0.0
2024,10,9,3,2024-10-09,B6,5034,LGA,LAS,"New York, NY",New York,"Las Vegas, NV",Nevada,1399,2159,-17,-15,1382,2144,26,7,1408,2137,2269,277,297,310,0,,0,0.0,0.0,0.0,0.0,0.0
2024,12,1,7,2024-12-01,AS,3748,BOS,PHL,"Boston, MA",Massachusetts,"Philadelphia, PA",Pennsylvania,527,2247,-13,-10,514,2237,11,17,525,2220,2032,256,276,284,0,,0,0.0,0.0,0.0,0.0,0.0
2024,1,13,6,2024-01-13,OO,7231,JFK,LGA,"New York, NY",New York,"New York, NY",New York,1552,1920,-19,-10,1533,1910,11,9,1544,1901,2303,278,298,298,0,,0,0.0,0.0,0.0,0.0,0.0
2024,8,27,2,2024-08-27,AA,1412,SLC,MDW,"Salt Lake City, UT",Utah,"Chicago, IL",Illinois,1133,1840,13,5,1146,1845,17,5,1163,1840,1347,169,189,191,0,,0,0.0,0.0,0.0,0.0,0.0
2024,11,15,5,2024-11-15,G4,9365,SEA,ORD,"Seattle, WA",Washington,"Chicago, IL",Illinois,711,827,-6,-10,705,817,24,10,729,807,234,34,54,68,0,,0,0.0,0.0,0.0,0.0,0.0
2024,5,26,7,2024-05-26,9E,4199,SFO,ATL,"San Francisco, CA",California,"Atlanta, GA",Georgia,1187,1655,-18,-15,1169,1640,17,15,1186,1625,1495,182,202,214,0,,0,0.0,0.0,0.0,0.0,0.0
2024,7,22,1,2024-07-22,WN,1754,DFW,EWR,"Dallas/Fort Worth, TX",Texas,"Newark, NJ",New Jersey,2140,1030,23,15,2163,1045,24,18,2187,1027,857,105,125,147,0,,0,0.0,0.0,0.0,0.0,0.0
2024,3,20,3,2024-03-20,F9,6118,DEN,DTW,"Denver, CO",Colorado,"Detroit, MI",Michigan,2003,1388,14,20,2017,1408,9,10,2026,1398,2644,331,351,350,0,,0,5.0,5.0,1.0,0.0,9.0
2024,2,12,1,2024-02-12,B6,1385,PHX,EWR,"Phoenix, AZ",Arizona,"Newark, NJ",New Jersey,571,769,-14,-15,557,754,29,11,586,743,221,31,51,71,0,,0,0.0,0.0,0.0,0.0,0.0
2024,3,29,5,2024-03-29,OO,7952,MSP,SLC,"Minneapolis, MN",Minnesota,"Salt Lake City, UT",Utah,2014,1854,-9,-10,2005,1844,18,4,2023,1840,2256,284,304,306,1,,0,0.0,0.0,0.0,0.0,0.0
2024,5,27,1,2024-05-27,F9,8826,PDX,CLT,"Portland, OR",Oregon,"Charlotte, NC",North Carolina,609,669,-2,0,607,669,20,3,627,666,1078,125,145,148,0,,0,0.0,0.0,0.0,0.0,0.0
2024,4,4,4,2024-04-04,HA,7146,EWR,HNL,"Newark, NJ",New Jersey,"Honolulu, HI",Hawaii,1636,1734,-3,-10,1633,1724,17,15,1650,1709,1616,199,219,231,0,,0,0.0,0.0,0.0,0.0,0.0
2024,5,30,4,2024-05-30,AA,5280,SEA,MCO,"Seattle, WA",Washington,"Orlando, FL",Florida,1920,1712,-11,-10,1909,1702,16,15,1925,1687,1241,163,183,194,0,,0,0.0,0.0,0.0,0.0,0.0
2024,1,2,2,2024-01-02,F9,1479,SLC,PHL,"Salt Lake City, UT",Utah,"Philadelphia, PA",Pennsylvania,731,601,-11,-5,720,596,5,13,725,583,436,53,73,71,0,,0,0.0,0.0,0.0,0.0,0.0
2024,1,22,1,2024-01-22,OO,745,SEA,PDX,"Seattle, WA",Washington,"Portland, OR",Oregon,542,1679,19,15,561,1694,12,12,573,1682,903,106,126,130,0,,0,0.0,0.0,0.0,0.0,0.0
2024,11,8,5,2024-11-08,MQ,8315,ORD,LGA,"Chicago, IL",Illinois,"New York, NY",New York,764,1269,29,20,793,1289,12,8,805,1281,1517,197,217,217,0,,0,7.0,1.0,1.0,0.0,11.0
2024,11,23,6,2024-11-23,OO,5512,STL,SAN,"St. Louis, MO",Missouri,"San Diego, CA",California,545,870,18,10,563,880,27,18,590,862,2088,251,271,296,0,,0,0.0,0.0,0.0,0.0,0.0
2024,1,7,7,2024-01-07,WN,4752,EWR,DEN,"Newark, NJ",New Jersey,"Denver, CO",Colorado,2093,1897,4,5,2097,1902,26,8,2123,1894,1919,236,256,270,0,,0,0.0,0.0,0.0,0.0,0.0
2024,7,24,3,2024-07-24,DL,6934,DFW,MCO,"Dallas/Fort Worth, TX",Texas,"Orlando, FL",Florida,1748,1143,11,5,1759,1148,19,15,1778,1133,819,105,125,139,0,,0,0.0,0.0,0.0,0.0,0.0
2024,4,23,2,2024-04-23,OO,4551,EWR,IAD,"Newark, NJ",New Jersey,"Washington, DC",District of Columbia,2175,869,-5,0,2170,869,7,14,2177,855,2942,364,384,385,0,,0,0.0,0.0,0.0,0.0,0.0
2024,9,28,6,2024-09-28,AS,6203,MDW,PHL,"Chicago, IL",Illinois,"Philadelphia, PA",Pennsylvania,1624,789,-2,0,1622,789,12,10,1634,779,2327,282,302,304,0,,0,0.0,0.0,0.0,0.0,0.0
2024,3,23,6,2024-03-23,DL,7184,ORD,LAX,"Chicago, IL",Illinois,"Los Angeles, CA",California,1804,1321,6,0,1810,1321,27,5,1837,1316,2635,332,352,364,0,,0,0.0,0.0,0.0,0.0,0.0
2024,6,27,4,2024-06-27,B6,4224,LGA,MSP,"New York, NY",New York,"Minneapolis, MN",Minnesota,737,2106,12,5,749,2111,28,15,777,2096,1169,142,162,185,0,,0,0.0,0.0,0.0,0.0,0.0
2024,7,28,7,2024-07-28,DL,464,MCO,SLC,"Orlando, FL",Florida,"Salt Lake City, UT",Utah,1100,1931,-12,-15,1088,1916,22,3,1110,1913,231,19,39,44,0,,0,0.0,0.0,0.0,0.0,0.0
2024,11,23,6,2024-11-23,UA,2755,BWI,IAD,"Baltimore, MD",Maryland,"Washington, DC",District of Columbia,1769,621,-15,-10,1754,611,28,12,1782,599,2471,316,336,356,0,,0,0.0,0.0,0.0,0.0,0.0
2024,5,3,5,2024-05-03,OO,8700,ATL,SLC,"Atlanta, GA",Georgia,"Salt Lake City, UT",Utah,1190,613,20,20,1210,633,11,17,1221,616,1947,238,258,266,0,,0,4.0,5.0,2.0,0.0,9.0
2024,4,22,1,2024-04-22,AS,7533,TPA,IAH,"Tampa, FL",Florida,"Houston, TX",Texas,1475,2109,3,-5,1478,2104,26,13,1504,2091,985,116,136,155,0,,0,0.0,0.0,0.0,0.0,0.0
2024,1,12,5,2024-01-12,AA,1414,EWR,LAS,"Newark, NJ",New Jersey,"Las Vegas, NV",Nevada,1242,2341,-5,-10,1237,2331,29,18,1266,2313,2186,282,302,329,0,,0,0.0,0.0,0.0,0.0,0.0
2024,5,5,7,2024-05-05,AS,5372,ORD,IAD,"Chicago, IL",Illinois,"Washington, DC",District of Columbia,1622,2169,-14,-5,1608,2164,16,5,1624,2159,909,103,123,124,0,,0,0.0,0.0,0.0,0.0,0.0
2024,2,22,4,2024-02-22,UA,318,BOS,SAN,"Boston, MA",Massachusetts,"San Diego, CA",California,1226,2087,-14,-10,1212,2077,19,11,1231,2066,2896,369,389,399,0,,0,0.0,0.0,0.0,0.0,0.0
2024,11,26,2,2024-11-26,NK,4803,LGA,MDW,"New York, NY",New York,"Chicago, IL",Illinois,699,1167,-20,-15,679,1152,12,9,691,1143,481,55,75,76,0,,0,0.0,0.0,0.0,0.0,0.0
2024,10,9,3,2024-10-09,DL,5231,MDW,EWR,"Chicago, IL",Illinois,"Newark, NJ",New Jersey,1512,2056,-6,-10,1506,2046,20,18,1526,2028,1841,229,249,267,0,,0,0.0,0.0,0.0,0.0,0.0
2024,5,19,7,2024-05-19,OH,1639,MDW,STL,"Chicago, IL",Illinois,"St. Louis, MO",Missouri,1779,1174,2,0,1781,1174,9,9,1790,1165,2167,274,294,292,0,,0,0.0,0.0,0.0,0.0,0.0
2024,4,6,6,2024-04-06,AS,3533,MSP,IAH,"Minneapolis, MN",Minnesota,"Houston, TX",Texas,936,2023,-14,-10,922,2013,9,10,931,2003,2522,321,341,340,0,,0,0.0,0.0,0.0,0.0,0.0
2024,1,5,5,2024-01-05,F9,1702,MIA,DCA,"Miami, FL",Florida,"Washington, DC",District of Columbia,993,1191,9,0,1002,1191,13,7,1015,1184,1037,119,139,139,0,,0,0.0,0.0,0.0,0.0,0.0
2024,2,26,1,2024-02-26,HA,2804,BOS,LAS,"Boston, MA",Massachusetts,"Las Vegas, NV",Nevada,1959,1151,-23,-15,1936,1136,17,8,1953,1128,329,45,65,70,0,,0,0.0,0.0,0.0,0.0,0.0
2024,11,29,5,2024-11-29,HA,5164,PHX,MDW,"Phoenix, AZ",Arizona,"Chicago, IL",Illinois,1206,1405,-16,-20,1190,1385,19,11,1209,1374,2019,243,263,273,0,,0,0.0,0.0,0.0,0.0,0.0
2024,3,9,6,2024-03-09,HA,3748,SFO,HNL,"San Francisco, CA",California,"Honolulu, HI",Hawaii,523,1513,19,10,542,1523,12,7,554,1516,2359,287,307,306,0,,0,0.0,0.0,0.0,0.0,0.0
2024,4,27,6,2024-04-27,AA,1205,TPA,LAX,"Tampa, FL",Florida,"Los Angeles, CA",California,1886,878,-3,5,1883,883,16,11,1899,872,1429,175,195,202,0,,0,0.0,0.0,0.0,0.0,0.0
2024,2,28,3,2024-02-28,OO,5836,PHX,TPA,"Phoenix, AZ",Arizona,"Tampa, FL",Florida,769,1367,9,5,778,1372,24,12,802,1360,2955,365,385,401,0,,0,0.0,0.0,0.0,0.0,0.0
2024,2,2,5,2024-02-02,OO,5912,LGA,JFK,"New York, NY",New York,"New York, NY",New York,1289,1733,-28,-20,1261,1713,13,8,1274,1705,2172,264,284,285,1,,0,0.0,0.0,0.0,0.0,0.0
2024,11,13,3,2024-11-13,MQ,2588,LAX,IAD,"Los Angeles, CA",California,"Washington, DC",District of Columbia,1237,647,-6,-10,1231,637,19,3,1250,634,2372,298,318,320,0,,0,0.0,0.0,0.0,0.0,0.0
2024,2,19,1,2024-02-19,G4,8908,MIA,TPA,"Miami, FL",Florida,"Tampa, FL",Florida,1751,1343,0,10,1751,1353,19,15,1770,1338,462,66,86,100,0,,0,0.0,0.0,0.0,0.0,0.0
2024,1,19,5,2024-01-19,B6,2518,DEN,BWI,"Denver, CO",Colorado,"Baltimore, MD",Maryland,627,1705,-6,-15,621,1690,17,7,638,1683,555,74,94,98,0,,0,0.0,0.0,0.0,0.0,0.0
2024,8,1,4,2024-08-01,B6,127,SAN,CLT,"San Diego, CA",California,"Charlotte, NC",North Carolina,1042,1285,10,10,1052,1295,19,18,1071,1277,1020,131,151,168,0,,0,0.0,0.0,0.0,0.0,0.0
2024,7,15,1,2024-07-15,MQ,8307,SAN,MIA,"San Diego, CA",California,"Miami, FL",Florida,2286,1224,-7,0,2279,1224,26,17,2305,1207,707,84,104,127,0,,0,0.0,0.0,0.0,0.0,0.0
2024,2,16,5,2024-02-16,YX,8624,PDX,IAH,"Portland, OR",Oregon,"Houston, TX",Texas,1581,1901,13,5,1594,1906,9,16,1603,1890,1430,182,202,207,0,,0,0.0,0.0,0.0,0.0,0.0
2024,6,15,6,2024-06-15,B6,8077,MCO,PHX,"Orlando, FL",Florida,"Phoenix, AZ",Arizona,824,980,-1,0,823,980,14,16,837,964,2753,343,363,373,0,,0,0.0,0.0,0.0,0.0,0.0
2024,10,15,2,2024-10-15,AS,4761,MCO,SEA,"Orlando, FL",Florida,"Seattle, WA",Washington,1158,909,-12,-5,1146,904,27,6,1173,898,2700,335,355,368,0,,0,0.0,0.0,0.0,0.0,0.0
2024,5,20,1,2024-05-20,DL,4649,DTW,MSP,"Detroit, MI",Michigan,"Minneapolis, MN",Minnesota,1629,1151,-5,-10,1624,1141,29,9,1653,1132,413,59,79,97,0,,0,0.0,0.0,0.0,0.0,0.0
2024,3,24,7,2024-03-24,AS,4053,IAH,DEN,"Houston, TX",Texas,"Denver, CO",Colorado,1960,1141,-5,5,1955,1146,16,17,1971,1129,1876,235,255,268,0,,0,0.0,0.0,0.0,0.0,0.0
2024,6,30,7,2024-06-30,OH,4361,BOS,ORD,"Boston, MA",Massachusetts,"Chicago, IL",Illinois,584,1366,12,10,596,1376,21,7,617,1369,1549,195,215,223,0,,0,0.0,0.0,0.0,0.0,0.0
2024,3,19,2,2024-03-19,OO,8223,MCO,SFO,"Orlando, FL",Florida,"San Francisco, CA",California,1525,1863,-12,-20,1513,1843,13,3,1526,1840,500,65,85,81,0,,0,0.0,0.0,0.0,0.0,0.0
2024,8,2,5,2024-08-02,WN,5073,LAX,IAH,"Los Angeles, CA",California,"Houston, TX",Texas,1960,1806,-2,-5,1958,1801,9,16,1967,1785,1073,124,144,149,0,,0,0.0,0.0,0.0,0.0,0.0
2024,1,14,7,2024-01-14,F9,8536,DEN,JFK,"Denver, CO",Colorado,"New York, NY",New York,950,783,-3,-5,947,778,13,4,960,774,1577,188,208,205,0,,0,0.0,0.0,0.0,0.0,0.0
2024,8,2,5,2024-08-02,MQ,1456,SAN,DCA,"San Diego, CA",California,"Washington, DC",District of Columbia,2088,2177,-7,0,2081,2177,9,6,2090,2171,1481,194,214,209,0,,0,0.0,0.0,0.0,0.0,0.0
2024,5,7,2,2024-05-07,OO,9234,BWI,EWR,"Baltimore, MD",Maryland,"Newark, NJ",New Jersey,1964,1065,-16,-15,1948,1050,27,9,1975,1041,2640,332,352,368,0,,0,0.0,0.0,0.0,0.0,0.0
2024,11,5,2,2024-11-05,G4,3567,JFK,CLT,"New York, NY",New York,"Charlotte, NC",North Carolina,1745,1238,12,15,1757,1253,18,3,1775,1250,603,67,87,88,0,,0,0.0,0.0,0.0,0.0,0.0
2024,9,4,3,2024-09-04,G4,7064,MCO,SFO,"Orlando, FL",Florida,"San Francisco, CA",California,1493,2060,-2,0,1491,2060,11,14,1502,2046,1041,122,142,147,0,,0,0.0,0.0,0.0,0.0,0.0
2024,1,29,1,2024-01-29,F9,7167,PHL,CLT,"Philadelphia, PA",Pennsylvania,"Charlotte, NC",North Carolina,1548,1193,18,15,1566,1208,13,3,1579,1205,2076,257,277,273,0,,0,0.0,0.0,0.0,0.0,0.0
2024,10,6,7,2024-10-06,UA,1845,TPA,LAS,"Tampa, FL",Florida,"Las Vegas, NV",Nevada,1558,1856,7,10,1565,1866,16,16,1581,1850,964,128,148,160,0,,0,0.0,0.0,0.0,0.0,0.0
2024,12,3,2,2024-12-03,9E,3979,DFW,MIA,"Dallas/Fort Worth, TX",Texas,"Miami, FL",Florida,1168,1303,-20,-10,1148,1293,9,8,1157,1285,387,56,76,73,0,,0,0.0,0.0,0.0,0.0,0.0
2024,11,14,4,2024-11-14,OO,3877,SLC,HNL,"Salt Lake City, UT",Utah,"Honolulu, HI",Hawaii,1471,600,-15,-15,1456,585,11,3,1467,582,2898,352,372,366,0,,0,0.0,0.0,0.0,0.0,0.0
2024,7,20,6,2024-07-20,OO,2215,MCO,DTW,"Orlando, FL",Florida,"Detroit, MI",Michigan,842,2128,15,10,857,2138,9,4,866,2134,559,73,93,86,0,,0,0.0,0.0,0.0,0.0,0.0
2024,12,26,4,2024-12-26,WN,6357,MCO,DFW,"Orlando, FL",Florida,"Dallas/Fort Worth, TX",Texas,1487,1607,-10,0,1477,1607,24,19,1501,1588,2524,309,329,352,0,,0,0.0,0.0,0.0,0.0,0.0
2024,2,26,1,2024-02-26,AA,2367,PDX,DEN,"Portland, OR",Oregon,"Denver, CO",Colorado,1889,961,-12,-20,1877,941,21,10,1898,931,921,115,135,146,0,,0,0.0,0.0,0.0,0.0,0.0
2024,8,5,1,2024-08-05,G4,2367,STL,PDX,"St. Louis, MO",Missouri,"Portland, OR",Oregon,2180,1318,24,15,2204,1333,15,19,2219,1314,2953,361,381,395,0,,0,0.0,0.0,0.0,0.0,0.0
2024,3,2,6,2024-03-02,B6,9788,PHL,DEN,"Philadelphia, PA",Pennsylvania,"Denver, CO",Colorado,1859,2332,7,0,1866,2332,9,18,1875,2314,2731,342,362,369,0,,0,0.0,0.0,0.0,0.0,0.0
2024,6,5,3,2024-06-05,AS,7186,IAD,DEN,"Washington, DC",District of Columbia,"Denver, CO",Colorado,1956,882,-9,-5,1947,877,8,17,1955,860,2980,365,385,390,0,,0,0.0,0.0,0.0,0.0,0.0
2024,7,20,6,2024-07-20,UA,4581,DEN,DTW,"Denver, CO",Colorado,"Detroit, MI",Michigan,1451,2152,-2,0,1449,2152,5,17,1454,2135,1593,191,211,213,0,,0,0.0,0.0,0.0,0.0,0.0
2024,1,17,3,2024-01-17,OO,7565,PHL,MCO,"Philadelphia, PA",Pennsylvania,"Orlando, FL",Florida,956,1430,5,10,961,1440,5,14,966,1426,1885,237,257,256,0,,0,0.0,0.0,0.0,0.0,0.0
2024,11,17,7,2024-11-17,9E,1029,LAS,PHX,"Las Vegas, NV",Nevada,"Phoenix, AZ",Arizona,1398,768,-6,-15,1392,753,18,19,1410,734,1929,232,252,269,0,,0,0.0,0.0,0.0,0.0,0.0
2024,1,6,6,2024-01-06,F9,7873,LAS,MIA,"Las Vegas, NV",Nevada,"Miami, FL",Florida,2002,1488,-10,-5,1992,1483,25,10,2017,1473,1422,181,201,216,0,,0,0.0,0.0,0.0,0.0,0.0
2024,2,27,2,2024-02-27,HA,3424,STL,MDW,"St. Louis, MO",Missouri,"Chicago, IL",Illinois,897,1809,-15,-5,882,1804,13,11,895,1793,1131,135,155,159,0,,0,0.0,0.0,0.0,0.0,0.0
2024,11,20,3,2024-11-20,NK,4687,DCA,STL,"Washington, DC",District of Columbia,"St. Louis, MO",Missouri,1398,721,5,10,1403,731,5,17,1408,714,1369,163,183,185,0,,0,0.0,0.0,0.0,0.0,0.0
2024,11,13,3,2024-11-13,AA,456,IAH,DEN,"Houston, TX",Texas,"Denver, CO",Colorado,842,1040,10,5,852,1045,12,15,864,1030,1378,170,190,197,0,,0,0.0,0.0,0.0,0.0,0.0
2024,6,17,1,2024-06-17,9E,4410,TPA,DCA,"Tampa, FL",Florida,"Washington, DC",District of Columbia,2214,1238,-12,-5,2202,1233,17,7,2219,1226,2981,370,390,394,0,,0,0.0,0.0,0.0,0.0,0.0
2024,3,22,5,2024-03-22,YX,4164,PHL,HNL,"Philadelphia, PA",Pennsylvania,"Honolulu, HI",Hawaii,1803,2301,-3,5,1800,2306,13,3,1813,2303,273,43,63,59,0,,0,0.0,0.0,0.0,0.0,0.0
2024,8,6,2,2024-08-06,B6,5599,ATL,EWR,"Atlanta, GA",Georgia,"Newark, NJ",New Jersey,1875,1073,-7,-5,1868,1068,19,14,1887,1054,1968,244,264,277,0,,0,0.0,0.0,0.0,0.0,0.0
2024,6,25,2,2024-06-25,9E,3941,TPA,CLT,"Tampa, FL",Florida,"Charlotte, NC",North Carolina,1312,1745,-3,0,1309,1745,15,3,1324,1742,1318,157,177,175,1,,0,0.0,0.0,0.0,0.0,0.0
2024,7,22,1,2024-07-22,G4,9118,MCO,EWR,"Orlando, FL",Florida,"Newark, NJ",New Jersey,1720,1331,41,45,1761,1376,8,19,1769,1357,2583,315,335,342,0,,0,16.0,12.0,5.0,1.0,11.0
2024,3,11,1,2024-03-11,YX,5433,MDW,STL,"Chicago, IL",Illinois,"St. Louis, MO",Missouri,1748,1540,1,0,1749,1540,12,4,1761,1536,1498,178,198,194,0,,0,0.0,0.0,0.0,0.0,0.0
2024,9,22,7,2024-09-22,OO,6771,DCA,SAN,"Washington, DC",District of Columbia,"San Diego, CA",California,1439,1259,20,30,1459,1289,17,9,1476,1280,1537,196,216,222,0,,0,10.0,3.0,4.0,0.0,13.0
2024,4,7,7,2024-04-07,YX,7159,SEA,TPA,"Seattle, WA",Washington,"Tampa, FL",Florida,546,891,6,5,552,896,21,5,573,891,1720,219,239,245,0,,0,0.0,0.0,0.0,0.0,0.0
2024,12,10,2,2024-12-10,AS,765,PHX,BWI,"Phoenix, AZ",Arizona,"Baltimore, MD",Maryland,1708,1537,-10,-15,1698,1522,8,16,1706,1506,1896,243,263,267,0,,0,0.0,0.0,0.0,0.0,0.0
2024,10,17,4,2024-10-17,F9,6953,EWR,HNL,"Newark, NJ",New Jersey,"Honolulu, HI",Hawaii,1414,846,8,5,1422,851,14,12,1436,839,2052,255,275,281,0,,0,0.0,0.0,0.0,0.0,0.0
2024,7,26,5,2024-07-26,9E,653,STL,LGA,"St. Louis, MO",Missouri,"New York, NY",New York,661,787,-10,-10,651,777,6,9,657,768,2356,287,307,302,0,,0,0.0,0.0,0.0,0.0,0.0
2024,1,2,2,2024-01-02,AA,8619,LAX,DCA,"Los Angeles, CA",California,"Washington, DC",District of Columbia,2166,2146,9,0,2175,2146,19,16,2194,2130,1739,219,239,254,0,,0,0.0,0.0,0.0,0.0,0.0
2024,5,3,5,2024-05-03,9E,7145,PHL,MDW,"Philadelphia, PA",Pennsylvania,"Chicago, IL",Illinois,794,1907,8,0,802,1907,24,5,826,1902,480,55,75,84,1,,0,0.0,0.0,0.0,0.0,0.0
2024,10,6,7,2024-10-06,OO,9480,LGA,ATL,"New York, NY",New York,"Atlanta, GA",Georgia,591,1156,18,10,609,1166,22,13,631,1153,256,41,61,76,0,,0,0.0,0.0,0.0,0.0,0.0
2024,3,14,4,2024-03-14,NK,7383,SAN,DEN,"San Diego, CA",California,"Denver, CO",Colorado,2110,1747,-8,-10,2102,1737,18,17,2120,1720,2572,326,346,361,0,,0,0.0,0.0,0.0,0.0,0.0
2024,6,14,5,2024-06-14,UA,249,ATL,SFO,"Atlanta, GA",Georgia,"San Francisco, CA",California,2173,1489,11,10,2184,1499,7,14,2191,1485,290,45,65,66,0,,0,0.0,0.0,0.0,0.0,0.0
2024,1,22,1,2024-01-22,G4,2953,SLC,IAH,"Salt Lake City, UT",Utah,"Houston, TX",Texas,1691,846,14,15,1705,861,5,7,1710,854,203,16,36,28,0,,0,0.0,0.0,0.0,0.0,0.0
2024,6,2,7,2024-06-02,AS,2836,IAD,SLC,"Washington, DC",District of Columbia,"Salt Lake City, UT",Utah,1781,2029,-11,-15,1770,2014,7,11,1777,2003,732,96,116,114,0,,0,0.0,0.0,0.0,0.0,0.0
2024,10,21,1,2024-10-21,B6,1056,HNL,SFO,"Honolulu, HI",Hawaii,"San Francisco, CA",California,1249,1960,12,10,1261,1970,27,9,1288,1961,614,68,88,104,0,,0,0.0,0.0,0.0,0.0,0.0
2024,8,6,2,2024-08-06,F9,5280,JFK,MSP,"New York, NY",New York,"Minneapolis, MN",Minnesota,1056,1558,-8,-10,1048,1548,17,17,1065,1531,835,112,132,146,0,,0,0.0,0.0,0.0,0.0,0.0
2024,6,5,3,2024-06-05,F9,8707,IAH,ORD,"Houston, TX",Texas,"Chicago, IL",Illinois,808,1782,-11,-15,797,1767,12,3,809,1764,1432,175,195,190,0,,0,0.0,0.0,0.0,0.0,0.0
2024,8,17,6,2024-08-17,YX,2745,IAD,IAH,"Washington, DC",District of Columbia,"Houston, TX",Texas,2172,1890,26,20,2198,1910,26,3,2224,1907,462,50,70,79,0,,0,6.0,3.0,0.0,0.0,11.0
2024,1,20,6,2024-01-20,YX,3874,SAN,EWR,"San Diego, CA",California,"Newark, NJ",New Jersey,2138,891,-5,-5,2133,886,21,8,2154,878,944,122,142,151,0,,0,0.0,0.0,0.0,0.0,0.0
2024,2,10,6,2024-02-10,UA,5113,IAH,ATL,"Houston, TX",Texas,"Atlanta, GA",Georgia,1652,2213,-1,0,1651,2213,27,7,1678,2206,1826,220,240,254,1,,0,0.0,0.0,0.0,0.0,0.0
2024,5,27,1,2024-05-27,DL,184,SAN,SEA,"San Diego, CA",California,"Seattle, WA",Washington,2196,1494,-7,0,2189,1494,20,13,2209,1481,1848,224,244,257,0,,0,0.0,0.0,0.0,0.0,0.0
2024,4,17,3,2024-04-17,HA,2035,BOS,JFK,"Boston, MA",Massachusetts,"New York, NY",New York,2073,750,-4,-10,2069,740,20,13,2089,727,2362,285,305,318,0,,0,0.0,0.0,0.0,0.0,0.0
2024,3,24,7,2024-03-24,DL,9708,LGA,LAS,"New York, NY",New York,"Las Vegas, NV",Nevada,1068,1908,8,5,1076,1913,16,16,1092,1897,2644,325,345,357,0,,0,0.0,0.0,0.0,0.0,0.0
2024,11,17,7,2024-11-17,OH,9362,CLT,DTW,"Charlotte, NC",North Carolina,"Detroit, MI",Michigan,1684,750,-29,-20,1655,730,23,10,1678,720,510,55,75,88,0,,0,0.0,0.0,0.0,0.0,0.0
2024,11,4,1,2024-11-04,B6,9813,IAD,SFO,"Washington, DC",District of Columbia,"San Francisco, CA",California,675,723,-14,-10,661,713,20,16,681,697,806,109,129,145,0,,0,0.0,0.0,0.0,0.0,0.0
2024,10,16,3,2024-10-16,9E,6849,MSP,CLT,"Minneapolis, MN",Minnesota,"Charlotte, NC",North Carolina,2294,871,20,15,2314,886,19,11,2333,875,1931,238,258,268,0,,0,0.0,0.0,0.0,0.0,0.0
2024,11,18,1,2024-11-18,YX,1601,MIA,DFW,"Miami, FL",Florida,"Dallas/Fort Worth, TX",Texas,1811,1963,26,20,1837,1983,13,13,1850,1970,1744,222,242,248,0,,0,0.0,5.0,3.0,0.0,12.0
2024,5,13,1,2024-05-13,NK,6669,SEA,STL,"Seattle, WA",Washington,"St. Louis, MO",Missouri,1472,2352,-7,0,1465,2352,20,13,1485,2339,308,34,54,67,0,,0,0.0,0.0,0.0,0.0,0.0
2024,7,25,4,2024-07-25,F9,2573,MSP,SEA,"Minneapolis, MN",Minnesota,"Seattle, WA",Washington,1928,1258,-18,-10,1910,1248,6,18,1916,1230,2533,312,332,336,0,,0,0.0,0.0,0.0,0.0,0.0
2024,10,9,3,2024-10-09,9E,835,MSP,IAH,"Minneapolis, MN",Minnesota,"Houston, TX",Texas,2180,2353,-11,-5,2169,2348,29,14,2198,2334,2719,342,362,385,0,,0,0.0,0.0,0.0,0.0,0.0
2024,9,22,7,2024-09-22,HA,2938,PDX,MSP,"Portland, OR",Oregon,"Minneapolis, MN",Minnesota,1437,1207,5,10,1442,1217,14,9,1456,1208,567,64,84,87,0,,0,0.0,0.0,0.0,0.0,0.0
2024,3,13,3,2024-03-13,F9,2662,HNL,MDW,"Honolulu, HI",Hawaii,"Chicago, IL",Illinois,2103,2070,-20,-15,2083,2055,16,5,2099,2050,1329,170,190,191,0,,0,0.0,0.0,0.0,0.0,0.0
2024,12,17,2,2024-12-17,MQ,4006,BWI,MDW,"Baltimore, MD",Maryland,"Chicago, IL",Illinois,1863,2185,-20,-15,1843,2170,22,14,1865,2156,260,25,45,61,0,,0,0.0,0.0,0.0,0.0,0.0
2024,2,17,6,2024-02-17,YX,1372,DFW,ATL,"Dallas/Fort Worth, TX",Texas,"Atlanta, GA",Georgia,1518,1580,18,10,1536,1590,22,8,1558,1582,2314,295,315,325,0,,0,0.0,0.0,0.0,0.0,0.0
2024,11,21,4,2024-11-21,F9,4936,TPA,DTW,"Tampa, FL",Florida,"Detroit, MI",Michigan,1791,2080,-5,-5,1786,2075,8,6,1794,2069,572,66,86,80,0,,0,0.0,0.0,0.0,0.0,0.0
2024,8,20,2,2024-08-20,HA,1962,MCO,PHX,"Orlando, FL",Florida,"Phoenix, AZ",Arizona,717,1154,-7,-15,710,1139,6,12,716,1127,2494,313,333,331,0,,0,0.0,0.0,0.0,0.0,0.0
2024,4,9,2,2024-04-09,9E,4326,IAH,STL,"Houston, TX",Texas,"St. Louis, MO",Missouri,1312,1130,-12,-15,1300,1115,11,10,1311,1105,622,84,104,105,0,,0,0.0,0.0,0.0,0.0,0.0
2024,2,28,3,2024-02-28,YX,9114,CLT,ATL,"Charlotte, NC",North Carolina,"Atlanta, GA",Georgia,663,1736,14,10,677,1746,23,12,700,1734,2515,320,340,355,0,,0,0.0,0.0,0.0,0.0,0.0
2024,9,14,6,2024-09-14,OO,642,STL,IAD,"St. Louis, MO",Missouri,"Washington, DC",District of Columbia,2214,1324,-6,0,2208,1324,15,18,2223,1306,537,66,86,99,0,,0,0.0,0.0,0.0,0.0,0.0
2024,3,5,2,2024-03-05,UA,6309,EWR,MSP,"Newark, NJ",New Jersey,"Minneapolis, MN",Minnesota,1914,2153,-9,-10,1905,2143,17,13,1922,2130,1676,218,238,248,0,,1,0.0,0.0,0.0,0.0,0.0
2024,3,23,6,2024-03-23,OH,2865,JFK,EWR,"New York, NY",New York,"Newark, NJ",New Jersey,1940,1245,12,10,1952,1255,24,6,1976,1249,812,104,124,134,0,,0,0.0,0.0,0.0,0.0,0.0
2024,6,2,7,2024-06-02,OO,7368,EWR,PHX,"Newark, NJ",New Jersey,"Phoenix, AZ",Arizona,547,2149,17,10,564,2159,21,15,585,2144,2662,341,361,377,0,,0,0.0,0.0,0.0,0.0,0.0
2024,9,22,7,2024-09-22,DL,984,EWR,SLC,"Newark, NJ",New Jersey,"Salt Lake City, UT",Utah,1717,663,-28,-20,1689,643,14,5,1703,638,2935,356,376,375,0,,0,0.0,0.0,0.0,0.0,0.0
2024,11,4,1,2024-11-04,MQ,3749,BOS,EWR,"Boston, MA",Massachusetts,"Newark, NJ",New Jersey,1300,2016,1,0,1301,2016,20,5,1321,2011,2231,268,288,293,0,,0,0.0,0.0,0.0,0.0,0.0
2024,3,19,2,2024-03-19,WN,6990,EWR,DCA,"Newark, NJ",New Jersey,"Washington, DC",District of Columbia,1217,2298,-16,-10,1201,2288,24,19,1225,2269,2781,353,373,396,0,,0,0.0,0.0,0.0,0.0,0.0
2024,11,10,7,2024-11-10,HA,3671,HNL,DEN,"Honolulu, HI",Hawaii,"Denver, CO",Colorado,583,2122,2,0,585,2122,20,9,605,2113,716,86,106,115,0,,0,0.0,0.0,0.0,0.0,0.0
2024,5,29,3,2024-05-29,AA,4033,MSP,ATL,"Minneapolis, MN",Minnesota,"Atlanta, GA",Georgia,1112,1117,-8,-10,1104,1107,24,13,1128,1094,2331,297,317,334,0,,0,0.0,0.0,0.0,0.0,0.0
2024,2,17,6,2024-02-17,UA,5956,IAH,IAD,"Houston, TX",Texas,"Washington, DC",District of Columbia,2190,1978,-10,-5,2180,1973,24,6,2204,1967,2242,279,299,309,0,,0,0.0,0.0,0.0,0.0,0.0
2024,9,4,3,2024-09-04,OO,3766,TPA,CLT,"Tampa, FL",Florida,"Charlotte, NC",North Carolina,1570,2256,5,0,1575,2256,20,18,1595,2238,535,61,81,99,0,,0,0.0,0.0,0.0,0.0,0.0
2024,10,4,5,2024-10-04,G4,8666,TPA,MDW,"Tampa, FL",Florida,"Chicago, IL",Illinois,733,1776,-8,0,725,1776,29,9,754,1767,1427,174,194,212,0,,0,0.0,0.0,0.0,0.0,0.0
2024,12,21,6,2024-12-21,NK,657,LGA,DEN,"New York, NY",New York,"Denver, CO",Colorado,1461,928,-9,-5,1452,923,23,18,1475,905,2718,344,364,385,0,,0,0.0,0.0,0.0,0.0,0.0
2024,4,7,7,2024-04-07,NK,9572,CLT,SFO,"Charlotte, NC",North Carolina,"San Francisco, CA",California,1822,1289,-16,-15,1806,1274,17,14,1823,1260,263,38,58,69,0,,0,0.0,0.0,0.0,0.0,0.0
2024,1,25,4,2024-01-25,AA,6140,SEA,DEN,"Seattle, WA",Washington,"Denver, CO",Colorado,1347,1078,13,20,1360,1098,27,11,1387,1087,2501,308,328,346,1,,0,3.0,3.0,1.0,0.0,13.0
2024,10,10,4,2024-10-10,NK,1228,SFO,DTW,"San Francisco, CA",California,"Detroit, MI",Michigan,646,990,-9,-10,637,980,24,12,661,968,1632,199,219,235,0,,0,0.0,0.0,0.0,0.0,0.0
2024,10,27,7,2024-10-27,9E,1460,PHX,CLT,"Phoenix, AZ",Arizona,"Charlotte, NC",North Carolina,695,1174,-5,0,690,1174,15,6,705,1168,1860,232,252,253,0,,0,0.0,0.0,0.0,0.0,0.0
2024,3,8,5,2024-03-08,NK,5520,PHL,DEN,"Philadelphia, PA",Pennsylvania,"Denver, CO",Colorado,1405,1011,-8,-15,1397,996,16,8,1413,988,583,67,87,91,0,,0,0.0,0.0,0.0,0.0,0.0
2024,1,7,7,2024-01-07,WN,9392,IAD,TPA,"Washington, DC",District of Columbia,"Tampa, FL",Florida,1513,1881,1,5,1514,1886,21,14,1535,1872,2345,300,320,335,0,,0,0.0,0.0,0.0,0.0,0.0
2024,10,31,4,2024-10-31,NK,9826,MCO,PHL,"Orlando, FL",Florida,"Philadelphia, PA",Pennsylvania,1545,2200,-24,-15,1521,2185,19,5,1540,2180,324,38,58,62,0,,0,0.0,0.0,0.0,0.0,0.0
2024,5,16,4,2024-05-16,F9,5449,TPA,IAH,"Tampa, FL",Florida,"Houston, TX",Texas,1717,1468,-13,-10,1704,1458,7,4,1711,1454,2351,286,306,297,0,,0,0.0,0.0,0.0,0.0,0.0
2024,6,12,3,2024-06-12,UA,2725,LAS,PDX,"Las Vegas, NV",Nevada,"Portland, OR",Oregon,885,1106,7,0,892,1106,13,19,905,1087,2779,345,365,377,0,,0,0.0,0.0,0.0,0.0,0.0
2024,3,23,6,2024-03-23,MQ,9923,PHX,DEN,"Phoenix, AZ",Arizona,"Denver, CO",Colorado,863,2322,-8,-10,855,2312,14,13,869,2299,2890,353,373,380,0,,0,0.0,0.0,0.0,0.0,0.0
2024,5,17,5,2024-05-17,9E,157,SLC,MCO,"Salt Lake City, UT",Utah,"Orlando, FL",Florida,773,1557,-8,0,765,1557,16,15,781,1542,647,72,92,103,0,,0,0.0,0.0,0.0,0.0,0.0
2024,3,13,3,2024-03-13,DL,9419,ATL,SEA,"Atlanta, GA",Georgia,"Seattle, WA",Washington,1907,2334,-13,-15,1894,2319,26,11,1920,2308,1102,140,160,177,0,,0,0.0,0.0,0.0,0.0,0.0
2024,8,24,6,2024-08-24,NK,8603,PHL,MDW,"Philadelphia, PA",Pennsylvania,"Chicago, IL",Illinois,707,893,-14,-10,693,883,28,19,721,864,458,50,70,97,0,,0,0.0,0.0,0.0,0.0,0.0
2024,2,15,4,2024-02-15,B6,5948,SFO,LAX,"San Francisco, CA",California,"Los Angeles, CA",California,774,1362,-5,5,769,1367,13,15,782,1352,2162,272,292,300,0,,0,0.0,0.0,0.0,0.0,0.0
2024,4,15,1,2024-04-15,B6,2837,IAD,MCO,"Washington, DC",District of Columbia,"Orlando, FL",Florida,1506,2100,-13,-20,1493,2080,28,15,1521,2065,2483,315,335,358,0,,0,0.0,0.0,0.0,0.0,0.0
2024,10,14,1,2024-10-14,OH,5593,PHX,MCO,"Phoenix, AZ",Arizona,"Orlando, FL",Florida,2252,2328,-10,-15,2242,2313,9,4,2251,2309,2036,251,271,264,0,,0,0.0,0.0,0.0,0.0,0.0
2024,9,18,3,2024-09-18,B6,3977,SEA,TPA,"Seattle, WA",Washington,"Tampa, FL",Florida,995,1107,-10,-10,985,1097,26,19,1011,1078,361,48,68,93,0,,0,0.0,0.0,0.0,0.0,0.0
2024,6,24,1,2024-06-24,HA,2382,DTW,DEN,"Detroit, MI",Michigan,"Denver, CO",Colorado,1401,718,-14,-20,1387,698,6,7,1393,691,2460,301,321,314,0,,0,0.0,0.0,0.0,0.0,0.0
2024,6,14,5,2024-06-14,NK,6886,LAX,PHL,"Los Angeles, CA",California,"Philadelphia, PA",Pennsylvania,2062,2314,-21,-15,2041,2299,17,16,2058,2283,2675,326,346,359,0,,0,0.0,0.0,0.0,0.0,0.0
2024,5,24,5,2024-05-24,G4,5608,STL,ATL,"St. Louis, MO",Missouri,"Atlanta, GA",Georgia,2050,1077,-15,-10,2035,1067,15,19,2050,1048,967,124,144,158,0,,0,0.0,0.0,0.0,0.0,0.0
2024,11,25,1,2024-11-25,OO,1531,MIA,PHL,"Miami, FL",Florida,"Philadelphia, PA",Pennsylvania,658,1163,-12,-15,646,1148,13,8,659,1140,625,72,92,93,0,,0,0.0,0.0,0.0,0.0,0.0
2024,10,9,3,2024-10-09,F9,1875,PDX,STL,"Portland, OR",Oregon,"St. Louis, MO",Missouri,1439,2245,13,10,1452,2255,26,11,1478,2244,1675,212,232,249,0,,0,0.0,0.0,0.0,0.0,0.0
2024,2,23,5,2024-02-23,AS,9610,LAX,SFO,"Los Angeles, CA",California,"San Francisco, CA",California,2249,1441,-7,-15,2242,1426,12,14,2254,1412,339,39,59,65,0,,0,0.0,0.0,0.0,0.0,0.0
2024,6,26,3,2024-06-26,NK,4307,SEA,MDW,"Seattle, WA",Washington,"Chicago, IL",Illinois,959,2233,4,10,963,2243,27,14,990,2229,2810,351,371,392,0,,0,0.0,0.0,0.0,0.0,0.0
2024,8,31,6,2024-08-31,G4,9620,DFW,STL,"Dallas/Fort Worth, TX",Texas,"St. Louis, MO",Missouri,893,1942,17,10,910,1952,19,9,929,1943,2332,281,301,309,0,,0,0.0,0.0,0.0,0.0,0.0
2024,12,6,5,2024-12-06,OH,4485,IAD,STL,"Washington, DC",District of Columbia,"St. Louis, MO",Missouri,1416,2018,-15,-15,1401,2003,20,7,1421,1996,2358,302,322,329,0,,0,0.0,0.0,0.0,0.0,0.0
2024,5,6,1,2024-05-06,OO,6451,MCO,LAX,"Orlando, FL",Florida,"Los Angeles, CA",California,1442,1671,-19,-20,1423,1651,14,13,1437,1638,1358,160,180,187,0,,0,0.0,0.0,0.0,0.0,0.0
2024,9,27,5,2024-09-27,AS,4074,PHX,DCA,"Phoenix, AZ",Arizona,"Washington, DC",District of Columbia,938,2236,-12,-20,926,2216,6,16,932,2200,314,31,51,53,0,,0,0.0,0.0,0.0,0.0,0.0
2024,5,11,6,2024-05-11,AA,6005,SLC,BWI,"Salt Lake City, UT",Utah,"Baltimore, MD",Maryland,1902,2061,6,0,1908,2061,19,9,1927,2052,2437,310,330,338,0,,0,0.0,0.0,0.0,0.0,0.0
2024,4,2,2,2024-04-02,WN,4777,ORD,SLC,"Chicago, IL",Illinois,"Salt Lake City, UT",Utah,663,1074,11,5,674,1079,22,13,696,1066,1666,204,224,239,0,,0,0.0,0.0,0.0,0.0,0.0
2024,3,13,3,2024-03-13,F9,4565,SAN,CLT,"San Diego, CA",California,"Charlotte, NC",North Carolina,1138,1545,-9,0,1129,1545,17,4,1146,1541,239,29,49,50,0,,0,0.0,0.0,0.0,0.0,0.0
2024,9,4,3,2024-09-04,NK,8511,ORD,DTW,"Chicago, IL",Illinois,"Detroit, MI",Michigan,1853,1351,-5,0,1848,1351,9,19,1857,1332,309,43,63,71,0,,0,0.0,0.0,0.0,0.0,0.0
2024,12,13,5,2024-12-13,UA,3402,SLC,IAH,"Salt Lake City, UT",Utah,"Houston, TX",Texas,1069,2209,-2,-10,1067,2199,23,17,1090,2182,736,99,119,139,0,,0,0.0,0.0,0.0,0.0,0.0
2024,9,29,7,2024-09-29,9E,7045,SEA,EWR,"Seattle, WA",Washington,"Newark, NJ",New Jersey,646,1149,5,10,651,1159,5,3,656,1156,832,112,132,120,0,,0,0.0,0.0,0.0,0.0,0.0
2024,2,12,1,2024-02-12,UA,2402,IAH,SAN,"Houston, TX",Texas,"San Diego, CA",California,1482,1327,-15,-5,1467,1322,7,15,1474,1307,1997,258,278,280,0,,0,0.0,0.0,0.0,0.0,0.0
2024,2,10,6,2024-02-10,OO,6385,ORD,DEN,"Chicago, IL",Illinois,"Denver, CO",Colorado,1459,735,33,30,1492,765,27,8,1519,757,2978,371,391,406,0,,0,5.0,2.0,2.0,0.0,21.0
2024,6,18,2,2024-06-18,UA,5066,MCO,TPA,"Orlando, FL",Florida,"Tampa, FL",Florida,1267,1117,-14,-5,1253,1112,14,4,1267,1108,2183,273,293,291,0,,0,0.0,0.0,0.0,0.0,0.0
2024,7,30,2,2024-07-30,YX,3826,STL,DEN,"St. Louis, MO",Missouri,"Denver, CO",Colorado,609,1358,-9,-10,600,1348,19,4,619,1344,755,97,117,120,0,,0,0.0,0.0,0.0,0.0,0.0
2024,6,16,7,2024-06-16,HA,2142,MSP,JFK,"Minneapolis, MN",Minnesota,"New York, NY",New York,893,923,16,10,909,933,29,12,938,921,2248,278,298,319,0,,0,0.0,0.0,0.0,0.0,0.0
2024,2,8,4,2024-02-08,AA,8814,PDX,TPA,"Portland, OR",Oregon,"Tampa, FL",Florida,2084,1820,-7,0,2077,1820,20,14,2097,1806,1816,223,243,257,0,,0,0.0,0.0,0.0,0.0,0.0
2024,9,1,7,2024-09-01,HA,3098,HNL,PHL,"Honolulu, HI",Hawaii,"Philadelphia, PA",Pennsylvania,1705,710,-2,5,1703,715,8,15,1711,700,1100,139,159,162,0,,0,0.0,0.0,0.0,0.0,0.0
2024,5,30,4,2024-05-30,9E,8071,MDW,BWI,"Chicago, IL",Illinois,"Baltimore, MD",Maryland,2096,2173,-9,-5,2087,2168,28,10,2115,2158,1651,208,228,246,0,,0,0.0,0.0,0.0,0.0,0.0
2024,4,20,6,2024-04-20,AA,1009,BOS,DCA,"Boston, MA",Massachusetts,"Washington, DC",District of Columbia,942,1738,12,10,954,1748,26,18,980,1730,1537,188,208,232,0,,0,0.0,0.0,0.0,0.0,0.0
2024,2,16,5,2024-02-16,AS,4233,SFO,DCA,"San Francisco, CA",California,"Washington, DC",District of Columbia,1246,2320,21,15,1267,2335,24,13,1291,2322,1113,141,161,178,0,,0,0.0,0.0,0.0,0.0,0.0
2024,3,3,7,2024-03-03,OH,1980,BWI,EWR,"Baltimore, MD",Maryland,"Newark, NJ",New Jersey,1253,1323,-2,-5,1251,1318,7,6,1258,1312,1386,171,191,184,0,,0,0.0,0.0,0.0,0.0,0.0
2024,8,12,1,2024-08-12,OH,2660,DEN,TPA,"Denver, CO",Colorado,"Tampa, FL",Florida,629,1087,-4,-10,625,1077,9,19,634,1058,1899,232,252,260,0,,0,0.0,0.0,0.0,0.0,0.0
2024,3,9,6,2024-03-09,AA,7627,DEN,LAS,"Denver, CO",Colorado,"Las Vegas, NV",Nevada,2299,964,5,0,2304,964,7,10,2311,954,201,15,35,32,0,,0,0.0,0.0,0.0,0.0,0.0
2024,10,25,5,2024-10-25,B6,5796,MIA,DFW,"Miami, FL",Florida,"Dallas/Fort Worth, TX",Texas,1926,2107,25,20,1951,2127,12,3,1963,2124,2226,286,306,301,0,,0,4.0,2.0,1.0,0.0,13.0
2024,10,16,3,2024-10-16,WN,3172,PHL,SFO,"Philadelphia, PA",Pennsylvania,"San Francisco, CA",California,1004,1366,-5,0,999,1366,10,5,1009,1361,1501,193,213,208,0,,0,0.0,0.0,0.0,0.0,0.0
2024,10,22,2,2024-10-22,B6,4576,IAD,LAS,"Washington, DC",District of Columbia,"Las Vegas, NV",Nevada,1219,1431,11,20,1230,1451,19,15,1249,1436,1022,118,138,152,0,,0,4.0,3.0,2.0,0.0,11.0
2024,7,21,7,2024-07-21,NK,4589,JFK,DFW,"New York, NY",New York,"Dallas/Fort Worth, TX",Texas,2177,1933,1,-5,2178,1928,10,3,2188,1925,1142,150,170,163,0,,0,0.0,0.0,0.0,0.0,0.0
2024,3,1,5,2024-03-01,AS,4591,TPA,PHX,"Tampa, FL",Florida,"Phoenix, AZ",Arizona,521,712,6,15,527,727,27,4,554,723,2911,363,383,394,0,,0,0.0,0.0,0.0,0.0,0.0
2024,11,13,3,2024-11-13,YX,8836,LAX,HNL,"Los Angeles, CA",California,"Honolulu, HI",Hawaii,1540,1893,-8,-15,1532,1878,11,7,1543,1871,2279,277,297,295,0,,0,0.0,0.0,0.0,0.0,0.0
2024,11,9,6,2024-11-09,G4,6955,HNL,EWR,"Honolulu, HI",Hawaii,"Newark, NJ",New Jersey,1374,919,4,-5,1378,914,12,10,1390,904,1321,156,176,178,0,,0,0.0,0.0,0.0,0.0,0.0
2024,6,9,7,2024-06-09,AS,7501,ORD,BOS,"Chicago, IL",Illinois,"Boston, MA",Massachusetts,1330,774,1,0,1331,774,20,19,1351,755,428,45,65,84,0,,0,0.0,0.0,0.0,0.0,0.0
2024,11,26,2,2024-11-26,G4,3197,BOS,MSP,"Boston, MA",Massachusetts,"Minneapolis, MN",Minnesota,1133,1642,-2,5,1131,1647,25,4,1156,1643,977,128,148,157,0,,0,0.0,0.0,0.0,0.0,0.0
2024,1,16,2,2024-01-16,WN,3605,MIA,TPA,"Miami, FL",Florida,"Tampa, FL",Florida,781,1826,-12,-10,769,1816,17,10,786,1806,2718,341,361,368,0,,0,0.0,0.0,0.0,0.0,0.0
2024,12,3,2,2024-12-03,AA,1184,TPA,MSP,"Tampa, FL",Florida,"Minneapolis, MN",Minnesota,1750,725,15,15,1765,740,9,13,1774,727,570,77,97,99,0,,0,0.0,0.0,0.0,0.0,0.0
2024,4,3,3,2024-04-03,AA,652,IAD,ATL,"Washington, DC",District of Columbia,"Atlanta, GA",Georgia,1943,1594,21,15,1964,1609,26,15,1990,1594,301,32,52,73,0,,0,0.0,0.0,0.0,0.0,0.0
2024,10,30,3,2024-10-30,9E,5660,DTW,BOS,"Detroit, MI",Michigan,"Boston, MA",Massachusetts,872,2090,7,5,879,2095,24,9,903,2086,401,59,79,92,0,,0,0.0,0.0,0.0,0.0,0.0
2024,5,17,5,2024-05-17,NK,1253,MSP,MDW,"Minneapolis, MN",Minnesota,"Chicago, IL",Illinois,1824,853,-7,-15,1817,838,6,8,1823,830,2766,345,365,359,0,,0,0.0,0.0,0.0,0.0,0.0
2024,12,3,2,2024-12-03,MQ,5573,BOS,LAS,"Boston, MA",Massachusetts,"Las Vegas, NV",Nevada,1508,1528,-18,-15,1490,1513,18,15,1508,1498,1015,125,145,158,0,,0,0.0,0.0,0.0,0.0,0.0
2024,2,7,3,2024-02-07,MQ,2345,DCA,STL,"Washington, DC",District of Columbia,"St. Louis, MO",Missouri,785,1366,-6,0,779,1366,22,19,801,1347,2492,316,336,357,0,,0,0.0,0.0,0.0,0.0,0.0
2024,5,6,1,2024-05-06,MQ,1786,DFW,CLT,"Dallas/Fort Worth, TX",Texas,"Charlotte, NC",North Carolina,1639,891,4,5,1643,896,22,6,1665,890,788,98,118,126,0,,0,0.0,0.0,0.0,0.0,0.0
2024,10,1,2,2024-10-01,UA,5935,BWI,BOS,"Baltimore, MD",Maryland,"Boston, MA",Massachusetts,1672,1775,-11,-15,1661,1760,22,13,1683,1747,2962,363,383,398,0,,0,0.0,0.0,0.0,0.0,0.0
2024,6,12,3,2024-06-12,DL,793,HNL,SFO,"Honolulu, HI",Hawaii,"San Francisco, CA",California,903,798,8,0,911,798,19,19,930,779,2383,305,325,343,0,,0,0.0,0.0,0.0,0.0,0.0
2024,11,14,4,2024-11-14,OH,7638,BOS,BWI,"Boston, MA",Massachusetts,"Baltimore, MD",Maryland,2205,1822,-2,0,2203,1822,9,3,2212,1819,670,75,95,87,0,,1,0.0,0.0,0.0,0.0,0.0
2024,3,17,7,2024-03-17,AS,8191,IAD,STL,"Washington, DC",District of Columbia,"St. Louis, MO",Missouri,589,1286,10,5,599,1291,6,13,605,1278,1323,169,189,188,0,,0,0.0,0.0,0.0,0.0,0.0
2024,6,22,6,2024-06-22,AS,5935,LGA,MDW,"New York, NY",New York,"Chicago, IL",Illinois,1642,2076,0,-5,1642,2071,27,15,1669,2056,2254,285,305,327,0,,0,0.0,0.0,0.0,0.0,0.0
2024,12,23,1,2024-12-23,MQ,8789,PDX,JFK,"Portland, OR",Oregon,"New York, NY",New York,1195,1381,2,5,1197,1386,15,16,1212,1370,977,125,145,156,0,,0,0.0,0.0,0.0,0.0,0.0
2024,11,16,6,2024-11-16,NK,6894,STL,MCO,"St. Louis, MO",Missouri,"Orlando, FL",Florida,1407,1540,-18,-10,1389,1530,24,18,1413,1512,595,81,101,123,0,,0,0.0,0.0,0.0,0.0,0.0
2024,3,31,7,2024-03-31,B6,8904,EWR,ATL,"Newark, NJ",New Jersey,"Atlanta, GA",Georgia,2299,1803,-18,-10,2281,1793,14,16,2295,1777,678,83,103,113,1,,0,0.0,0.0,0.0,0.0,0.0
2024,8,25,7,2024-08-25,F9,8667,MSP,SEA,"Minneapolis, MN",Minnesota,"Seattle, WA",Washington,2262,817,14,15,2276,832,9,9,2285,823,1132,135,155,153,0,,0,0.0,0.0,0.0,0.0,0.0
2024,9,20,5,2024-09-20,NK,905,DCA,CLT,"Washington, DC",District of Columbia,"Charlotte, NC",North Carolina,1616,1229,-4,-5,1612,1224,6,7,1618,1217,353,39,59,52,0,,0,0.0,0.0,0.0,0.0,0.0
2024,6,27,4,2024-06-27,DL,1020,SEA,LAS,"Seattle, WA",Washington,"Las Vegas, NV",Nevada,1128,1417,34,30,1162,1447,16,11,1178,1436,204,26,46,53,0,,0,3.0,1.0,0.0,0.0,26.0
2024,7,27,6,2024-07-27,HA,3704,DTW,SFO,"Detroit, MI",Michigan,"San Francisco, CA",California,1501,1432,-16,-20,1485,1412,21,13,1506,1399,1910,228,248,262,0,,0,0.0,0.0,0.0,0.0,0.0
2024,3,13,3,2024-03-13,AA,1543,MSP,TPA,"Minneapolis, MN",Minnesota,"Tampa, FL",Florida,946,1943,8,0,954,1943,29,11,983,1932,974,122,142,162,0,,0,0.0,0.0,0.0,0.0,0.0
2024,4,16,2,2024-04-16,MQ,7148,MCO,ATL,"Orlando, FL",Florida,"Atlanta, GA",Georgia,811,622,-2,-5,809,617,26,11,835,606,1515,189,209,226,0,,0,0.0,0.0,0.0,0.0,0.0
2024,12,10,2,2024-12-10,OH,1645,STL,BOS,"St. Louis, MO",Missouri,"Boston, MA",Massachusetts,1841,1236,60,60,1901,1296,9,8,1910,1288,1646,204,224,221,0,,0,2.0,3.0,8.0,0.0,47.0
2024,10,21,1,2024-10-21,G4,1310,PHX,DCA,"Phoenix, AZ",Arizona,"Washington, DC",District of Columbia,620,1707,40,45,660,1752,25,8,685,1744,453,47,67,80,0,,0,4.0,7.0,4.0,0.0,30.0
2024,10,10,4,2024-10-10,B6,6312,LGA,ATL,"New York, NY",New York,"Atlanta, GA",Georgia,816,1310,-9,-10,807,1300,22,6,829,1294,2603,329,349,357,0,,0,0.0,0.0,0.0,0.0,0.0
2024,12,18,3,2024-12-18,YX,4787,DCA,EWR,"Washington, DC",District of Columbia,"Newark, NJ",New Jersey,637,1949,-3,-10,634,1939,20,13,654,1926,1288,169,189,202,0,,0,0.0,0.0,0.0,0.0,0.0
2024,6,30,7,2024-06-30,OO,5410,EWR,PHL,"Newark, NJ",New Jersey,"Philadelphia, PA",Pennsylvania,2266,1298,-4,5,2262,1303,12,4,2274,1299,2249,289,309,305,0,,0,0.0,0.0,0.0,0.0,0.0
2024,2,6,2,2024-02-06,B6,9800,PHL,IAD,"Philadelphia, PA",Pennsylvania,"Washington, DC",District of Columbia,1317,928,15,10,1332,938,8,14,1340,924,778,98,118,120,0,,0,0.0,0.0,0.0,0.0,0.0
2024,5,16,4,2024-05-16,YX,1013,IAD,ORD,"Washington, DC",District of Columbia,"Chicago, IL",Illinois,2183,2227,-2,5,2181,2232,8,10,2189,2222,302,45,65,63,0,,0,0.0,0.0,0.0,0.0,0.0
2024,12,3,2,2024-12-03,9E,2880,IAH,DFW,"Houston, TX",Texas,"Dallas/Fort Worth, TX",Texas,1807,1953,3,10,1810,1963,28,15,1838,1948,1493,179,199,222,0,,0,0.0,0.0,0.0,0.0,0.0
2024,2,25,7,2024-02-25,WN,8681,SEA,DEN,"Seattle, WA",Washington,"Denver, CO",Colorado,2177,2317,-9,-15,2168,2302,8,6,2176,2296,2242,281,301,295,0,,0,0.0,0.0,0.0,0.0,0.0
2024,7,5,5,2024-07-05,DL,7832,MCO,DTW,"Orlando, FL",Florida,"Detroit, MI",Michigan,2043,1310,9,0,2052,1310,21,11,2073,1299,2496,302,322,334,1,,0,0.0,0.0,0.0,0.0,0.0
2024,12,6,5,2024-12-06,B6,5087,SLC,DCA,"Salt Lake City, UT",Utah,"Washington, DC",District of Columbia,2028,1072,4,5,2032,1077,24,18,2056,1059,544,58,78,100,0,,0,0.0,0.0,0.0,0.0,0.0
2024,9,14,6,2024-09-14,DL,3725,DEN,HNL,"Denver, CO",Colorado,"Honolulu, HI",Hawaii,890,1077,-3,-10,887,1067,14,4,901,1063,2220,271,291,289,0,,0,0.0,0.0,0.0,0.0,0.0
2024,2,27,2,2024-02-27,YX,9362,EWR,SEA,"Newark, NJ",New Jersey,"Seattle, WA",Washington,1528,1858,13,5,1541,1863,5,7,1546,1856,2454,308,328,320,0,,0,0.0,0.0,0.0,0.0,0.0
2024,12,28,6,2024-12-28,NK,7426,ORD,SAN,"Chicago, IL",Illinois,"San Diego, CA",California,1268,1521,15,15,1283,1536,26,16,1309,1520,1719,220,240,262,0,,0,0.0,0.0,0.0,0.0,0.0
2024,5,2,4,2024-05-02,OO,2670,DFW,LAX,"Dallas/Fort Worth, TX",Texas,"Los Angeles, CA",California,866,1155,13,10,879,1165,22,13,901,1152,752,100,120,135,0,,0,0.0,0.0,0.0,0.0,0.0
2024,7,6,6,2024-07-06,G4,3837,LAX,DCA,"Los Angeles, CA",California,"Washington, DC",District of Columbia,1340,1187,-17,-10,1323,1177,19,5,1342,1172,1935,231,251,255,0,,0,0.0,0.0,0.0,0.0,0.0
2024,8,17,6,2024-08-17,G4,2879,IAD,SEA,"Washington, DC",District of Columbia,"Seattle, WA",Washington,991,2276,0,-5,991,2271,29,11,1020,2260,449,62,82,102,0,,0,0.0,0.0,0.0,0.0,0.0
2024,6,16,7,2024-06-16,OO,8630,PDX,LAS,"Portland, OR",Oregon,"Las Vegas, NV",Nevada,1257,1293,-8,0,1249,1293,14,7,1263,1286,2557,310,330,331,0,,0,0.0,0.0,0.0,0.0,0.0
2024,4,23,2,2024-04-23,AS,2076,SAN,BWI,"San Diego, CA",California,"Baltimore, MD",Maryland,1989,718,-10,-10,1979,708,20,11,1999,697,1860,232,252,263,0,,0,0.0,0.0,0.0,0.0,0.0
2024,9,8,7,2024-09-08,AA,894,JFK,DCA,"New York, NY",New York,"Washington, DC",District of Columbia,1758,1663,14,20,1772,1683,8,11,1780,1672,2353,301,321,320,0,,0,1.0,0.0,0.0,0.0,19.0
2024,4,16,2,2024-04-16,MQ,1822,PHL,DFW,"Philadelphia, PA",Pennsylvania,"Dallas/Fort Worth, TX",Texas,1885,859,-19,-10,1866,849,28,4,1894,845,1625,206,226,238,0,,0,0.0,0.0,0.0,0.0,0.0
2024,2,6,2,2024-02-06,AS,998,SFO,LAX,"San Francisco, CA",California,"Los Angeles, CA",California,1021,1548,6,5,1027,1553,22,8,1049,1545,2777,349,369,379,0,,0,0.0,0.0,0.0,0.0,0.0
2024,11,30,6,2024-11-30,B6,202,MDW,SEA,"Chicago, IL",Illinois,"Seattle, WA",Washington,1765,1355,-3,-5,1762,1350,25,6,1787,1344,2394,293,313,324,0,,0,0.0,0.0,0.0,0.0,0.0
2024,4,1,1,2024-04-01,WN,7553,ORD,EWR,"Chicago, IL",Illinois,"Newark, NJ",New Jersey,1965,2264,-9,0,1956,2264,15,3,1971,2261,876,109,129,127,1,,0,0.0,0.0,0.0,0.0,0.0
2024,1,18,4,2024-01-18,YX,9739,BOS,PDX,"Boston, MA",Massachusetts,"Portland, OR",Oregon,687,605,-26,-20,661,585,12,15,673,570,2728,343,363,370,0,,0,0.0,0.0,0.0,0.0,0.0
2024,12,19,4,2024-12-19,AS,2132,IAH,TPA,"Houston, TX",Texas,"Tampa, FL",Florida,903,910,-2,-10,901,900,5,7,906,893,295,41,61,53,0,,0,0.0,0.0,0.0,0.0,0.0
2024,3,3,7,2024-03-03,AS,6272,MSP,PHL,"Minneapolis, MN",Minnesota,"Philadelphia, PA",Pennsylvania,926,665,-11,-5,915,660,26,16,941,644,288,34,54,76,0,,0,0.0,0.0,0.0,0.0,0.0
2024,5,29,3,2024-05-29,OH,1634,DFW,IAD,"Dallas/Fort Worth, TX",Texas,"Washington, DC",District of Columbia,912,1997,-3,5,909,2002,6,16,915,1986,414,44,64,66,0,,0,0.0,0.0,0.0,0.0,0.0
2024,5,18,6,2024-05-18,AS,7297,IAD,SLC,"Washington, DC",District of Columbia,"Salt Lake City, UT",Utah,2037,1330,13,5,2050,1335,25,3,2075,1332,2962,363,383,391,0,,0,0.0,0.0,0.0,0.0,0.0
2024,7,4,4,2024-07-04,DL,4670,BWI,LAS,"Baltimore, MD",Maryland,"Las Vegas, NV",Nevada,653,1769,-12,-20,641,1749,21,9,662,1740,2396,299,319,329,0,,0,0.0,0.0,0.0,0.0,0.0
2024,7,3,3,2024-07-03,HA,6806,BWI,DCA,"Baltimore, MD",Maryland,"Washington, DC",District of Columbia,702,1857,-10,-10,692,1847,24,19,716,1828,2418,297,317,340,0,,0,0.0,0.0,0.0,0.0,0.0
2024,7,23,2,2024-07-23,OH,534,PDX,SEA,"Portland, OR",Oregon,"Seattle, WA",Washington,716,628,6,5,722,633,23,5,745,628,1578,205,225,233,0,,0,0.0,0.0,0.0,0.0,0.0
2024,9,16,1,2024-09-16,NK,9549,DCA,ORD,"Washington, DC",District of Columbia,"Chicago, IL",Illinois,981,2296,18,10,999,2306,14,3,1013,2303,998,133,153,150,0,,0,0.0,0.0,0.0,0.0,0.0
2024,8,1,4,2024-08-01,OH,8346,LAX,BOS,"Los Angeles, CA",California,"Boston, MA",Massachusetts,1838,2266,-1,-10,1837,2256,25,3,1862,2253,2068,256,276,284,0,,0,0.0,0.0,0.0,0.0,0.0
2024,9,12,4,2024-09-12,WN,9222,DEN,IAD,"Denver, CO",Colorado,"Washington, DC",District of Columbia,2140,1259,-11,-10,2129,1249,12,14,2141,1235,433,44,64,70,0,,0,0.0,0.0,0.0,0.0,0.0
2024,5,14,2,2024-05-14,MQ,8603,DCA,MSP,"Washington, DC",District of Columbia,"Minneapolis, MN",Minnesota,1524,1499,-9,-15,1515,1484,29,15,1544,1469,337,50,70,94,0,,0,0.0,0.0,0.0,0.0,0.0
2024,3,1,5,2024-03-01,HA,7356,SEA,MDW,"Seattle, WA",Washington,"Chicago, IL",Illinois,1265,2217,-9,-10,1256,2207,25,6,1281,2201,759,92,112,123,0,,0,0.0,0.0,0.0,0.0,0.0
2024,12,28,6,2024-12-28,YX,9248,LGA,LAS,"New York, NY",New York,"Las Vegas, NV",Nevada,1002,1503,-28,-20,974,1483,13,17,987,1466,2502,313,333,343,0,,0,0.0,0.0,0.0,0.0,0.0
2024,11,5,2,2024-11-05,G4,6561,BOS,DEN,"Boston, MA",Massachusetts,"Denver, CO",Colorado,1298,2093,-3,0,1295,2093,14,19,1309,2074,2055,252,272,285,0,,0,0.0,0.0,0.0,0.0,0.0
2024,3,28,4,2024-03-28,9E,4183,MDW,BWI,"Chicago, IL",Illinois,"Baltimore, MD",Maryland,1305,960,12,15,1317,975,24,8,1341,967,1590,198,218,230,0,,0,0.0,0.0,0.0,0.0,0.0
2024,11,19,2,2024-11-19,DL,6096,HNL,PDX,"Honolulu, HI",Hawaii,"Portland, OR",Oregon,1801,2218,-13,-15,1788,2203,9,15,1797,2188,1903,228,248,252,0,,0,0.0,0.0,0.0,0.0,0.0
2024,7,25,4,2024-07-25,B6,4952,EWR,LAX,"Newark, NJ",New Jersey,"Los Angeles, CA",California,1717,1561,7,5,1724,1566,13,9,1737,1557,1299,162,182,184,0,,0,0.0,0.0,0.0,0.0,0.0
2024,5,8,3,2024-05-08,OH,2612,LAX,BOS,"Los Angeles, CA",California,"Boston, MA",Massachusetts,1442,2208,-1,0,1441,2208,15,7,1456,2201,948,112,132,134,0,,0,0.0,0.0,0.0,0.0,0.0
2024,11,6,3,2024-11-06,WN,5628,SEA,MCO,"Seattle, WA",Washington,"Orlando, FL",Florida,1268,1978,19,15,1287,1993,29,13,1316,1980,643,85,105,127,0,,0,0.0,0.0,0.0,0.0,0.0
2024,1,3,3,2024-01-03,G4,1363,LGA,LAX,"New York, NY",New York,"Los Angeles, CA",California,1261,2349,10,5,1271,2354,22,7,1293,2347,2032,258,278,287,0,,0,0.0,0.0,0.0,0.0,0.0
2024,8,29,4,2024-08-29,WN,6051,ORD,DFW,"Chicago, IL",Illinois,"Dallas/Fort Worth, TX",Texas,1771,625,12,10,1783,635,25,3,1808,632,1697,218,238,246,0,,0,0.0,0.0,0.0,0.0,0.0
2024,4,30,2,2024-04-30,F9,2847,LAS,LAX,"Las Vegas, NV",Nevada,"Los Angeles, CA",California,587,1913,0,0,587,1913,28,15,615,1898,370,52,72,95,0,,0,0.0,0.0,0.0,0.0,0.0
2024,4,11,4,2024-04-11,F9,7380,PDX,HNL,"Portland, OR",Oregon,"Honolulu, HI",Hawaii,933,670,11,10,944,680,5,14,949,666,2055,261,281,280,0,,0,0.0,0.0,0.0,0.0,0.0
2024,2,7,3,2024-02-07,AS,1193,DCA,DFW,"Washington, DC",District of Columbia,"Dallas/Fort Worth, TX",Texas,919,2312,-2,-5,917,2307,20,16,937,2291,2215,277,297,313,0,,0,0.0,0.0,0.0,0.0,0.0
2024,12,6,5,2024-12-06,AS,3863,PDX,CLT,"Portland, OR",Oregon,"Charlotte, NC",North Carolina,1776,1712,-1,-10,1775,1702,24,3,1799,1699,2276,284,304,311,0,,0,0.0,0.0,0.0,0.0,0.0
2024,5,12,7,2024-05-12,OO,7451,STL,IAH,"St. Louis, MO",Missouri,"Houston, TX",Texas,928,776,7,15,935,791,28,15,963,776,701,84,104,127,0,,0,0.0,0.0,0.0,0.0,0.0
2024,7,20,6,2024-07-20,F9,332,LAX,TPA,"Los Angeles, CA",California,"Tampa, FL",Florida,1687,626,9,5,1696,631,14,19,1710,612,2405,297,317,330,0,,0,0.0,0.0,0.0,0.0,0.0
2024,12,13,5,2024-12-13,YX,2201,BWI,CLT,"Baltimore, MD",Maryland,"Charlotte, NC",North Carolina,2018,1912,-15,-15,2003,1897,22,10,2025,1887,740,93,113,125,0,,0,0.0,0.0,0.0,0.0,0.0
2024,1,21,7,2024-01-21,MQ,2128,STL,HNL,"St. Louis, MO",Missouri,"Honolulu, HI",Hawaii,661,1439,2,10,663,1449,5,10,668,1439,674,92,112,107,0,,0,0.0,0.0,0.0,0.0,0.0
2024,8,29,4,2024-08-29,YX,6333,MIA,ORD,"Miami, FL",Florida,"Chicago, IL",Illinois,1006,1416,2,-5,1008,1411,10,10,1018,1401,406,58,78,78,0,,0,0.0,0.0,0.0,0.0,0.0
2024,4,18,4,2024-04-18,9E,8026,JFK,SFO,"New York, NY",New York,"San Francisco, CA",California,764,1174,-13,-10,751,1164,26,19,777,1145,1707,220,240,265,0,,0,0.0,0.0,0.0,0.0,0.0
2024,10,29,2,2024-10-29,G4,2029,JFK,PDX,"New York, NY",New York,"Portland, OR",Oregon,609,1599,-3,0,606,1599,5,14,611,1585,547,58,78,77,0,,0,0.0,0.0,0.0,0.0,0.0
2024,3,24,7,2024-03-24,HA,9750,LAS,DEN,"Las Vegas, NV",Nevada,"Denver, CO",Colorado,1399,1130,2,0,1401,1130,7,13,1408,1117,1687,214,234,234,0,,0,0.0,0.0,0.0,0.0,0.0
2024,3,23,6,2024-03-23,B6,9940,CLT,SLC,"Charlotte, NC",North Carolina,"Salt Lake City, UT",Utah,2242,2107,-5,0,2237,2107,17,19,2254,2088,1670,213,233,249,0,,0,0.0,0.0,0.0,0.0,0.0
2024,10,17,4,2024-10-17,OO,8699,DCA,SEA,"Washington, DC",District of Columbia,"Seattle, WA",Washington,1842,2057,-11,-10,1831,2047,16,9,1847,2038,1107,144,164,169,0,,0,0.0,0.0,0.0,0.0,0.0
2024,3,9,6,2024-03-09,AA,3440,BWI,PHL,"Baltimore, MD",Maryland,"Philadelphia, PA",Pennsylvania,1655,1092,24,20,1679,1112,28,12,1707,1100,2144,265,285,305,0,,0,6.0,5.0,3.0,0.0,6.0
2024,5,8,3,2024-05-08,AA,2077,SFO,HNL,"San Francisco, CA",California,"Honolulu, HI",Hawaii,1656,877,14,20,1670,897,18,19,1688,878,1359,168,188,205,0,,0,2.0,0.0,2.0,0.0,16.0
2024,7,14,7,2024-07-14,HA,2513,BWI,SFO,"Baltimore, MD",Maryland,"San Francisco, CA",California,893,1598,-30,-20,863,1578,29,19,892,1559,1991,243,263,291,0,,0,0.0,0.0,0.0,0.0,0.0
2024,5,19,7,2024-05-19,DL,8126,BWI,MSP,"Baltimore, MD",Maryland,"Minneapolis, MN",Minnesota,1119,1969,-8,-5,1111,1964,28,13,1139,1951,2623,318,338,359,0,,0,0.0,0.0,0.0,0.0,0.0
2024,10,9,3,2024-10-09,9E,5518,MIA,LAX,"Miami, FL",Florida,"Los Angeles, CA",California,1183,2202,-29,-20,1154,2182,21,11,1175,2171,2744,334,354,366,0,,0,0.0,0.0,0.0,0.0,0.0
2024,11,7,4,2024-11-07,9E,6125,ORD,TPA,"Chicago, IL",Illinois,"Tampa, FL",Florida,1051,1861,0,10,1051,1871,20,10,1071,1861,551,75,95,105,0,,0,0.0,0.0,0.0,0.0,0.0
2024,8,21,3,2024-08-21,B6,5037,EWR,DTW,"Newark, NJ",New Jersey,"Detroit, MI",Michigan,1303,1760,15,10,1318,1770,17,13,1335,1757,2335,292,312,322,0,,0,0.0,0.0,0.0,0.0,0.0
2024,1,23,2,2024-01-23,WN,3697,EWR,PDX,"Newark, NJ",New Jersey,"Portland, OR",Oregon,1558,1786,-6,0,1552,1786,8,6,1560,1780,2636,326,346,340,0,,0,0.0,0.0,0.0,0.0,0.0
2024,6,1,6,2024-06-01,AA,1478,MCO,HNL,"Orlando, FL",Florida,"Honolulu, HI",Hawaii,2094,1438,18,10,2112,1448,19,10,2131,1438,1370,161,181,190,0,,0,0.0,0.0,0.0,0.0,0.0
2024,10,3,4,2024-10-03,WN,720,DTW,DEN,"Detroit, MI",Michigan,"Denver, CO",Colorado,2228,1446,5,5,2233,1451,13,11,2246,1440,2328,293,313,317,0,,0,0.0,0.0,0.0,0.0,0.0
2024,3,1,5,2024-03-01,WN,1029,BOS,HNL,"Boston, MA",Massachusetts,"Honolulu, HI",Hawaii,1221,1499,-3,0,1218,1499,21,16,1239,1483,1379,171,191,208,0,,0,0.0,0.0,0.0,0.0,0.0
2024,11,14,4,2024-11-14,9E,6644,IAD,DFW,"Washington, DC",District of Columbia,"Dallas/Fort Worth, TX",Texas,1895,892,-12,-5,1883,887,15,16,1898,871,1503,180,200,211,0,,0,0.0,0.0,0.0,0.0,0.0
2024,2,21,3,2024-02-21,WN,7672,SLC,ATL,"Salt Lake City, UT",Utah,"Atlanta, GA",Georgia,530,1651,-7,-10,523,1641,24,3,547,1638,2451,304,324,331,0,,0,0.0,0.0,0.0,0.0,0.0
2024,12,9,1,2024-12-09,AA,5926,STL,DEN,"St. Louis, MO",Missouri,"Denver, CO",Colorado,1697,855,-4,-10,1693,845,11,17,1704,828,2022,248,268,276,0,,0,0.0,0.0,0.0,0.0,0.0
2024,6,1,6,2024-06-01,G4,1074,SAN,MCO,"San Diego, CA",California,"Orlando, FL",Florida,1316,1504,-2,0,1314,1504,11,10,1325,1494,1166,153,173,174,0,,0,0.0,0.0,0.0,0.0,0.0
2024,8,24,6,2024-08-24,OH,1789,DCA,ATL,"Washington, DC",District of Columbia,"Atlanta, GA",Georgia,1913,2247,-17,-10,1896,2237,27,7,1923,2230,2122,264,284,298,0,,0,0.0,0.0,0.0,0.0,0.0
2024,11,6,3,2024-11-06,UA,4771,PDX,MSP,"Portland, OR",Oregon,"Minneapolis, MN",Minnesota,2233,1264,-19,-10,2214,1254,8,18,2222,1236,2451,298,318,324,0,,0,0.0,0.0,0.0,0.0,0.0
2024,10,28,1,2024-10-28,MQ,7020,PHL,IAD,"Philadelphia, PA",Pennsylvania,"Washington, DC",District of Columbia,605,864,-21,-20,584,844,12,12,596,832,673,91,111,115,0,,0,0.0,0.0,0.0,0.0,0.0
2024,2,1,4,2024-02-01,WN,6876,SLC,DFW,"Salt Lake City, UT",Utah,"Dallas/Fort Worth, TX",Texas,1798,2187,8,0,1806,2187,23,13,1829,2174,943,114,134,150,0,,0,0.0,0.0,0.0,0.0,0.0
2024,2,24,6,2024-02-24,B6,9017,SLC,MDW,"Salt Lake City, UT",Utah,"Chicago, IL",Illinois,1619,2104,43,45,1662,2149,18,7,1680,2142,1994,239,259,264,0,,0,12.0,0.0,8.0,1.0,24.0
2024,12,17,2,2024-12-17,MQ,8453,STL,PHX,"St. Louis, MO",Missouri,"Phoenix, AZ",Arizona,2205,1000,15,10,2220,1010,29,12,2249,998,2166,277,297,318,0,,0,0.0,0.0,0.0,0.0,0.0
2024,2,5,1,2024-02-05,MQ,7884,MSP,EWR,"Minneapolis, MN",Minnesota,"Newark, NJ",New Jersey,1516,1059,14,5,1530,1064,26,18,1556,1046,1596,195,215,239,1,,0,0.0,0.0,0.0,0.0,0.0
2024,4,19,5,2024-04-19,NK,758,MDW,DTW,"Chicago, IL",Illinois,"Detroit, MI",Michigan,1553,1376,11,5,1564,1381,27,6,1591,1375,365,49,69,82,0,,0,0.0,0.0,0.0,0.0,0.0
2024,6,25,2,2024-06-25,AS,2997,CLT,MSP,"Charlotte, NC",North Carolina,"Minneapolis, MN",Minnesota,1293,2189,-14,-5,1279,2184,29,3,1308,2181,996,122,142,154,0,,0,0.0,0.0,0.0,0.0,0.0
2024,12,27,5,2024-12-27,B6,5768,STL,SAN,"St. Louis, MO",Missouri,"San Diego, CA",California,660,1756,-2,-10,658,1746,8,17,666,1729,1455,179,199,204,0,,0,0.0,0.0,0.0,0.0,0.0
2024,11,9,6,2024-11-09,F9,6325,BWI,SLC,"Baltimore, MD",Maryland,"Salt Lake City, UT",Utah,1829,1620,-14,-5,1815,1615,25,9,1840,1606,2355,288,308,322,0,,0,0.0,0.0,0.0,0.0,0.0
2024,10,21,1,2024-10-21,OH,2642,PDX,SEA,"Portland, OR",Oregon,"Seattle, WA",Washington,2146,1814,-10,-15,2136,1799,21,6,2157,1793,2036,256,276,283,0,,0,0.0,0.0,0.0,0.0,0.0
2024,12,1,7,2024-12-01,AA,9870,TPA,HNL,"Tampa, FL",Florida,"Honolulu, HI",Hawaii,2247,1747,5,0,2252,1747,28,16,2280,1731,632,81,101,125,0,,0,0.0,0.0,0.0,0.0,0.0
2024,4,6,6,2024-04-06,NK,9366,SEA,IAH,"Seattle, WA",Washington,"Houston, TX",Texas,695,2054,-7,-10,688,2044,22,7,710,2037,420,44,64,73,0,,0,0.0,0.0,0.0,0.0,0.0
2024,7,31,3,2024-07-31,YX,3305,STL,TPA,"St. Louis, MO",Missouri,"Tampa, FL",Florida,1107,1841,14,5,1121,1846,25,19,1146,1827,706,96,116,140,0,,0,0.0,0.0,0.0,0.0,0.0
2024,11,12,2,2024-11-12,AS,4144,LAX,DTW,"Los Angeles, CA",California,"Detroit, MI",Michigan,837,1002,-20,-10,817,992,19,6,836,986,1188,149,169,174,0,,0,0.0,0.0,0.0,0.0,0.0
2024,5,16,4,2024-05-16,OO,3533,BWI,DFW,"Baltimore, MD",Maryland,"Dallas/Fort Worth, TX",Texas,1661,1594,-12,-10,1649,1584,9,7,1658,1577,1953,250,270,266,0,,0,0.0,0.0,0.0,0.0,0.0
2024,1,6,6,2024-01-06,B6,6811,DTW,STL,"Detroit, MI",Michigan,"St. Louis, MO",Missouri,1289,1945,24,20,1313,1965,19,19,1332,1946,557,62,82,100,0,,0,0.0,0.0,1.0,0.0,19.0
2024,4,18,4,2024-04-18,NK,7484,CLT,STL,"Charlotte, NC",North Carolina,"St. Louis, MO",Missouri,946,900,-11,-15,935,885,8,13,943,872,2785,356,376,377,0,,0,0.0,0.0,0.0,0.0,0.0
2024,2,4,7,2024-02-04,UA,977,PHX,DEN,"Phoenix, AZ",Arizona,"Denver, CO",Colorado,1833,1694,0,0,1833,1694,8,6,1841,1688,945,114,134,128,0,,0,0.0,0.0,0.0,0.0,0.0
2024,2,8,4,2024-02-08,AA,1191,PHL,LAS,"Philadelphia, PA",Pennsylvania,"Las Vegas, NV",Nevada,1702,813,-21,-15,1681,798,16,17,1697,781,814,96,116,129,0,,0,0.0,0.0,0.0,0.0,0.0
2024,5,29,3,2024-05-29,G4,3159,BWI,BOS,"Baltimore, MD",Maryland,"Boston, MA",Massachusetts,836,1473,-18,-15,818,1458,22,9,840,1449,323,43,63,74,0,,0,0.0,0.0,0.0,0.0,0.0
2024,4,27,6,2024-04-27,DL,7107,PHX,SEA,"Phoenix, AZ",Arizona,"Seattle, WA",Washington,1757,2168,-4,0,1753,2168,23,7,1776,2161,1507,190,210,220,0,,0,0.0,0.0,0.0,0.0,0.0
2024,9,17,2,2024-09-17,MQ,5362,SEA,DTW,"Seattle, WA",Washington,"Detroit, MI",Michigan,1772,973,-5,0,1767,973,22,16,1789,957,349,51,71,89,0,,0,0.0,0.0,0.0,0.0,0.0
2024,3,27,3,2024-03-27,9E,7613,PHL,DCA,"Philadelphia, PA",Pennsylvania,"Washington, DC",District of Columbia,631,1959,-14,-10,617,1949,5,3,622,1946,2631,323,343,331,0,,0,0.0,0.0,0.0,0.0,0.0
2024,3,16,6,2024-03-16,HA,1774,LGA,SFO,"New York, NY",New York,"San Francisco, CA",California,748,1794,18,10,766,1804,8,9,774,1795,1123,139,159,156,0,,0,0.0,0.0,0.0,0.0,0.0
2024,11,8,5,2024-11-08,UA,9900,ORD,IAD,"Chicago, IL",Illinois,"Washington, DC",District of Columbia,1978,943,8,5,1986,948,29,15,2015,933,659,74,94,118,0,,0,0.0,0.0,0.0,0.0,0.0
2024,8,1,4,2024-08-01,F9,2926,EWR,SFO,"Newark, NJ",New Jersey,"San Francisco, CA",California,998,2079,-5,-5,993,2074,19,15,1012,2059,2951,366,386,400,0,,0,0.0,0.0,0.0,0.0,0.0
2024,10,11,5,2024-10-11,YX,9509,SLC,MCO,"Salt Lake City, UT",Utah,"Orlando, FL",Florida,562,1461,-2,-10,560,1451,10,3,570,1448,2995,366,386,379,0,,0,0.0,0.0,0.0,0.0,0.0
2024,8,26,1,2024-08-26,9E,3152,BWI,SAN,"Baltimore, MD",Maryland,"San Diego, CA",California,1318,2033,8,5,1326,2038,28,17,1354,2021,1626,209,229,254,0,,0,0.0,0.0,0.0,0.0,0.0
2024,6,13,4,2024-06-13,G4,413,MIA,LGA,"Miami, FL",Florida,"New York, NY",New York,1915,900,13,5,1928,905,6,4,1934,901,2934,374,394,384,0,,0,0.0,0.0,0.0,0.0,0.0
2024,3,27,3,2024-03-27,MQ,9021,BOS,DFW,"Boston, MA",Massachusetts,"Dallas/Fort Worth, TX",Texas,756,2119,-20,-15,736,2104,6,10,742,2094,1307,166,186,182,0,,0,0.0,0.0,0.0,0.0,0.0
2024,5,20,1,2024-05-20,UA,483,EWR,PHL,"Newark, NJ",New Jersey,"Philadelphia, PA",Pennsylvania,1771,1914,-15,-5,1756,1909,6,10,1762,1899,813,95,115,111,0,,0,0.0,0.0,0.0,0.0,0.0
2024,6,8,6,2024-06-08,AS,5984,SAN,SLC,"San Diego, CA",California,"Salt Lake City, UT",Utah,1787,1348,-7,-10,1780,1338,15,16,1795,1322,665,80,100,111,0,,0,0.0,0.0,0.0,0.0,0.0
2024,2,15,4,2024-02-15,NK,1912,DFW,PHX,"Dallas/Fort Worth, TX",Texas,"Phoenix, AZ",Arizona,966,1036,-9,-10,957,1026,12,6,969,1020,2636,333,353,351,0,,0,0.0,0.0,0.0,0.0,0.0
2024,4,21,7,2024-04-21,HA,2424,SFO,DCA,"San Francisco, CA",California,"Washington, DC",District of Columbia,1348,701,-9,-10,1339,691,21,15,1360,676,1551,199,219,235,0,,0,0.0,0.0,0.0,0.0,0.0
2024,2,14,3,2024-02-14,AA,5348,IAH,PDX,"Houston, TX",Texas,"Portland, OR",Oregon,860,609,18,20,878,629,25,7,903,622,754,87,107,119,0,,0,7.0,4.0,2.0,0.0,7.0
2024,9,3,2,2024-09-03,OH,3529,PDX,IAD,"Portland, OR",Oregon,"Washington, DC",District of Columbia,1379,1664,3,5,1382,1669,16,16,1398,1653,1942,241,261,273,0,,0,0.0,0.0,0.0,0.0,0.0
2024,4,13,6,2024-04-13,NK,3391,MCO,ORD,"Orlando, FL",Florida,"Chicago, IL",Illinois,1916,969,8,5,1924,974,8,12,1932,962,2348,298,318,318,1,,0,0.0,0.0,0.0,0.0,0.0
2024,3,25,1,2024-03-25,WN,7273,BOS,DCA,"Boston, MA",Massachusetts,"Washington, DC",District of Columbia,678,725,-1,-10,677,715,5,6,682,709,1877,231,251,242,0,,0,0.0,0.0,0.0,0.0,0.0
2024,5,13,1,2024-05-13,B6,4946,DCA,SAN,"Washington, DC",District of Columbia,"San Diego, CA",California,1448,1384,-29,-20,1419,1364,14,9,1433,1355,739,92,112,115,0,,0,0.0,0.0,0.0,0.0,0.0
2024,4,17,3,2024-04-17,F9,6867,JFK,SLC,"New York, NY",New York,"Salt Lake City, UT",Utah,2029,982,-12,-15,2017,967,11,6,2028,961,1809,235,255,252,0,,0,0.0,0.0,0.0,0.0,0.0
2024,1,18,4,2024-01-18,WN,327,IAH,JFK,"Houston, TX",Texas,"New York, NY",New York,998,926,-4,0,994,926,20,13,1014,913,205,33,53,66,0,,0,0.0,0.0,0.0,0.0,0.0
2024,4,3,3,2024-04-03,HA,6173,MIA,DTW,"Miami, FL",Florida,"Detroit, MI",Michigan,1176,1049,-6,-10,1170,1039,21,13,1191,1026,2997,364,384,398,0,,0,0.0,0.0,0.0,0.0,0.0
2024,5,29,3,2024-05-29,WN,5804,STL,HNL,"St. Louis, MO",Missouri,"Honolulu, HI",Hawaii,2126,1122,-13,-10,2113,1112,10,14,2123,1098,1990,247,267,271,0,,0,0.0,0.0,0.0,0.0,0.0
2024,9,2,1,2024-09-02,F9,8303,STL,IAD,"St. Louis, MO",Missouri,"Washington, DC",District of Columbia,2227,1609,-12,-20,2215,1589,5,17,2220,1572,2779,348,368,370,0,,0,0.0,0.0,0.0,0.0,0.0
2024,10,15,2,2024-10-15,HA,7865,TPA,BWI,"Tampa, FL",Florida,"Baltimore, MD",Maryland,791,2330,1,10,792,2340,15,7,807,2333,1803,216,236,238,0,,0,0.0,0.0,0.0,0.0,0.0
2024,7,27,6,2024-07-27,B6,1622,LAX,MDW,"Los Angeles, CA",California,"Chicago, IL",Illinois,1087,1541,-10,0,1077,1541,17,10,1094,1531,1077,130,150,157,0,,0,0.0,0.0,0.0,0.0,0.0
2024,5,5,7,2024-05-05,MQ,791,BOS,EWR,"Boston, MA",Massachusetts,"Newark, NJ",New Jersey,1317,2155,-7,-15,1310,2140,17,13,1327,2127,2186,281,301,311,0,,0,0.0,0.0,0.0,0.0,0.0
2024,8,22,4,2024-08-22,AS,1839,BOS,PHL,"Boston, MA",Massachusetts,"Philadelphia, PA",Pennsylvania,598,1582,2,5,600,1587,13,8,613,1579,1766,215,235,236,0,,0,0.0,0.0,0.0,0.0,0.0
2024,5,1,3,2024-05-01,YX,1625,TPA,MIA,"Tampa, FL",Florida,"Miami, FL",Florida,2130,872,1,5,2131,877,7,16,2138,861,1691,212,232,235,1,,0,0.0,0.0,0.0,0.0,0.0
2024,5,17,5,2024-05-17,OO,169,SAN,IAH,"San Diego, CA",California,"Houston, TX",Texas,680,1101,-3,-10,677,1091,6,13,683,1078,2131,258,278,277,0,,0,0.0,0.0,0.0,0.0,0.0
2024,4,24,3,2024-04-24,OH,6351,LAS,SAN,"Las Vegas, NV",Nevada,"San Diego, CA",California,1452,2110,-2,-10,1450,2100,27,9,1477,2091,759,99,119,135,0,,0,0.0,0.0,0.0,0.0,0.0
2024,6,10,1,2024-06-10,B6,3223,PHL,SLC,"Philadelphia, PA",Pennsylvania,"Salt Lake City, UT",Utah,1926,1850,12,10,1938,1860,5,16,1943,1844,944,123,143,144,0,,0,0.0,0.0,0.0,0.0,0.0
2024,7,19,5,2024-07-19,AA,4824,JFK,LAX,"New York, NY",New York,"Los Angeles, CA",California,2189,1850,0,-5,2189,1845,11,18,2200,1827,2364,295,315,324,0,,0,0.0,0.0,0.0,0.0,0.0
2024,8,21,3,2024-08-21,NK,7749,PDX,ORD,"Portland, OR",Oregon,"Chicago, IL",Illinois,873,1465,10,10,883,1475,29,15,912,1460,2880,356,376,400,0,,0,0.0,0.0,0.0,0.0,0.0
2024,1,28,7,2024-01-28,AS,1387,SEA,SAN,"Seattle, WA",Washington,"San Diego, CA",California,1123,940,-21,-20,1102,920,24,8,1126,912,1936,245,265,277,0,,0,0.0,0.0,0.0,0.0,0.0
2024,1,11,4,2024-01-11,DL,8867,SEA,PDX,"Seattle, WA",Washington,"Portland, OR",Oregon,2206,871,8,0,2214,871,14,17,2228,854,912,113,133,144,0,,0,0.0,0.0,0.0,0.0,0.0
2024,7,24,3,2024-07-24,OO,5054,DEN,LAX,"Denver, CO",Colorado,"Los Angeles, CA",California,752,994,-16,-10,736,984,6,7,742,977,238,31,51,44,0,,0,0.0,0.0,0.0,0.0,0.0
2024,6,15,6,2024-06-15,NK,844,STL,DFW,"St. Louis, MO",Missouri,"Dallas/Fort Worth, TX",Texas,1362,1747,6,5,1368,1752,8,19,1376,1733,1181,152,172,179,0,,0,0.0,0.0,0.0,0.0,0.0
2024,9,3,2,2024-09-03,AS,6375,MIA,ORD,"Miami, FL",Florida,"Chicago, IL",Illinois,621,1509,53,60,674,1569,29,7,703,1562,2418,298,318,334,0,,0,5.0,6.0,7.0,0.0,42.0
2024,2,16,5,2024-02-16,B6,4676,PHL,DFW,"Philadelphia, PA",Pennsylvania,"Dallas/Fort Worth, TX",Texas,941,794,0,-5,941,789,20,12,961,777,1208,158,178,190,0,,0,0.0,0.0,0.0,0.0,0.0
2024,9,2,1,2024-09-02,F9,5176,PHX,DTW,"Phoenix, AZ",Arizona,"Detroit, MI",Michigan,2240,2206,-24,-15,2216,2191,12,4,2228,2187,1941,246,266,262,0,,0,0.0,0.0,0.0,0.0,0.0
2024,5,6,1,2024-05-06,B6,9316,PHL,BWI,"Philadelphia, PA",Pennsylvania,"Baltimore, MD",Maryland,744,1796,-12,-5,732,1791,16,18,748,1773,1823,234,254,268,0,,0,0.0,0.0,0.0,0.0,0.0
2024,5,26,7,2024-05-26,OO,1041,CLT,MCO,"Charlotte, NC",North Carolina,"Orlando, FL",Florida,2162,1826,15,10,2177,1836,9,15,2186,1821,952,123,143,147,0,,0,0.0,0.0,0.0,0.0,0.0
2024,4,27,6,2024-04-27,DL,5150,TPA,PHX,"Tampa, FL",Florida,"Phoenix, AZ",Arizona,2014,1656,5,5,2019,1661,28,5,2047,1656,1680,210,230,243,0,,0,0.0,0.0,0.0,0.0,0.0
2024,5,31,5,2024-05-31,AS,867,BOS,TPA,"Boston, MA",Massachusetts,"Tampa, FL",Florida,1370,810,-15,-10,1355,800,27,16,1382,784,345,43,63,86,0,,0,0.0,0.0,0.0,0.0,0.0
2024,3,12,2,2024-03-12,OH,2538,ATL,MSP,"Atlanta, GA",Georgia,"Minneapolis, MN",Minnesota,1326,1412,20,20,1346,1432,24,9,1370,1423,1488,194,214,227,0,,0,4.0,5.0,2.0,0.0,9.0
2024,12,28,6,2024-12-28,YX,9125,DTW,LAX,"Detroit, MI",Michigan,"Los Angeles, CA",California,1569,1293,-1,0,1568,1293,7,14,1575,1279,1472,180,200,201,0,,0,0.0,0.0,0.0,0.0,0.0
2024,5,16,4,2024-05-16,AA,8919,DFW,HNL,"Dallas/Fort Worth, TX",Texas,"Honolulu, HI",Hawaii,951,1352,-6,-10,945,1342,5,19,950,1323,1748,224,244,248,1,,0,0.0,0.0,0.0,0.0,0.0
2024,6,23,7,2024-06-23,B6,476,MDW,MCO,"Chicago, IL",Illinois,"Orlando, FL",Florida,795,1600,-4,0,791,1600,18,14,809,1586,1321,162,182,194,0,,0,0.0,0.0,0.0,0.0,0.0
2024,10,15,2,2024-10-15,OH,189,MIA,MDW,"Miami, FL",Florida,"Chicago, IL",Illinois,2271,1674,4,0,2275,1674,23,5,2298,1669,2635,338,358,366,0,,0,0.0,0.0,0.0,0.0,0.0
2024,1,19,5,2024-01-19,AS,9357,JFK,PHX,"New York, NY",New York,"Phoenix, AZ",Arizona,1664,1491,0,10,1664,1501,28,10,1692,1491,754,89,109,127,0,,0,0.0,0.0,0.0,0.0,0.0
2024,7,13,6,2024-07-13,HA,6166,CLT,DFW,"Charlotte, NC",North Carolina,"Dallas/Fort Worth, TX",Texas,2156,2030,-8,-5,2148,2025,29,17,2177,2008,1958,247,267,293,0,,0,0.0,0.0,0.0,0.0,0.0
2024,11,25,1,2024-11-25,NK,9350,PHL,IAD,"Philadelphia, PA",Pennsylvania,"Washington, DC",District of Columbia,2044,1140,4,10,2048,1150,20,15,2068,1135,1382,166,186,201,0,,0,0.0,0.0,0.0,0.0,0.0
2024,6,23,7,2024-06-23,OH,5675,MCO,SFO,"Orlando, FL",Florida,"San Francisco, CA",California,1589,1117,5,10,1594,1127,13,18,1607,1109,1248,146,166,177,0,,0,0.0,0.0,0.0,0.0,0.0
2024,12,19,4,2024-12-19,DL,2755,LAS,TPA,"Las Vegas, NV",Nevada,"Tampa, FL",Florida,982,1534,-2,5,980,1539,9,17,989,1522,415,49,69,75,0,,0,0.0,0.0,0.0,0.0,0.0
2024,5,20,1,2024-05-20,AA,1615,MIA,DCA,"Miami, FL",Florida,"Washington, DC",District of Columbia,808,732,-6,-10,802,722,8,13,810,709,1299,152,172,173,0,,0,0.0,0.0,0.0,0.0,0.0
2024,9,2,1,2024-09-02,AS,3117,IAH,STL,"Houston, TX",Texas,"St. Louis, MO",Missouri,1983,695,13,20,1996,715,10,15,2006,700,2076,253,273,278,0,,0,1.0,1.0,0.0,0.0,18.0
2024,4,2,2,2024-04-02,UA,7911,ORD,MSP,"Chicago, IL",Illinois,"Minneapolis, MN",Minnesota,1092,1023,-8,0,1084,1023,16,16,1100,1007,2185,282,302,314,0,,0,0.0,0.0,0.0,0.0,0.0
2024,8,26,1,2024-08-26,B6,7443,LAX,SEA,"Los Angeles, CA",California,"Seattle, WA",Washington,2295,1457,20,15,2315,1472,18,15,2333,1457,1749,212,232,245,0,,0,0.0,0.0,0.0,0.0,0.0
2024,7,23,2,2024-07-23,YX,1673,MCO,DTW,"Orlando, FL",Florida,"Detroit, MI",Michigan,1518,1573,-5,-10,1513,1563,27,10,1540,1553,2107,254,274,291,1,,0,0.0,0.0,0.0,0.0,0.0
2024,2,17,6,2024-02-17,HA,5697,ATL,MSP,"Atlanta, GA",Georgia,"Minneapolis, MN",Minnesota,897,681,27,30,924,711,18,13,942,698,912,119,139,150,0,,0,0.0,2.0,2.0,0.0,26.0
2024,9,1,7,2024-09-01,OO,4026,DTW,MDW,"Detroit, MI",Michigan,"Chicago, IL",Illinois,968,1388,5,10,973,1398,10,16,983,1382,1291,164,184,190,0,,0,0.0,0.0,0.0,0.0,0.0
2024,11,15,5,2024-11-15,MQ,3896,CLT,STL,"Charlotte, NC",North Carolina,"St. Louis, MO",Missouri,1116,914,17,15,1133,929,9,17,1142,912,268,26,46,52,0,,0,0.0,0.0,0.0,0.0,0.0
2024,11,12,2,2024-11-12,HA,8923,IAH,PHX,"Houston, TX",Texas,"Phoenix, AZ",Arizona,891,2352,-12,-10,879,2342,6,12,885,2330,1080,139,159,157,0,,0,0.0,0.0,0.0,0.0,0.0
2024,10,21,1,2024-10-21,DL,1332,JFK,SFO,"New York, NY",New York,"San Francisco, CA",California,596,1515,-7,-5,589,1510,7,6,596,1504,2772,355,375,368,0,,0,0.0,0.0,0.0,0.0,0.0
2024,5,7,2,2024-05-07,HA,2364,MDW,MIA,"Chicago, IL",Illinois,"Miami, FL",Florida,1713,1903,-15,-15,1698,1888,13,9,1711,1879,1308,171,191,193,0,,0,0.0,0.0,0.0,0.0,0.0
2024,12,9,1,2024-12-09,AA,2147,CLT,TPA,"Charlotte, NC",North Carolina,"Tampa, FL",Florida,1440,2266,-18,-15,1422,2251,11,8,1433,2243,2517,314,334,333,0,,0,0.0,0.0,0.0,0.0,0.0
2024,10,8,2,2024-10-08,AA,635,MCO,PHL,"Orlando, FL",Florida,"Philadelphia, PA",Pennsylvania,1359,1709,-8,-10,1351,1699,16,3,1367,1696,1360,164,184,183,0,,0,0.0,0.0,0.0,0.0,0.0
2024,1,17,3,2024-01-17,MQ,7984,DEN,MIA,"Denver, CO",Colorado,"Miami, FL",Florida,694,965,28,20,722,985,22,13,744,972,945,115,135,150,0,,0,6.0,5.0,3.0,0.0,6.0
2024,3,11,1,2024-03-11,OO,6981,ORD,DTW,"Chicago, IL",Illinois,"Detroit, MI",Michigan,1457,965,-5,5,1452,970,17,5,1469,965,499,67,87,89,1,,0,0.0,0.0,0.0,0.0,0.0
2024,9,25,3,2024-09-25,WN,7478,LGA,SEA,"New York, NY",New York,"Seattle, WA",Washington,1857,1716,1,-5,1858,1711,5,5,1863,1706,738,83,103,93,1,,0,0.0,0.0,0.0,0.0,0.0
2024,11,20,3,2024-11-20,9E,3197,CLT,LAS,"Charlotte, NC",North Carolina,"Las Vegas, NV",Nevada,582,670,15,20,597,690,5,3,602,687,1392,178,198,186,0,,0,4.0,1.0,1.0,0.0,14.0
2024,10,8,2,2024-10-08,MQ,9567,DTW,LAS,"Detroit, MI",Michigan,"Las Vegas, NV",Nevada,750,925,6,5,756,930,5,12,761,918,1573,199,219,216,0,,0,0.0,0.0,0.0,0.0,0.0
2024,10,31,4,2024-10-31,DL,3173,DFW,PDX,"Dallas/Fort Worth, TX",Texas,"Portland, OR",Oregon,1593,2130,8,15,1601,2145,26,16,1627,2129,2803,341,361,383,0,,0,0.0,0.0,0.0,0.0,0.0
2024,1,7,7,2024-01-07,AA,1125,PHL,MDW,"Philadelphia, PA",Pennsylvania,"Chicago, IL",Illinois,1815,1949,20,15,1835,1964,25,19,1860,1945,1639,198,218,242,0,,0,0.0,0.0,0.0,0.0,0.0
2024,11,9,6,2024-11-09,AS,2151,LGA,JFK,"New York, NY",New York,"New York, NY",New York,839,1443,-3,5,836,1448,11,4,847,1444,781,88,108,103,0,,0,0.0,0.0,0.0,0.0,0.0
2024,10,31,4,2024-10-31,OH,3721,LGA,BOS,"New York, NY",New York,"Boston, MA",Massachusetts,1908,1814,-4,-10,1904,1804,25,16,1929,1788,1951,234,254,275,0,,0,0.0,0.0,0.0,0.0,0.0
2024,4,12,5,2024-04-12,WN,4663,SAN,PDX,"San Diego, CA",California,"Portland, OR",Oregon,1199,813,67,60,1266,873,13,7,1279,866,1776,214,234,234,0,,0,11.0,13.0,4.0,0.0,32.0
2024,11,4,1,2024-11-04,9E,8492,SLC,PHX,"Salt Lake City, UT",Utah,"Phoenix, AZ",Arizona,1981,1670,2,-5,1983,1665,5,9,1988,1656,2235,277,297,291,0,,0,0.0,0.0,0.0,0.0,0.0
2024,7,11,4,2024-07-11,MQ,4503,LGA,BWI,"New York, NY",New York,"Baltimore, MD",Maryland,1664,2353,12,5,1676,2358,19,17,1695,2341,2261,288,308,324,0,,0,0.0,0.0,0.0,0.0,0.0
2024,8,28,3,2024-08-28,YX,3423,LGA,IAH,"New York, NY",New York,"Houston, TX",Texas,1663,688,7,10,1670,698,29,8,1699,690,1524,195,215,232,0,,0,0.0,0.0,0.0,0.0,0.0
2024,3,2,6,2024-03-02,HA,3458,BOS,PHL,"Boston, MA",Massachusetts,"Philadelphia, PA",Pennsylvania,1598,1595,-13,-10,1585,1585,16,6,1601,1579,1377,180,200,202,0,,0,0.0,0.0,0.0,0.0,0.0
2024,1,17,3,2024-01-17,NK,6241,MDW,BOS,"Chicago, IL",Illinois,"Boston, MA",Massachusetts,599,1850,2,0,601,1850,8,16,609,1834,1835,223,243,247,0,,0,0.0,0.0,0.0,0.0,0.0
2024,6,19,3,2024-06-19,OO,5117,JFK,DEN,"New York, NY",New York,"Denver, CO",Colorado,2180,2020,-4,-5,2176,2015,14,3,2190,2012,876,102,122,119,0,,0,0.0,0.0,0.0,0.0,0.0
2024,1,25,4,2024-01-25,AS,6535,DTW,LGA,"Detroit, MI",Michigan,"New York, NY",New York,1698,816,-6,-10,1692,806,27,10,1719,796,427,47,67,84,0,,0,0.0,0.0,0.0,0.0,0.0
2024,9,7,6,2024-09-07,B6,7421,CLT,SFO,"Charlotte, NC",North Carolina,"San Francisco, CA",California,1232,900,-21,-20,1211,880,22,8,1233,872,1145,133,153,163,1,,0,0.0,0.0,0.0,0.0,0.0
2024,9,9,1,2024-09-09,9E,3071,IAD,SLC,"Washington, DC",District of Columbia,"Salt Lake City, UT",Utah,822,2039,8,10,830,2049,23,17,853,2032,2532,322,342,362,0,,0,0.0,0.0,0.0,0.0,0.0
2024,7,25,4,2024-07-25,YX,8877,STL,SLC,"St. Louis, MO",Missouri,"Salt Lake City, UT",Utah,2000,1525,-23,-15,1977,1510,24,8,2001,1502,1179,154,174,186,0,,0,0.0,0.0,0.0,0.0,0.0
2024,1,29,1,2024-01-29,MQ,3445,SFO,ATL,"San Francisco, CA",California,"Atlanta, GA",Georgia,509,1452,9,10,518,1462,9,17,527,1445,2097,270,290,296,0,,0,0.0,0.0,0.0,0.0,0.0
2024,4,26,5,2024-04-26,YX,5916,LGA,STL,"New York, NY",New York,"St. Louis, MO",Missouri,1512,1493,6,0,1518,1493,6,3,1524,1490,1599,196,216,205,0,,0,0.0,0.0,0.0,0.0,0.0
2024,10,8,2,2024-10-08,YX,4704,DCA,IAH,"Washington, DC",District of Columbia,"Houston, TX",Texas,1569,769,4,0,1573,769,11,12,1584,757,1455,186,206,209,0,,0,0.0,0.0,0.0,0.0,0.0
2024,5,23,4,2024-05-23,YX,3524,JFK,BWI,"New York, NY",New York,"Baltimore, MD",Maryland,2152,1988,9,10,2161,1998,10,6,2171,1992,2366,297,317,313,0,,0,0.0,0.0,0.0,0.0,0.0
2024,1,25,4,2024-01-25,DL,4200,MIA,JFK,"Miami, FL",Florida,"New York, NY",New York,2039,1855,9,0,2048,1855,20,16,2068,1839,2942,375,395,411,0,,0,0.0,0.0,0.0,0.0,0.0
2024,11,5,2,2024-11-05,B6,8651,MIA,CLT,"Miami, FL",Florida,"Charlotte, NC",North Carolina,1836,1219,-2,-5,1834,1214,19,14,1853,1200,464,50,70,83,0,,0,0.0,0.0,0.0,0.0,0.0
2024,6,4,2,2024-06-04,G4,3577,SEA,ATL,"Seattle, WA",Washington,"Atlanta, GA",Georgia,1761,1951,-10,-15,1751,1936,13,18,1764,1918,2623,331,351,362,0,,0,0.0,0.0,0.0,0.0,0.0
2024,3,13,3,2024-03-13,G4,7282,IAH,ATL,"Houston, TX",Texas,"Atlanta, GA",Georgia,1305,1856,-5,0,1300,1856,11,9,1311,1847,1692,212,232,232,0,,0,0.0,0.0,0.0,0.0,0.0
2024,4,29,1,2024-04-29,DL,7540,MSP,SLC,"Minneapolis, MN",Minnesota,"Salt Lake City, UT",Utah,1407,1281,-4,0,1403,1281,14,9,1417,1272,857,111,131,134,0,,0,0.0,0.0,0.0,0.0,0.0
2024,11,7,4,2024-11-07,NK,4758,MDW,LAX,"Chicago, IL",Illinois,"Los Angeles, CA",California,1554,2270,-11,-10,1543,2260,6,9,1549,2251,1147,141,161,156,0,,0,0.0,0.0,0.0,0.0,0.0
2024,11,16,6,2024-11-16,9E,2912,IAD,ATL,"Washington, DC",District of Columbia,"Atlanta, GA",Georgia,2033,1242,8,0,2041,1242,7,8,2048,1234,2324,288,308,303,0,,0,0.0,0.0,0.0,0.0,0.0
2024,4,2,2,2024-04-02,OH,144,IAH,SLC,"Houston, TX",Texas,"Salt Lake City, UT",Utah,629,636,2,-5,631,631,23,17,654,614,594,77,97,117,0,,1,0.0,0.0,0.0,0.0,0.0
2024,3,26,2,2024-03-26,WN,733,IAD,DCA,"Washington, DC",District of Columbia,"Washington, DC",District of Columbia,2276,1370,8,10,2284,1380,28,12,2312,1368,480,51,71,91,0,,0,0.0,0.0,0.0,0.0,0.0
2024,12,1,7,2024-12-01,MQ,9502,SFO,SLC,"San Francisco, CA",California,"Salt Lake City, UT",Utah,1908,2025,-9,0,1899,2025,28,14,1927,2011,2913,369,389,411,0,,0,0.0,0.0,0.0,0.0,0.0
2024,12,29,7,2024-12-29,MQ,6904,DCA,SAN,"Washington, DC",District of Columbia,"San Diego, CA",California,2116,1610,13,15,2129,1625,7,10,2136,1615,1952,244,264,261,0,,0,0.0,0.0,0.0,0.0,0.0
2024,4,27,6,2024-04-27,UA,2868,JFK,PHL,"New York, NY",New York,"Philadelphia, PA",Pennsylvania,1548,1235,-7,0,1541,1235,12,6,1553,1229,2876,365,385,383,0,,0,0.0,0.0,0.0,0.0,0.0
2024,8,20,2,2024-08-20,OO,8885,IAD,EWR,"Washington, DC",District of Columbia,"Newark, NJ",New Jersey,1784,1025,10,10,1794,1035,9,9,1803,1026,788,99,119,117,0,,0,0.0,0.0,0.0,0.0,0.0
2024,7,17,3,2024-07-17,AA,9716,PHL,MCO,"Philadelphia, PA",Pennsylvania,"Orlando, FL",Florida,2083,1007,6,0,2089,1007,24,5,2113,1002,2813,342,362,371,0,,0,0.0,0.0,0.0,0.0,0.0
2024,7,24,3,2024-07-24,UA,7975,SLC,MSP,"Salt Lake City, UT",Utah,"Minneapolis, MN",Minnesota,1921,1374,-8,0,1913,1374,16,10,1929,1364,1695,208,228,234,0,,0,0.0,0.0,0.0,0.0,0.0
2024,12,4,3,2024-12-04,OO,2026,DEN,STL,"Denver, CO",Colorado,"St. Louis, MO",Missouri,1063,1464,-1,-5,1062,1459,15,15,1077,1444,868,113,133,143,0,,0,0.0,0.0,0.0,0.0,0.0
2024,5,26,7,2024-05-26,G4,956,DTW,IAH,"Detroit, MI",Michigan,"Houston, TX",Texas,1853,816,-14,-5,1839,811,8,15,1847,796,1898,229,249,252,0,,0,0.0,0.0,0.0,0.0,0.0
2024,9,27,5,2024-09-27,OH,6088,EWR,BOS,"Newark, NJ",New Jersey,"Boston, MA",Massachusetts,648,769,20,15,668,784,8,18,676,766,763,91,111,117,0,,0,0.0,0.0,0.0,0.0,0.0
2024,5,18,6,2024-05-18,HA,8843,LAX,HNL,"Los Angeles, CA",California,"Honolulu, HI",Hawaii,1932,1209,-17,-10,1915,1199,5,18,1920,1181,1339,164,184,187,0,,0,0.0,0.0,0.0,0.0,0.0
2024,6,29,6,2024-06-29,G4,7947,DFW,JFK,"Dallas/Fort Worth, TX",Texas,"New York, NY",New York,2134,957,-8,-15,2126,942,11,4,2137,938,2744,349,369,364,0,,0,0.0,0.0,0.0,0.0,0.0
2024,1,30,2,2024-01-30,NK,4238,MCO,HNL,"Orlando, FL",Florida,"Honolulu, HI",Hawaii,1078,785,9,10,1087,795,24,5,1111,790,1859,232,252,261,0,,0,0.0,0.0,0.0,0.0,0.0
2024,2,26,1,2024-02-26,UA,4374,BWI,DEN,"Baltimore, MD",Maryland,"Denver, CO",Colorado,1519,1324,-5,0,1514,1324,6,17,1520,1307,1107,139,159,162,0,,0,0.0,0.0,0.0,0.0,0.0
2024,8,19,1,2024-08-19,MQ,9772,SAN,LAS,"San Diego, CA",California,"Las Vegas, NV",Nevada,2245,1469,-10,-10,2235,1459,5,19,2240,1440,1204,146,166,170,0,,0,0.0,0.0,0.0,0.0,0.0
2024,5,25,6,2024-05-25,UA,706,JFK,DTW,"New York, NY",New York,"Detroit, MI",Michigan,2283,1423,-6,-5,2277,1418,23,4,2300,1414,375,55,75,82,0,,0,0.0,0.0,0.0,0.0,0.0
2024,2,17,6,2024-02-17,WN,8963,BWI,STL,"Baltimore, MD",Maryland,"St. Louis, MO",Missouri,618,1278,-10,0,608,1278,21,19,629,1259,2234,278,298,318,0,,0,0.0,0.0,0.0,0.0,0.0
2024,7,12,5,2024-07-12,NK,5122,LGA,MDW,"New York, NY",New York,"Chicago, IL",Illinois,1957,1784,5,0,1962,1784,15,8,1977,1776,2510,312,332,335,0,,0,0.0,0.0,0.0,0.0,0.0
2024,8,11,7,2024-08-11,NK,116,LGA,MSP,"New York, NY",New York,"Minneapolis, MN",Minnesota,727,883,4,10,731,893,9,13,740,880,2958,362,382,384,0,,0,0.0,0.0,0.0,0.0,0.0
2024,5,15,3,2024-05-15,YX,5834,PHL,SFO,"Philadelphia, PA",Pennsylvania,"San Francisco, CA",California,1114,783,-7,-5,1107,778,10,7,1117,771,284,41,61,58,0,,0,0.0,0.0,0.0,0.0,0.0
2024,1,22,1,2024-01-22,YX,2973,MSP,DTW,"Minneapolis, MN",Minnesota,"Detroit, MI",Michigan,739,2160,11,5,750,2165,26,8,776,2157,2812,349,369,383,0,,0,0.0,0.0,0.0,0.0,0.0
2024,1,6,6,2024-01-06,OH,7865,ATL,PDX,"Atlanta, GA",Georgia,"Portland, OR",Oregon,1412,741,3,10,1415,751,10,5,1425,746,1560,199,219,214,0,,0,0.0,0.0,0.0,0.0,0.0
2024,7,22,1,2024-07-22,DL,5249,LAX,ORD,"Los Angeles, CA",California,"Chicago, IL",Illinois,1755,2318,1,10,1756,2328,27,6,1783,2322,2998,365,385,398,0,,0,0.0,0.0,0.0,0.0,0.0
2024,8,26,1,2024-08-26,YX,5411,IAD,MDW,"Washington, DC",District of Columbia,"Chicago, IL",Illinois,1465,2219,-19,-10,1446,2209,21,17,1467,2192,1803,225,245,263,0,,0,0.0,0.0,0.0,0.0,0.0
2024,7,3,3,2024-07-03,HA,2584,BOS,MSP,"Boston, MA",Massachusetts,"Minneapolis, MN",Minnesota,1813,830,-11,-5,1802,825,24,19,1826,806,2420,294,314,337,0,,0,0.0,0.0,0.0,0.0,0.0
2024,12,25,3,2024-12-25,B6,6422,SAN,MIA,"San Diego, CA",California,"Miami, FL",Florida,1677,2091,-9,0,1668,2091,14,5,1682,2086,824,112,132,131,0,,0,0.0,0.0,0.0,0.0,0.0
2024,10,18,5,2024-10-18,NK,8907,SEA,SFO,"Seattle, WA",Washington,"San Francisco, CA",California,2205,987,12,10,2217,997,14,18,2231,979,2191,281,301,313,0,,0,0.0,0.0,0.0,0.0,0.0
2024,11,30,6,2024-11-30,NK,6877,MDW,DEN,"Chicago, IL",Illinois,"Denver, CO",Colorado,658,1334,-1,5,657,1339,13,18,670,1321,473,58,78,89,0,,0,0.0,0.0,0.0,0.0,0.0
2024,8,7,3,2024-08-07,AS,3305,PDX,IAD,"Portland, OR",Oregon,"Washington, DC",District of Columbia,2148,757,-10,0,2138,757,22,3,2160,754,1879,232,252,257,0,,0,0.0,0.0,0.0,0.0,0.0
2024,4,25,4,2024-04-25,9E,4507,ATL,ORD,"Atlanta, GA",Georgia,"Chicago, IL",Illinois,1062,1941,34,30,1096,1971,17,13,1113,1958,2854,353,373,383,0,,0,0.0,5.0,4.0,0.0,21.0
2024,11,8,5,2024-11-08,9E,3907,SFO,MSP,"San Francisco, CA",California,"Minneapolis, MN",Minnesota,975,1808,3,-5,978,1803,12,3,990,1800,759,99,119,114,0,,0,0.0,0.0,0.0,0.0,0.0
2024,2,18,7,2024-02-18,YX,8816,JFK,SEA,"New York, NY",New York,"Seattle, WA",Washington,1047,2044,13,10,1060,2054,15,9,1075,2045,2480,312,332,336,0,,0,0.0,0.0,0.0,0.0,0.0
2024,6,21,5,2024-06-21,F9,3273,JFK,SLC,"New York, NY",New York,"Salt Lake City, UT",Utah,1536,1806,11,10,1547,1816,11,11,1558,1805,1761,211,231,233,1,,0,0.0,0.0,0.0,0.0,0.0
2024,3,22,5,2024-03-22,UA,1573,PHX,CLT,"Phoenix, AZ",Arizona,"Charlotte, NC",North Carolina,1352,2220,6,15,1358,2235,11,15,1369,2220,1169,150,170,176,0,,0,0.0,0.0,0.0,0.0,0.0
2024,11,17,7,2024-11-17,HA,3438,ATL,IAH,"Atlanta, GA",Georgia,"Houston, TX",Texas,2030,1176,39,30,2069,1206,7,8,2076,1198,790,98,118,113,0,,0,11.0,8.0,5.0,0.0,6.0
2024,11,28,4,2024-11-28,AA,4657,TPA,DFW,"Tampa, FL",Florida,"Dallas/Fort Worth, TX",Texas,717,1675,-10,0,707,1675,20,19,727,1656,870,101,121,140,0,,0,0.0,0.0,0.0,0.0,0.0
2024,2,14,3,2024-02-14,UA,2512,DTW,MSP,"Detroit, MI",Michigan,"Minneapolis, MN",Minnesota,1254,1626,-18,-10,1236,1616,17,8,1253,1608,1647,197,217,222,0,,0,0.0,0.0,0.0,0.0,0.0
2024,11,30,6,2024-11-30,OO,2251,JFK,DEN,"New York, NY",New York,"Denver, CO",Colorado,1234,676,0,0,1234,676,22,4,1256,672,2808,344,364,370,0,,0,0.0,0.0,0.0,0.0,0.0
2024,1,20,6,2024-01-20,DL,3282,BOS,TPA,"Boston, MA",Massachusetts,"Tampa, FL",Florida,2243,2270,16,10,2259,2280,22,5,2281,2275,2439,295,315,322,0,,0,0.0,0.0,0.0,0.0,0.0
2024,8,8,4,2024-08-08,DL,8719,SEA,IAD,"Seattle, WA",Washington,"Washington, DC",District of Columbia,1490,1181,4,10,1494,1191,16,8,1510,1183,372,43,63,67,0,,0,0.0,0.0,0.0,0.0,0.0
2024,5,2,4,2024-05-02,OH,8262,EWR,BOS,"Newark, NJ",New Jersey,"Boston, MA",Massachusetts,1280,2297,1,-5,1281,2292,17,3,1298,2289,457,52,72,72,0,,0,0.0,0.0,0.0,0.0,0.0
2024,8,21,3,2024-08-21,OH,4664,BWI,DCA,"Baltimore, MD",Maryland,"Washington, DC",District of Columbia,721,1207,-13,-20,708,1187,7,18,715,1169,892,110,130,135,0,,0,0.0,0.0,0.0,0.0,0.0
2024,8,8,4,2024-08-08,DL,1114,ORD,SFO,"Chicago, IL",Illinois,"San Francisco, CA",California,787,1639,-8,0,779,1639,7,10,786,1629,1942,248,268,265,0,,0,0.0,0.0,0.0,0.0,0.0
2024,11,18,1,2024-11-18,B6,1704,DEN,HNL,"Denver, CO",Colorado,"Honolulu, HI",Hawaii,1023,829,4,0,1027,829,6,18,1033,811,254,27,47,51,0,,1,0.0,0.0,0.0,0.0,0.0
2024,12,4,3,2024-12-04,MQ,969,DFW,PHL,"Dallas/Fort Worth, TX",Texas,"Philadelphia, PA",Pennsylvania,2010,1503,-10,-15,2000,1488,11,6,2011,1482,351,52,72,69,0,,0,0.0,0.0,0.0,0.0,0.0
2024,1,3,3,2024-01-03,AA,7013,LGA,BWI,"New York, NY",New York,"Baltimore, MD",Maryland,1198,1516,9,5,1207,1521,6,17,1213,1504,2915,366,386,389,0,,0,0.0,0.0,0.0,0.0,0.0
2024,6,30,7,2024-06-30,9E,2827,MDW,PDX,"Chicago, IL",Illinois,"Portland, OR",Oregon,1180,1488,-4,-10,1176,1478,10,16,1186,1462,1997,249,269,275,0,,0,0.0,0.0,0.0,0.0,0.0
2024,7,24,3,2024-07-24,WN,2952,IAH,ORD,"Houston, TX",Texas,"Chicago, IL",Illinois,823,1890,7,0,830,1890,17,3,847,1887,2671,342,362,362,0,,0,0.0,0.0,0.0,0.0,0.0
2024,11,15,5,2024-11-15,OH,9177,SEA,CLT,"Seattle, WA",Washington,"Charlotte, NC",North Carolina,1117,1929,-18,-15,1099,1914,15,3,1114,1911,2711,332,352,350,0,,0,0.0,0.0,0.0,0.0,0.0
2024,2,9,5,2024-02-09,9E,2708,SEA,STL,"Seattle, WA",Washington,"St. Louis, MO",Missouri,1699,1629,13,10,1712,1639,9,6,1721,1633,1854,230,250,245,0,,0,0.0,0.0,0.0,0.0,0.0
2024,2,28,3,2024-02-28,B6,1373,CLT,SAN,"Charlotte, NC",North Carolina,"San Diego, CA",California,1360,1733,-2,5,1358,1738,11,17,1369,1721,393,40,60,68,0,,0,0.0,0.0,0.0,0.0,0.0
2024,3,2,6,2024-03-02,DL,7749,MDW,LGA,"Chicago, IL",Illinois,"New York, NY",New York,540,742,-6,-5,534,737,15,8,549,729,2513,312,332,335,0,,0,0.0,0.0,0.0,0.0,0.0
2024,5,11,6,2024-05-11,B6,2055,ATL,MSP,"Atlanta, GA",Georgia,"Minneapolis, MN",Minnesota,1848,2290,9,0,1857,2290,11,6,1868,2284,2500,319,339,336,0,,0,0.0,0.0,0.0,0.0,0.0
2024,2,29,4,2024-02-29,9E,8878,PDX,LAS,"Portland, OR",Oregon,"Las Vegas, NV",Nevada,2284,806,-14,-10,2270,796,12,6,2282,790,1226,146,166,164,0,,0,0.0,0.0,0.0,0.0,0.0
2024,11,26,2,2024-11-26,HA,8492,LAX,MSP,"Los Angeles, CA",California,"Minneapolis, MN",Minnesota,1790,1028,39,30,1829,1058,8,12,1837,1046,1874,240,260,260,0,,0,10.0,2.0,4.0,0.0,14.0
2024,5,1,3,2024-05-01,WN,4649,PDX,DTW,"Portland, OR",Oregon,"Detroit, MI",Michigan,2257,765,-5,5,2252,770,14,9,2266,761,2870,367,387,390,0,,0,0.0,0.0,0.0,0.0,0.0
2024,4,16,2,2024-04-16,F9,9117,PDX,IAD,"Portland, OR",Oregon,"Washington, DC",District of Columbia,892,859,1,5,893,864,25,8,918,856,2912,358,378,391,0,,0,0.0,0.0,0.0,0.0,0.0
2024,4,5,5,2024-04-05,AA,8402,BWI,MSP,"Baltimore, MD",Maryland,"Minneapolis, MN",Minnesota,1636,2308,-9,-10,1627,2298,24,6,1651,2292,1033,124,144,154,0,,0,0.0,0.0,0.0,0.0,0.0
2024,12,12,4,2024-12-12,HA,8200,MIA,JFK,"Miami, FL",Florida,"New York, NY",New York,1807,993,-27,-20,1780,973,19,15,1799,958,1360,161,181,195,0,,0,0.0,0.0,0.0,0.0,0.0
2024,8,22,4,2024-08-22,YX,3011,HNL,PDX,"Honolulu, HI",Hawaii,"Portland, OR",Oregon,702,720,-4,0,698,720,27,13,725,707,2948,362,382,402,0,,0,0.0,0.0,0.0,0.0,0.0
2024,3,2,6,2024-03-02,B6,9199,MCO,DTW,"Orlando, FL",Florida,"Detroit, MI",Michigan,1352,1549,-11,-15,1341,1534,19,11,1360,1523,1434,188,208,218,0,,0,0.0,0.0,0.0,0.0,0.0
2024,9,12,4,2024-09-12,OH,5968,SFO,LGA,"San Francisco, CA",California,"New York, NY",New York,1273,1012,-4,5,1269,1017,23,10,1292,1007,440,56,76,89,0,,0,0.0,0.0,0.0,0.0,0.0
2024,2,18,7,2024-02-18,OH,5763,DFW,JFK,"Dallas/Fort Worth, TX",Texas,"New York, NY",New York,1667,1763,-14,-5,1653,1758,14,12,1667,1746,2434,304,324,330,0,,0,0.0,0.0,0.0,0.0,0.0
2024,12,13,5,2024-12-13,OO,654,LAX,DEN,"Los Angeles, CA",California,"Denver, CO",Colorado,1766,767,-11,-5,1755,762,6,4,1761,758,1829,235,255,245,0,,0,0.0,0.0,0.0,0.0,0.0
2024,6,7,5,2024-06-07,YX,8398,IAD,ORD,"Washington, DC",District of Columbia,"Chicago, IL",Illinois,1281,1707,-23,-15,1258,1692,20,5,1278,1687,2888,358,378,383,0,,0,0.0,0.0,0.0,0.0,0.0
2024,5,3,5,2024-05-03,9E,3436,SAN,DTW,"San Diego, CA",California,"Detroit, MI",Michigan,534,1020,65,60,599,1080,24,4,623,1076,1199,152,172,180,0,,0,0.0,5.0,3.0,1.0,51.0
2024,11,12,2,2024-11-12,AA,6469,PHL,DTW,"Philadelphia, PA",Pennsylvania,"Detroit, MI",Michigan,552,2329,13,20,565,2349,9,13,574,2336,1746,221,241,243,0,,0,5.0,3.0,0.0,0.0,12.0
2024,7,25,4,2024-07-25,9E,2634,MCO,ORD,"Orlando, FL",Florida,"Chicago, IL",Illinois,1002,1387,-11,-15,991,1372,21,3,1012,1369,1943,235,255,259,0,,0,0.0,0.0,0.0,0.0,0.0
2024,2,17,6,2024-02-17,9E,2326,JFK,DCA,"New York, NY",New York,"Washington, DC",District of Columbia,1879,867,1,-5,1880,862,7,7,1887,855,1764,214,234,228,0,,0,0.0,0.0,0.0,0.0,0.0
2024,5,15,3,2024-05-15,WN,3393,PHX,ORD,"Phoenix, AZ",Arizona,"Chicago, IL",Illinois,649,637,-5,-5,644,632,12,9,656,623,2238,282,302,303,0,,0,0.0,0.0,0.0,0.0,0.0
2024,7,19,5,2024-07-19,F9,9685,PHL,HNL,"Philadelphia, PA",Pennsylvania,"Honolulu, HI",Hawaii,936,1525,-17,-10,919,1515,15,7,934,1508,2350,296,316,318,0,,0,0.0,0.0,0.0,0.0,0.0
2024,9,6,5,2024-09-06,AA,266,MDW,BOS,"Chicago, IL",Illinois,"Boston, MA",Massachusetts,949,1926,8,15,957,1941,9,8,966,1933,2413,293,313,310,0,,0,0.0,0.0,0.0,0.0,0.0
2024,11,9,6,2024-11-09,OO,3724,LAS,HNL,"Las Vegas, NV",Nevada,"Honolulu, HI",Hawaii,1024,937,-2,5,1022,942,21,3,1043,939,203,18,38,42,0,,0,0.0,0.0,0.0,0.0,0.0
2024,12,22,7,2024-12-22,HA,2447,MSP,STL,"Minneapolis, MN",Minnesota,"St. Louis, MO",Missouri,766,929,28,20,794,949,8,19,802,930,451,65,85,92,0,,0,0.0,3.0,0.0,0.0,17.0
2024,11,13,3,2024-11-13,DL,1504,IAH,STL,"Houston, TX",Texas,"St. Louis, MO",Missouri,2132,798,1,10,2133,808,28,6,2161,802,671,79,99,113,0,,0,0.0,0.0,0.0,0.0,0.0
2024,10,21,1,2024-10-21,AA,6278,DCA,MSP,"Washington, DC",District of Columbia,"Minneapolis, MN",Minnesota,585,1409,10,5,595,1414,12,19,607,1395,2746,342,362,373,0,,0,0.0,0.0,0.0,0.0,0.0
2024,11,9,6,2024-11-09,OO,9817,STL,MIA,"St. Louis, MO",Missouri,"Miami, FL",Florida,808,604,14,5,822,609,6,15,828,594,2513,315,335,336,0,,0,0.0,0.0,0.0,0.0,0.0
2024,7,27,6,2024-07-27,NK,2874,CLT,HNL,"Charlotte, NC",North Carolina,"Honolulu, HI",Hawaii,764,2055,12,10,776,2065,20,7,796,2058,1459,188,208,215,0,,0,0.0,0.0,0.0,0.0,0.0
2024,12,20,5,2024-12-20,DL,9117,SAN,ORD,"San Diego, CA",California,"Chicago, IL",Illinois,991,1588,2,5,993,1593,13,6,1006,1587,2173,274,294,293,0,,0,0.0,0.0,0.0,0.0,0.0
2024,7,29,1,2024-07-29,AA,9416,LAX,MCO,"Los Angeles, CA",California,"Orlando, FL",Florida,2106,1994,-2,-10,2104,1984,21,7,2125,1977,1851,228,248,256,0,,0,0.0,0.0,0.0,0.0,0.0
2024,7,10,3,2024-07-10,HA,8860,MIA,SLC,"Miami, FL",Florida,"Salt Lake City, UT",Utah,1540,1494,-9,0,1531,1494,14,11,1545,1483,1776,222,242,247,0,,0,0.0,0.0,0.0,0.0,0.0
2024,2,13,2,2024-02-13,YX,3839,STL,IAD,"St. Louis, MO",Missouri,"Washington, DC",District of Columbia,1712,702,6,0,1718,702,28,15,1746,687,1407,172,192,215,0,,0,0.0,0.0,0.0,0.0,0.0
2024,1,29,1,2024-01-29,AS,8118,HNL,SEA,"Honolulu, HI",Hawaii,"Seattle, WA",Washington,1021,1034,31,30,1052,1064,28,11,1080,1053,1755,227,247,266,0,,0,4.0,4.0,4.0,0.0,18.0
2024,2,28,3,2024-02-28,AS,4564,PHL,SFO,"Philadelphia, PA",Pennsylvania,"San Francisco, CA",California,1689,1249,3,0,1692,1249,17,6,1709,1243,1997,256,276,279,0,,0,0.0,0.0,0.0,0.0,0.0
2024,3,11,1,2024-03-11,9E,7841,EWR,STL,"Newark, NJ",New Jersey,"St. Louis, MO",Missouri,2074,980,-19,-20,2055,960,26,16,2081,944,1565,192,212,234,0,,0,0.0,0.0,0.0,0.0,0.0
2024,4,1,1,2024-04-01,DL,7736,TPA,SFO,"Tampa, FL",Florida,"San Francisco, CA",California,1377,665,-8,-10,1369,655,21,4,1390,651,1989,253,273,278,0,,0,0.0,0.0,0.0,0.0,0.0
2024,9,21,6,2024-09-21,HA,8120,BWI,MDW,"Baltimore, MD",Maryland,"Chicago, IL",Illinois,1868,1178,14,15,1882,1193,16,4,1898,1189,2263,287,307,307,0,,0,0.0,0.0,0.0,0.0,0.0
2024,8,7,3,2024-08-07,AA,7388,ORD,EWR,"Chicago, IL",Illinois,"Newark, NJ",New Jersey,1742,869,13,20,1755,889,13,11,1768,878,983,121,141,145,0,,0,2.0,0.0,2.0,0.0,16.0
2024,8,2,5,2024-08-02,OH,4194,SFO,ORD,"San Francisco, CA",California,"Chicago, IL",Illinois,593,646,1,5,594,651,19,16,613,635,1118,147,167,182,0,,0,0.0,0.0,0.0,0.0,0.0
2024,10,3,4,2024-10-03,9E,3030,MCO,BOS,"Orlando, FL",Florida,"Boston, MA",Massachusetts,1681,1515,-24,-15,1657,1500,14,14,1671,1486,995,120,140,148,1,,0,0.0,0.0,0.0,0.0,0.0
2024,3,4,1,2024-03-04,UA,863,CLT,IAD,"Charlotte, NC",North Carolina,"Washington, DC",District of Columbia,533,964,-16,-20,517,944,23,7,540,937,817,102,122,132,0,,0,0.0,0.0,0.0,0.0,0.0
2024,12,11,3,2024-12-11,9E,3550,CLT,SAN,"Charlotte, NC",North Carolina,"San Diego, CA",California,1300,1803,-7,0,1293,1803,21,4,1314,1799,1903,228,248,253,0,,0,0.0,0.0,0.0,0.0,0.0
2024,10,18,5,2024-10-18,OH,3495,PDX,SEA,"Portland, OR",Oregon,"Seattle, WA",Washington,915,667,118,120,1033,787,11,10,1044,777,2844,348,368,369,0,,0,28.0,30.0,16.0,1.0,45.0
2024,9,1,7,2024-09-01,B6,3819,CLT,MDW,"Charlotte, NC",North Carolina,"Chicago, IL",Illinois,2029,1738,5,10,2034,1748,18,9,2052,1739,586,73,93,100,0,,0,0.0,0.0,0.0,0.0,0.0
2024,3,2,6,2024-03-02,AS,4901,SAN,HNL,"San Diego, CA",California,"Honolulu, HI",Hawaii,2013,1649,21,15,2034,1664,17,9,2051,1655,1103,143,163,169,0,,0,0.0,0.0,0.0,0.0,0.0
2024,11,27,3,2024-11-27,UA,8512,LGA,MCO,"New York, NY",New York,"Orlando, FL",Florida,1023,2182,-4,0,1019,2182,25,10,1044,2172,1646,206,226,241,0,,0,0.0,0.0,0.0,0.0,0.0
2024,6,18,2,2024-06-18,G4,1961,MIA,HNL,"Miami, FL",Florida,"Honolulu, HI",Hawaii,732,806,15,10,747,816,6,6,753,810,1443,179,199,191,0,,0,0.0,0.0,0.0,0.0,0.0
2024,9,25,3,2024-09-25,OO,9313,MIA,IAH,"Miami, FL",Florida,"Houston, TX",Texas,2122,672,1,-5,2123,667,20,3,2143,664,1507,189,209,212,0,,0,0.0,0.0,0.0,0.0,0.0
2024,9,23,1,2024-09-23,B6,209,DFW,PHL,"Dallas/Fort Worth, TX",Texas,"Philadelphia, PA",Pennsylvania,1104,1882,-23,-20,1081,1862,21,4,1102,1858,1124,137,157,162,0,,0,0.0,0.0,0.0,0.0,0.0
2024,2,23,5,2024-02-23,MQ,6649,LGA,MSP,"New York, NY",New York,"Minneapolis, MN",Minnesota,606,2009,7,15,613,2024,10,6,623,2018,2226,282,302,298,0,,0,0.0,0.0,0.0,0.0,0.0
2024,1,16,2,2024-01-16,DL,8990,IAD,CLT,"Washington, DC",District of Columbia,"Charlotte, NC",North Carolina,1716,629,-1,-10,1715,619,5,11,1720,608,536,74,94,90,0,,0,0.0,0.0,0.0,0.0,0.0
2024,1,8,1,2024-01-08,9E,5629,SLC,LAS,"Salt Lake City, UT",Utah,"Las Vegas, NV",Nevada,1991,2044,0,5,1991,2049,10,5,2001,2044,1301,164,184,179,0,,0,0.0,0.0,0.0,0.0,0.0
2024,4,13,6,2024-04-13,AS,8399,ATL,MSP,"Atlanta, GA",Georgia,"Minneapolis, MN",Minnesota,1021,1626,12,5,1033,1631,5,3,1038,1628,2411,304,324,312,0,,0,0.0,0.0,0.0,0.0,0.0
2024,2,28,3,2024-02-28,YX,8680,SEA,SAN,"Seattle, WA",Washington,"San Diego, CA",California,1136,2144,-10,-10,1126,2134,27,7,1153,2127,424,51,71,85,0,,0,0.0,0.0,0.0,0.0,0.0
2024,11,8,5,2024-11-08,F9,8716,STL,MCO,"St. Louis, MO",Missouri,"Orlando, FL",Florida,1286,2143,-15,-10,1271,2133,27,13,1298,2120,236,38,58,78,0,,0,0.0,0.0,0.0,0.0,0.0
2024,2,9,5,2024-02-09,OO,2594,BOS,DEN,"Boston, MA",Massachusetts,"Denver, CO",Colorado,1518,1120,-3,-5,1515,1115,14,13,1529,1102,985,120,140,147,0,,0,0.0,0.0,0.0,0.0,0.0
2024,8,24,6,2024-08-24,AS,7832,SFO,IAD,"San Francisco, CA",California,"Washington, DC",District of Columbia,1802,1487,3,5,1805,1492,24,13,1829,1479,2704,337,357,374,0,,0,0.0,0.0,0.0,0.0,0.0
2024,4,3,3,2024-04-03,WN,5859,DFW,LAS,"Dallas/Fort Worth, TX",Texas,"Las Vegas, NV",Nevada,1651,1000,-23,-20,1628,980,27,17,1655,963,1420,185,205,229,0,,0,0.0,0.0,0.0,0.0,0.0
2024,8,9,5,2024-08-09,AS,1627,BWI,STL,"Baltimore, MD",Maryland,"St. Louis, MO",Missouri,840,2287,-3,-5,837,2282,28,3,865,2279,275,24,44,55,0,,0,0.0,0.0,0.0,0.0,0.0
2024,7,22,1,2024-07-22,F9,2126,EWR,SEA,"Newark, NJ",New Jersey,"Seattle, WA",Washington,1196,1253,8,5,1204,1258,12,13,1216,1245,960,117,137,142,0,,0,0.0,0.0,0.0,0.0,0.0
2024,5,17,5,2024-05-17,F9,1955,JFK,BOS,"New York, NY",New York,"Boston, MA",Massachusetts,558,1549,-20,-10,538,1539,20,8,558,1531,2185,266,286,294,0,,0,0.0,0.0,0.0,0.0,0.0
2024,10,26,6,2024-10-26,MQ,8738,MSP,BWI,"Minneapolis, MN",Minnesota,"Baltimore, MD",Maryland,1705,1447,-21,-15,1684,1432,16,19,1700,1413,2761,351,371,386,0,,0,0.0,0.0,0.0,0.0,0.0
2024,7,25,4,2024-07-25,9E,1697,PHX,TPA,"Phoenix, AZ",Arizona,"Tampa, FL",Florida,1085,1897,-10,-5,1075,1892,23,13,1098,1879,2012,251,271,287,0,,0,0.0,0.0,0.0,0.0,0.0
2024,12,1,7,2024-12-01,DL,8501,CLT,DCA,"Charlotte, NC",North Carolina,"Washington, DC",District of Columbia,2037,2095,-12,-10,2025,2085,18,11,2043,2074,2519,314,334,343,0,,0,0.0,0.0,0.0,0.0,0.0
2024,3,21,4,2024-03-21,F9,948,PDX,IAD,"Portland, OR",Oregon,"Washington, DC",District of Columbia,742,1534,9,0,751,1534,12,14,763,1520,875,113,133,139,0,,0,0.0,0.0,0.0,0.0,0.0
2024,8,5,1,2024-08-05,AS,6058,DTW,ORD,"Detroit, MI",Michigan,"Chicago, IL",Illinois,727,1995,22,20,749,2015,23,15,772,2000,298,40,60,78,0,,0,4.0,1.0,1.0,0.0,14.0
2024,1,2,2,2024-01-02,DL,9943,DTW,STL,"Detroit, MI",Michigan,"St. Louis, MO",Missouri,1059,1030,-30,-20,1029,1010,19,5,1048,1005,1307,160,180,184,0,,0,0.0,0.0,0.0,0.0,0.0
2024,6,26,3,2024-06-26,AA,3629,IAH,BWI,"Houston, TX",Texas,"Baltimore, MD",Maryland,1017,1138,10,15,1027,1153,9,6,1036,1147,2537,312,332,327,0,,0,0.0,0.0,0.0,0.0,0.0
2024,12,11,3,2024-12-11,AS,2018,DEN,MDW,"Denver, CO",Colorado,"Chicago, IL",Illinois,1054,1971,-9,-5,1045,1966,21,18,1066,1948,297,34,54,73,0,,0,0.0,0.0,0.0,0.0,0.0
2024,10,5,6,2024-10-05,MQ,8868,BOS,PHL,"Boston, MA",Massachusetts,"Philadelphia, PA",Pennsylvania,1668,670,4,5,1672,675,27,6,1699,669,1755,226,246,259,0,,0,0.0,0.0,0.0,0.0,0.0
2024,5,25,6,2024-05-25,NK,5861,ATL,PHL,"Atlanta, GA",Georgia,"Philadelphia, PA",Pennsylvania,626,2105,3,10,629,2115,18,14,647,2101,1460,177,197,209,0,,0,0.0,0.0,0.0,0.0,0.0
2024,11,13,3,2024-11-13,OH,788,LAS,ORD,"Las Vegas, NV",Nevada,"Chicago, IL",Illinois,834,2354,7,0,841,2354,19,12,860,2342,570,78,98,109,0,,0,0.0,0.0,0.0,0.0,0.0
2024,8,11,7,2024-08-11,OH,9081,MDW,BOS,"Chicago, IL",Illinois,"Boston, MA",Massachusetts,1257,855,-10,-15,1247,840,12,15,1259,825,1374,166,186,193,0,,0,0.0,0.0,0.0,0.0,0.0
2024,3,2,6,2024-03-02,9E,6406,CLT,PDX,"Charlotte, NC",North Carolina,"Portland, OR",Oregon,1931,1726,-7,-15,1924,1711,8,8,1932,1703,2894,356,376,372,0,,0,0.0,0.0,0.0,0.0,0.0
2024,10,20,7,2024-10-20,B6,5172,LAS,TPA,"Las Vegas, NV",Nevada,"Tampa, FL",Florida,620,746,5,5,625,751,11,10,636,741,884,109,129,130,0,,0,0.0,0.0,0.0,0.0,0.0
2024,8,26,1,2024-08-26,OH,1455,ATL,EWR,"Atlanta, GA",Georgia,"Newark, NJ",New Jersey,2267,1501,-4,-10,2263,1491,11,13,2274,1478,651,83,103,107,0,,0,0.0,0.0,0.0,0.0,0.0
2024,7,13,6,2024-07-13,9E,1787,DTW,HNL,"Detroit, MI",Michigan,"Honolulu, HI",Hawaii,1200,1269,-9,0,1191,1269,26,19,1217,1250,1271,154,174,199,0,,0,0.0,0.0,0.0,0.0,0.0
2024,6,14,5,2024-06-14,F9,8641,SEA,ATL,"Seattle, WA",Washington,"Atlanta, GA",Georgia,1808,739,-9,-5,1799,734,9,8,1808,726,2873,362,382,379,0,,0,0.0,0.0,0.0,0.0,0.0
2024,8,9,5,2024-08-09,OO,9421,DTW,IAD,"Detroit, MI",Michigan,"Washington, DC",District of Columbia,741,1254,-7,-5,734,1249,14,17,748,1232,1554,184,204,215,0,,0,0.0,0.0,0.0,0.0,0.0
2024,3,1,5,2024-03-01,MQ,4450,BOS,SFO,"Boston, MA",Massachusetts,"San Francisco, CA",California,577,1220,8,5,585,1225,24,15,609,1210,2572,327,347,366,0,,0,0.0,0.0,0.0,0.0,0.0
2024,5,8,3,2024-05-08,YX,6601,IAD,DEN,"Washington, DC",District of Columbia,"Denver, CO",Colorado,2093,2046,11,5,2104,2051,9,11,2113,2040,1970,252,272,272,0,,0,0.0,0.0,0.0,0.0,0.0
2024,6,21,5,2024-06-21,G4,6186,MSP,DCA,"Minneapolis, MN",Minnesota,"Washington, DC",District of Columbia,949,1470,4,0,953,1470,27,17,980,1453,1145,137,157,181,0,,0,0.0,0.0,0.0,0.0,0.0
2024,6,4,2,2024-06-04,WN,4308,DCA,MDW,"Washington, DC",District of Columbia,"Chicago, IL",Illinois,1993,663,-9,-5,1984,658,28,12,2012,646,1583,187,207,227,0,,0,0.0,0.0,0.0,0.0,0.0
2024,4,19,5,2024-04-19,NK,6767,SFO,MIA,"San Francisco, CA",California,"Miami, FL",Florida,1704,1894,-14,-10,1690,1884,8,7,1698,1877,243,38,58,53,0,,0,0.0,0.0,0.0,0.0,0.0
2024,9,25,3,2024-09-25,F9,1090,DFW,IAH,"Dallas/Fort Worth, TX",Texas,"Houston, TX",Texas,2105,2321,3,0,2108,2321,25,17,2133,2304,1959,234,254,276,0,,0,0.0,0.0,0.0,0.0,0.0
2024,12,21,6,2024-12-21,MQ,5390,LGA,EWR,"New York, NY",New York,"Newark, NJ",New Jersey,764,1467,8,10,772,1477,15,5,787,1472,2464,317,337,337,0,,0,0.0,0.0,0.0,0.0,0.0
2024,10,4,5,2024-10-04,AS,1476,SEA,BOS,"Seattle, WA",Washington,"Boston, MA",Massachusetts,2239,1434,-2,0,2237,1434,10,18,2247,1416,1927,238,258,266,0,,0,0.0,0.0,0.0,0.0,0.0
2024,3,14,4,2024-03-14,DL,9518,LGA,LAS,"New York, NY",New York,"Las Vegas, NV",Nevada,1181,1112,26,20,1207,1132,19,7,1226,1125,1279,156,176,182,0,,0,7.0,1.0,2.0,0.0,10.0
2024,7,25,4,2024-07-25,NK,7347,JFK,DCA,"New York, NY",New York,"Washington, DC",District of Columbia,794,1630,-29,-20,765,1610,15,7,780,1603,1177,143,163,165,0,,0,0.0,0.0,0.0,0.0,0.0
2024,10,5,6,2024-10-05,MQ,7302,HNL,MIA,"Honolulu, HI",Hawaii,"Miami, FL",Florida,1464,2016,91,90,1555,2106,29,4,1584,2102,1234,154,174,187,0,,0,5.0,2.0,11.0,1.0,71.0
2024,11,21,4,2024-11-21,G4,8855,SFO,PHL,"San Francisco, CA",California,"Philadelphia, PA",Pennsylvania,1389,1624,10,5,1399,1629,26,10,1425,1619,2604,317,337,353,0,,0,0.0,0.0,0.0,0.0,0.0
2024,12,5,4,2024-12-05,B6,6404,BWI,PHL,"Baltimore, MD",Maryland,"Philadelphia, PA",Pennsylvania,746,1884,1,10,747,1894,11,19,758,1875,2726,347,367,377,0,,0,0.0,0.0,0.0,0.0,0.0
2024,12,22,7,2024-12-22,HA,2987,DCA,SAN,"Washington, DC",District of Columbia,"San Diego, CA",California,923,646,-1,-5,922,641,28,5,950,636,1093,135,155,168,0,,0,0.0,0.0,0.0,0.0,0.0
2024,12,5,4,2024-12-05,DL,6781,MCO,SEA,"Orlando, FL",Florida,"Seattle, WA",Washington,1582,1467,-5,0,1577,1467,23,3,1600,1464,768,101,121,127,0,,0,0.0,0.0,0.0,0.0,0.0
2024,7,22,1,2024-07-22,WN,7713,DFW,SLC,"Dallas/Fort Worth, TX",Texas,"Salt Lake City, UT",Utah,1332,1377,5,5,1337,1382,9,12,1346,1370,1958,251,271,272,0,,0,0.0,0.0,0.0,0.0,0.0
2024,6,9,7,2024-06-09,UA,1440,SAN,MCO,"San Diego, CA",California,"Orlando, FL",Florida,1981,1625,11,5,1992,1630,8,18,2000,1612,304,29,49,55,0,,0,0.0,0.0,0.0,0.0,0.0
2024,1,28,7,2024-01-28,WN,8072,DCA,PDX,"Washington, DC",District of Columbia,"Portland, OR",Oregon,510,1134,-12,-5,498,1129,5,15,503,1114,2223,275,295,295,0,,0,0.0,0.0,0.0,0.0,0.0
2024,9,13,5,2024-09-13,9E,9729,SEA,STL,"Seattle, WA",Washington,"St. Louis, MO",Missouri,846,958,3,-5,849,953,20,8,869,945,820,100,120,128,0,,0,0.0,0.0,0.0,0.0,0.0
2024,6,13,4,2024-06-13,NK,194,BWI,SAN,"Baltimore, MD",Maryland,"San Diego, CA",California,1351,2100,-1,5,1350,2105,16,15,1366,2090,749,86,106,117,0,,0,0.0,0.0,0.0,0.0,0.0
2024,3,3,7,2024-03-03,9E,3396,DTW,DEN,"Detroit, MI",Michigan,"Denver, CO",Colorado,1528,2045,16,15,1544,2060,24,14,1568,2046,2879,360,380,398,0,,0,0.0,0.0,0.0,0.0,0.0
2024,1,22,1,2024-01-22,F9,5998,LAX,ORD,"Los Angeles, CA",California,"Chicago, IL",Illinois,2240,1414,3,-5,2243,1409,22,7,2265,1402,2254,287,307,316,1,,0,0.0,0.0,0.0,0.0,0.0
2024,3,10,7,2024-03-10,AA,9240,IAH,ORD,"Houston, TX",Texas,"Chicago, IL",Illinois,1893,1195,-15,-5,1878,1190,24,9,1902,1181,2889,359,379,392,0,,0,0.0,0.0,0.0,0.0,0.0
2024,4,5,5,2024-04-05,MQ,2792,LGA,SAN,"New York, NY",New York,"San Diego, CA",California,1981,803,10,10,1991,813,6,4,1997,809,2291,286,306,296,0,,0,0.0,0.0,0.0,0.0,0.0
2024,6,11,2,2024-06-11,F9,4261,SAN,MCO,"San Diego, CA",California,"Orlando, FL",Florida,744,1570,0,5,744,1575,17,12,761,1563,1417,177,197,206,0,,0,0.0,0.0,0.0,0.0,0.0
2024,3,19,2,2024-03-19,B6,8226,DEN,BWI,"Denver, CO",Colorado,"Baltimore, MD",Maryland,748,826,-12,-5,736,821,16,12,752,809,2909,369,389,397,0,,0,0.0,0.0,0.0,0.0,0.0
2024,1,5,5,2024-01-05,YX,3381,BOS,MSP,"Boston, MA",Massachusetts,"Minneapolis, MN",Minnesota,1444,1547,-9,-15,1435,1532,8,9,1443,1523,447,62,82,79,0,,0,0.0,0.0,0.0,0.0,0.0
2024,11,11,1,2024-11-11,NK,1597,LGA,SLC,"New York, NY",New York,"Salt Lake City, UT",Utah,934,1416,6,5,940,1421,8,15,948,1406,1833,235,255,258,0,,0,0.0,0.0,0.0,0.0,0.0
2024,4,29,1,2024-04-29,OO,7153,BOS,SLC,"Boston, MA",Massachusetts,"Salt Lake City, UT",Utah,1943,750,-6,-5,1937,745,17,15,1954,730,236,19,39,51,0,,0,0.0,0.0,0.0,0.0,0.0
2024,10,28,1,2024-10-28,OO,6814,SAN,JFK,"San Diego, CA",California,"New York, NY",New York,604,1870,-12,-15,592,1855,7,13,599,1842,1536,188,208,208,0,,0,0.0,0.0,0.0,0.0,0.0
2024,6,26,3,2024-06-26,AA,7757,SFO,DTW,"San Francisco, CA",California,"Detroit, MI",Michigan,741,616,-4,0,737,616,25,9,762,607,2898,365,385,399,0,,0,0.0,0.0,0.0,0.0,0.0
2024,6,24,1,2024-06-24,DL,8103,HNL,ORD,"Honolulu, HI",Hawaii,"Chicago, IL",Illinois,1795,903,-5,-5,1790,898,29,4,1819,894,772,104,124,137,0,,0,0.0,0.0,0.0,0.0,0.0
2024,8,4,7,2024-08-04,AA,7791,MSP,TPA,"Minneapolis, MN",Minnesota,"Tampa, FL",Florida,1018,2137,-13,-5,1005,2132,21,14,1026,2118,2210,280,300,315,0,,0,0.0,0.0,0.0,0.0,0.0
2024,2,25,7,2024-02-25,B6,8206,IAD,SEA,"Washington, DC",District of Columbia,"Seattle, WA",Washington,2259,1820,-3,0,2256,1820,11,15,2267,1805,853,111,131,137,0,,0,0.0,0.0,0.0,0.0,0.0
2024,7,5,5,2024-07-05,OH,301,CLT,HNL,"Charlotte, NC",North Carolina,"Honolulu, HI",Hawaii,1228,2069,14,5,1242,2074,17,6,1259,2068,2831,357,377,380,0,,0,0.0,0.0,0.0,0.0,0.0
2024,8,19,1,2024-08-19,OH,1598,IAD,ATL,"Washington, DC",District of Columbia,"Atlanta, GA",Georgia,1567,1964,-16,-10,1551,1954,19,3,1570,1951,1816,231,251,253,0,,0,0.0,0.0,0.0,0.0,0.0
2024,9,11,3,2024-09-11,AS,3186,SFO,ORD,"San Francisco, CA",California,"Chicago, IL",Illinois,1549,1380,-22,-15,1527,1365,18,17,1545,1348,2324,293,313,328,0,,0,0.0,0.0,0.0,0.0,0.0
2024,4,13,6,2024-04-13,9E,2690,BWI,SFO,"Baltimore, MD",Maryland,"San Francisco, CA",California,680,1684,-3,-5,677,1679,20,17,697,1662,1967,251,271,288,0,,0,0.0,0.0,0.0,0.0,0.0
2024,3,17,7,2024-03-17,G4,7225,MIA,PDX,"Miami, FL",Florida,"Portland, OR",Oregon,1103,866,-22,-15,1081,851,21,19,1102,832,1078,140,160,180,0,,0,0.0,0.0,0.0,0.0,0.0
2024,8,17,6,2024-08-17,F9,7960,ORD,IAH,"Chicago, IL",Illinois,"Houston, TX",Texas,927,1720,0,5,927,1725,20,5,947,1720,2838,350,370,375,0,,0,0.0,0.0,0.0,0.0,0.0
2024,9,14,6,2024-09-14,NK,5508,PDX,DTW,"Portland, OR",Oregon,"Detroit, MI",Michigan,767,1906,11,20,778,1926,20,10,798,1916,1648,200,220,230,0,,0,2.0,2.0,2.0,0.0,14.0
2024,9,20,5,2024-09-20,YX,2048,LGA,BOS,"New York, NY",New York,"Boston, MA",Massachusetts,1357,1870,-1,5,1356,1875,5,9,1361,1866,939,119,139,133,0,,0,0.0,0.0,0.0,0.0,0.0
2024,11,26,2,2024-11-26,B6,4063,DFW,JFK,"Dallas/Fort Worth, TX",Texas,"New York, NY",New York,1079,634,-6,-10,1073,624,18,3,1091,621,1429,183,203,204,0,,0,0.0,0.0,0.0,0.0,0.0
2024,6,30,7,2024-06-30,OH,793,DEN,CLT,"Denver, CO",Colorado,"Charlotte, NC",North Carolina,1375,1385,-13,-10,1362,1375,6,3,1368,1372,2341,282,302,291,0,,0,0.0,0.0,0.0,0.0,0.0
2024,9,12,4,2024-09-12,HA,5463,MIA,SFO,"Miami, FL",Florida,"San Francisco, CA",California,650,2092,-19,-10,631,2082,26,13,657,2069,2949,372,392,411,0,,0,0.0,0.0,0.0,0.0,0.0
2024,2,7,3,2024-02-07,UA,5987,EWR,ORD,"Newark, NJ",New Jersey,"Chicago, IL",Illinois,2139,667,-16,-10,2123,657,13,3,2136,654,1409,171,191,187,0,,0,0.0,0.0,0.0,0.0,0.0
2024,6,24,1,2024-06-24,G4,7834,JFK,PDX,"New York, NY",New York,"Portland, OR",Oregon,1099,788,-7,-5,1092,783,23,17,1115,766,246,24,44,64,0,,0,0.0,0.0,0.0,0.0,0.0
2024,1,27,6,2024-01-27,MQ,5817,JFK,BOS,"New York, NY",New York,"Boston, MA",Massachusetts,594,640,-18,-15,576,625,9,10,585,615,1350,173,193,192,0,,0,0.0,0.0,0.0,0.0,0.0
2024,10,2,3,2024-10-02,B6,5393,LGA,PHL,"New York, NY",New York,"Philadelphia, PA",Pennsylvania,881,1207,13,10,894,1217,28,15,922,1202,2763,340,360,383,0,,0,0.0,0.0,0.0,0.0,0.0
2024,5,19,7,2024-05-19,UA,4151,SEA,MIA,"Seattle, WA",Washington,"Miami, FL",Florida,1014,1282,15,10,1029,1292,14,5,1043,1287,528,67,87,86,0,,0,0.0,0.0,0.0,0.0,0.0
2024,10,25,5,2024-10-25,UA,2391,ATL,BWI,"Atlanta, GA",Georgia,"Baltimore, MD",Maryland,2243,1544,-9,0,2234,1544,10,9,2244,1535,552,69,89,88,0,,0,0.0,0.0,0.0,0.0,0.0
2024,10,13,7,2024-10-13,UA,2798,IAD,SFO,"Washington, DC",District of Columbia,"San Francisco, CA",California,1429,1506,-23,-15,1406,1491,7,15,1413,1476,1793,224,244,246,0,,0,0.0,0.0,0.0,0.0,0.0
2024,3,31,7,2024-03-31,OH,9302,PHX,PDX,"Phoenix, AZ",Arizona,"Portland, OR",Oregon,2137,1690,3,10,2140,1700,6,14,2146,1686,1982,247,267,267,0,,0,0.0,0.0,0.0,0.0,0.0
2024,3,1,5,2024-03-01,AS,1141,DFW,LAX,"Dallas/Fort Worth, TX",Texas,"Los Angeles, CA",California,2212,1546,-11,-15,2201,1531,23,5,2224,1526,387,56,76,84,0,,0,0.0,0.0,0.0,0.0,0.0
2024,12,30,1,2024-12-30,AA,1657,DTW,PDX,"Detroit, MI",Michigan,"Portland, OR",Oregon,1951,1931,-21,-15,1930,1916,10,12,1940,1904,911,103,123,125,0,,0,0.0,0.0,0.0,0.0,0.0
2024,12,12,4,2024-12-12,OO,1307,DFW,SEA,"Dallas/Fort Worth, TX",Texas,"Seattle, WA",Washington,1948,1742,-1,-5,1947,1737,25,7,1972,1730,790,97,117,129,0,,0,0.0,0.0,0.0,0.0,0.0
2024,6,11,2,2024-06-11,WN,9972,ATL,DTW,"Atlanta, GA",Georgia,"Detroit, MI",Michigan,698,1452,2,-5,700,1447,28,11,728,1436,429,48,68,87,0,,0,0.0,0.0,0.0,0.0,0.0
2024,12,16,1,2024-12-16,MQ,3721,DFW,IAD,"Dallas/Fort Worth, TX",Texas,"Washington, DC",District of Columbia,507,2306,-3,-5,504,2301,14,3,518,2298,2148,273,293,290,0,,0,0.0,0.0,0.0,0.0,0.0
2024,5,22,3,2024-05-22,F9,3452,DEN,TPA,"Denver, CO",Colorado,"Tampa, FL",Florida,2280,1809,-10,-10,2270,1799,22,7,2292,1792,520,60,80,89,0,,0,0.0,0.0,0.0,0.0,0.0
2024,9,9,1,2024-09-09,UA,7555,PHX,ORD,"Phoenix, AZ",Arizona,"Chicago, IL",Illinois,1304,1573,-16,-15,1288,1558,18,3,1306,1555,2733,335,355,356,0,,0,0.0,0.0,0.0,0.0,0.0
2024,9,25,3,2024-09-25,B6,1778,LAS,ORD,"Las Vegas, NV",Nevada,"Chicago, IL",Illinois,826,1693,3,10,829,1703,6,4,835,1699,1595,201,221,211,0,,0,0.0,0.0,0.0,0.0,0.0
2024,10,17,4,2024-10-17,DL,9072,DCA,MCO,"Washington, DC",District of Columbia,"Orlando, FL",Florida,2213,1610,4,-5,2217,1605,8,12,2225,1593,277,33,53,53,0,,0,0.0,0.0,0.0,0.0,0.0
2024,7,5,5,2024-07-05,HA,6852,MDW,SLC,"Chicago, IL",Illinois,"Salt Lake City, UT",Utah,2117,1356,-16,-10,2101,1346,19,6,2120,1340,1679,209,229,234,0,,0,0.0,0.0,0.0,0.0,0.0
2024,10,30,3,2024-10-30,DL,1045,IAH,PDX,"Houston, TX",Texas,"Portland, OR",Oregon,2147,2294,-10,0,2137,2294,29,5,2166,2289,2766,339,359,373,0,,0,0.0,0.0,0.0,0.0,0.0
2024,10,17,4,2024-10-17,OO,3528,EWR,IAD,"Newark, NJ",New Jersey,"Washington, DC",District of Columbia,1370,1606,-18,-20,1352,1586,25,12,1377,1574,1823,228,248,265,0,,0,0.0,0.0,0.0,0.0,0.0
2024,3,26,2,2024-03-26,MQ,8073,DEN,SLC,"Denver, CO",Colorado,"Salt Lake City, UT",Utah,1544,1907,3,0,1547,1907,27,17,1574,1890,392,52,72,96,0,,0,0.0,0.0,0.0,0.0,0.0
2024,6,14,5,2024-06-14,NK,7268,PHX,HNL,"Phoenix, AZ",Arizona,"Honolulu, HI",Hawaii,2069,2242,-5,-10,2064,2232,27,8,2091,2224,2993,373,393,408,0,,0,0.0,0.0,0.0,0.0,0.0
2024,4,23,2,2024-04-23,9E,8839,MIA,SLC,"Miami, FL",Florida,"Salt Lake City, UT",Utah,754,1147,2,0,756,1147,10,3,766,1144,1008,118,138,131,0,,0,0.0,0.0,0.0,0.0,0.0
2024,12,21,6,2024-12-21,UA,3084,ATL,LAX,"Atlanta, GA",Georgia,"Los Angeles, CA",California,1956,1971,4,0,1960,1971,10,12,1970,1959,2033,263,283,285,0,,0,0.0,0.0,0.0,0.0,0.0
2024,7,1,1,2024-07-01,B6,2690,IAH,MCO,"Houston, TX",Texas,"Orlando, FL",Florida,2028,1514,8,10,2036,1524,13,4,2049,1520,618,80,100,97,0,,0,0.0,0.0,0.0,0.0,0.0
2024,7,25,4,2024-07-25,UA,1897,SLC,IAD,"Salt Lake City, UT",Utah,"Washington, DC",District of Columbia,1550,1818,-18,-10,1532,1808,24,11,1556,1797,1641,213,233,248,0,,0,0.0,0.0,0.0,0.0,0.0
2024,9,12,4,2024-09-12,AS,5143,ORD,TPA,"Chicago, IL",Illinois,"Tampa, FL",Florida,1019,1083,-9,0,1010,1083,22,19,1032,1064,2128,274,294,315,0,,0,0.0,0.0,0.0,0.0,0.0
2024,8,22,4,2024-08-22,MQ,2357,IAH,LGA,"Houston, TX",Texas,"New York, NY",New York,1429,1187,21,20,1450,1207,27,18,1477,1189,1016,131,151,176,1,,0,1.0,1.0,2.0,0.0,16.0
2024,12,20,5,2024-12-20,9E,2297,BWI,BOS,"Baltimore, MD",Maryland,"Boston, MA",Massachusetts,1029,1903,12,5,1041,1908,26,4,1067,1904,2653,336,356,366,0,,0,0.0,0.0,0.0,0.0,0.0
2024,1,3,3,2024-01-03,UA,8322,MCO,ORD,"Orlando, FL",Florida,"Chicago, IL",Illinois,1446,1971,13,20,1459,1991,8,18,1467,1973,620,76,96,102,0,,0,1.0,1.0,3.0,0.0,15.0
2024,7,26,5,2024-07-26,F9,8903,DEN,DCA,"Denver, CO",Colorado,"Washington, DC",District of Columbia,999,2215,24,15,1023,2230,5,5,1028,2225,2563,315,335,325,0,,0,0.0,0.0,0.0,0.0,0.0
2024,7,15,1,2024-07-15,DL,4497,DTW,STL,"Detroit, MI",Michigan,"St. Louis, MO",Missouri,1756,2101,4,0,1760,2101,8,15,1768,2086,211,21,41,44,0,,0,0.0,0.0,0.0,0.0,0.0
2024,12,6,5,2024-12-06,UA,3012,LAS,SEA,"Las Vegas, NV",Nevada,"Seattle, WA",Washington,1919,1721,-20,-10,1899,1711,26,8,1925,1703,2626,318,338,352,0,,0,0.0,0.0,0.0,0.0,0.0
2024,5,4,6,2024-05-04,F9,8974,CLT,JFK,"Charlotte, NC",North Carolina,"New York, NY",New York,1830,881,2,5,1832,886,7,9,1839,877,2539,316,336,332,0,,0,0.0,0.0,0.0,0.0,0.0
2024,5,17,5,2024-05-17,F9,8548,LAX,IAH,"Los Angeles, CA",California,"Houston, TX",Texas,1009,1229,11,5,1020,1234,17,14,1037,1220,1063,138,158,169,0,,0,0.0,0.0,0.0,0.0,0.0
2024,12,4,3,2024-12-04,AA,9231,CLT,IAH,"Charlotte, NC",North Carolina,"Houston, TX",Texas,2226,1018,-6,0,2220,1018,19,16,2239,1002,1094,127,147,162,0,,0,0.0,0.0,0.0,0.0,0.0
2024,1,25,4,2024-01-25,F9,6252,TPA,CLT,"Tampa, FL",Florida,"Charlotte, NC",North Carolina,923,822,1,5,924,827,5,17,929,810,2121,256,276,278,0,,0,0.0,0.0,0.0,0.0,0.0
2024,3,8,5,2024-03-08,9E,7272,SEA,MDW,"Seattle, WA",Washington,"Chicago, IL",Illinois,649,1875,-8,0,641,1875,20,4,661,1871,1085,139,159,163,0,,0,0.0,0.0,0.0,0.0,0.0
2024,3,1,5,2024-03-01,DL,2994,PHL,DFW,"Philadelphia, PA",Pennsylvania,"Dallas/Fort Worth, TX",Texas,1915,679,-5,0,1910,679,6,12,1916,667,844,113,133,131,0,,0,0.0,0.0,0.0,0.0,0.0
2024,1,29,1,2024-01-29,YX,3285,BWI,EWR,"Baltimore, MD",Maryland,"Newark, NJ",New Jersey,2013,1425,-3,-5,2010,1420,10,19,2020,1401,2447,314,334,343,0,,0,0.0,0.0,0.0,0.0,0.0
2024,1,19,5,2024-01-19,NK,9068,PHX,IAD,"Phoenix, AZ",Arizona,"Washington, DC",District of Columbia,1167,1281,-15,-20,1152,1261,5,17,1157,1244,771,92,112,114,0,,0,0.0,0.0,0.0,0.0,0.0
2024,6,19,3,2024-06-19,AS,2832,ATL,JFK,"Atlanta, GA",Georgia,"New York, NY",New York,1445,1012,16,10,1461,1022,26,8,1487,1014,1831,226,246,260,0,,0,0.0,0.0,0.0,0.0,0.0
2024,3,14,4,2024-03-14,DL,9023,DFW,SFO,"Dallas/Fort Worth, TX",Texas,"San Francisco, CA",California,1570,2292,5,10,1575,2302,21,4,1596,2298,2960,366,386,391,0,,0,0.0,0.0,0.0,0.0,0.0
2024,3,1,5,2024-03-01,B6,5424,TPA,PDX,"Tampa, FL",Florida,"Portland, OR",Oregon,811,2016,-6,0,805,2016,21,3,826,2013,1345,173,193,197,0,,1,0.0,0.0,0.0,0.0,0.0
2024,6,1,6,2024-06-01,NK,9261,PDX,LGA,"Portland, OR",Oregon,"New York, NY",New York,638,933,-3,-10,635,923,26,11,661,912,1768,214,234,251,0,,0,0.0,0.0,0.0,0.0,0.0
2024,10,2,3,2024-10-02,F9,7949,LAS,HNL,"Las Vegas, NV",Nevada,"Honolulu, HI",Hawaii,1928,1488,-27,-20,1901,1468,5,18,1906,1450,525,62,82,85,0,,0,0.0,0.0,0.0,0.0,0.0
2024,2,17,6,2024-02-17,UA,8394,MIA,DCA,"Miami, FL",Florida,"Washington, DC",District of Columbia,1421,1951,-19,-20,1402,1931,20,18,1422,1913,2855,355,375,393,0,,0,0.0,0.0,0.0,0.0,0.0
2024,7,29,1,2024-07-29,AA,1183,IAD,MCO,"Washington, DC",District of Columbia,"Orlando, FL",Florida,2177,1625,-10,-15,2167,1610,13,16,2180,1594,1483,187,207,216,0,,0,0.0,0.0,0.0,0.0,0.0
2024,12,8,7,2024-12-08,MQ,5305,SEA,SLC,"Seattle, WA",Washington,"Salt Lake City, UT",Utah,513,1826,-5,-5,508,1821,6,3,514,1818,2419,303,323,312,0,,0,0.0,0.0,0.0,0.0,0.0
2024,5,18,6,2024-05-18,NK,4962,MCO,HNL,"Orlando, FL",Florida,"Honolulu, HI",Hawaii,1270,857,-10,-10,1260,847,29,4,1289,843,2485,317,337,350,0,,0,0.0,0.0,0.0,0.0,0.0
2024,4,19,5,2024-04-19,MQ,3170,ATL,DTW,"Atlanta, GA",Georgia,"Detroit, MI",Michigan,2271,1362,-15,-10,2256,1352,25,11,2281,1341,2595,316,336,352,0,,0,0.0,0.0,0.0,0.0,0.0
2024,7,1,1,2024-07-01,B6,8663,DEN,PHX,"Denver, CO",Colorado,"Phoenix, AZ",Arizona,2042,1990,10,5,2052,1995,9,18,2061,1977,874,107,127,134,0,,0,0.0,0.0,0.0,0.0,0.0
2024,1,28,7,2024-01-28,B6,8970,ORD,CLT,"Chicago, IL",Illinois,"Charlotte, NC",North Carolina,2074,1769,15,20,2089,1789,12,7,2101,1782,1594,196,216,215,0,,0,5.0,0.0,3.0,0.0,12.0
2024,7,15,1,2024-07-15,NK,301,ORD,STL,"Chicago, IL",Illinois,"St. Louis, MO",Missouri,684,1436,-12,-10,672,1426,5,18,677,1408,2793,346,366,369,0,,0,0.0,0.0,0.0,0.0,0.0
2024,7,9,2,2024-07-09,AA,188,DTW,MCO,"Detroit, MI",Michigan,"Orlando, FL",Florida,1638,2001,7,0,1645,2001,13,7,1658,1994,2360,285,305,305,0,,0,0.0,0.0,0.0,0.0,0.0
2024,11,10,7,2024-11-10,F9,6399,PHL,PHX,"Philadelphia, PA",Pennsylvania,"Phoenix, AZ",Arizona,609,2064,35,45,644,2109,18,19,662,2090,364,54,74,91,0,,0,17.0,3.0,2.0,1.0,22.0
2024,2,20,2,2024-02-20,YX,8479,ORD,SLC,"Chicago, IL",Illinois,"Salt Lake City, UT",Utah,2100,1054,22,15,2122,1069,21,12,2143,1057,1704,216,236,249,0,,0,0.0,0.0,0.0,0.0,0.0
2024,5,28,2,2024-05-28,OH,5271,DEN,MIA,"Denver, CO",Colorado,"Miami, FL",Florida,1242,2030,3,-5,1245,2025,9,14,1254,2011,2220,281,301,304,0,,0,0.0,0.0,0.0,0.0,0.0
2024,9,24,2,2024-09-24,9E,1654,MDW,JFK,"Chicago, IL",Illinois,"New York, NY",New York,780,618,-7,-5,773,613,12,7,785,606,387,39,59,58,0,,0,0.0,0.0,0.0,0.0,0.0
2024,2,19,1,2024-02-19,HA,5699,MIA,SEA,"Miami, FL",Florida,"Seattle, WA",Washington,1042,1553,-7,-10,1035,1543,21,10,1056,1533,1432,182,202,213,0,,0,0.0,0.0,0.0,0.0,0.0
2024,9,2,1,2024-09-02,B6,8521,LGA,MDW,"New York, NY",New York,"Chicago, IL",Illinois,585,1578,-9,-10,576,1568,25,13,601,1555,1222,154,174,192,0,,0,0.0,0.0,0.0,0.0,0.0
2024,4,22,1,2024-04-22,F9,154,IAD,STL,"Washington, DC",District of Columbia,"St. Louis, MO",Missouri,637,1032,-1,0,636,1032,16,5,652,1027,2874,364,384,385,0,,0,0.0,0.0,0.0,0.0,0.0
2024,6,18,2,2024-06-18,9E,4466,SAN,IAD,"San Diego, CA",California,"Washington, DC",District of Columbia,1989,2052,-7,-5,1982,2047,23,18,2005,2029,1281,158,178,199,0,,0,0.0,0.0,0.0,0.0,0.0
2024,6,14,5,2024-06-14,HA,4131,EWR,MSP,"Newark, NJ",New Jersey,"Minneapolis, MN",Minnesota,576,851,6,5,582,856,12,13,594,843,2848,356,376,381,0,,0,0.0,0.0,0.0,0.0,0.0
2024,1,14,7,2024-01-14,9E,9415,SLC,LAS,"Salt Lake City, UT",Utah,"Las Vegas, NV",Nevada,1660,1395,-16,-10,1644,1385,23,19,1667,1366,503,53,73,95,0,,0,0.0,0.0,0.0,0.0,0.0
2024,7,21,7,2024-07-21,B6,3240,SAN,SFO,"San Diego, CA",California,"San Francisco, CA",California,2157,2185,13,5,2170,2190,16,12,2186,2178,271,28,48,56,0,,0,0.0,0.0,0.0,0.0,0.0
2024,10,14,1,2024-10-14,YX,8178,PHL,IAH,"Philadelphia, PA",Pennsylvania,"Houston, TX",Texas,1474,1506,-11,-10,1463,1496,12,13,1475,1483,2827,350,370,375,0,,0,0.0,0.0,0.0,0.0,0.0
2024,7,7,7,2024-07-07,NK,1652,JFK,BWI,"New York, NY",New York,"Baltimore, MD",Maryland,1275,1248,-9,0,1266,1248,15,17,1281,1231,1869,228,248,260,0,,0,0.0,0.0,0.0,0.0,0.0
2024,6,3,1,2024-06-03,9E,7895,TPA,BOS,"Tampa, FL",Florida,"Boston, MA",Massachusetts,1516,1509,-5,0,1511,1509,15,10,1526,1499,2847,352,372,377,0,,0,0.0,0.0,0.0,0.0,0.0
2024,2,24,6,2024-02-24,UA,5371,STL,LGA,"St. Louis, MO",Missouri,"New York, NY",New York,596,1337,-1,5,595,1342,19,7,614,1335,2971,374,394,400,0,,0,0.0,0.0,0.0,0.0,0.0
2024,6,30,7,2024-06-30,DL,215,LGA,JFK,"New York, NY",New York,"New York, NY",New York,1494,820,-20,-10,1474,810,6,7,1480,803,1482,192,212,205,0,,0,0.0,0.0,0.0,0.0,0.0
2024,7,28,7,2024-07-28,AS,3713,IAD,DTW,"Washington, DC",District of Columbia,"Detroit, MI",Michigan,2054,712,-3,-10,2051,702,7,3,2058,699,2096,258,278,268,1,,0,0.0,0.0,0.0,0.0,0.0
2024,3,15,5,2024-03-15,B6,6472,BOS,DFW,"Boston, MA",Massachusetts,"Dallas/Fort Worth, TX",Texas,1297,1772,-6,-10,1291,1762,5,11,1296,1751,1246,162,182,178,0,,0,0.0,0.0,0.0,0.0,0.0
2024,10,3,4,2024-10-03,G4,8651,PDX,DFW,"Portland, OR",Oregon,"Dallas/Fort Worth, TX",Texas,1532,1159,-9,0,1523,1159,5,16,1528,1143,2330,296,316,317,0,,0,0.0,0.0,0.0,0.0,0.0
2024,5,12,7,2024-05-12,9E,8319,SEA,LAS,"Seattle, WA",Washington,"Las Vegas, NV",Nevada,582,1681,-11,-15,571,1666,8,5,579,1661,1864,232,252,245,0,,0,0.0,0.0,0.0,0.0,0.0
2024,12,8,7,2024-12-08,WN,3937,MDW,STL,"Chicago, IL",Illinois,"St. Louis, MO",Missouri,546,796,0,0,546,796,25,19,571,777,990,120,140,164,0,,0,0.0,0.0,0.0,0.0,0.0
2024,2,28,3,2024-02-28,OO,3633,MIA,CLT,"Miami, FL",Florida,"Charlotte, NC",North Carolina,2035,2272,-13,-15,2022,2257,23,15,2045,2242,2248,281,301,319,0,,0,0.0,0.0,0.0,0.0,0.0
2024,12,10,2,2024-12-10,UA,9710,TPA,MDW,"Tampa, FL",Florida,"Chicago, IL",Illinois,929,2330,4,-5,933,2325,22,12,955,2313,2614,324,344,358,0,,0,0.0,0.0,0.0,0.0,0.0
2024,6,30,7,2024-06-30,G4,5931,DCA,STL,"Washington, DC",District of Columbia,"St. Louis, MO",Missouri,1613,2341,9,5,1622,2346,5,12,1627,2334,2252,273,293,290,0,,0,0.0,0.0,0.0,0.0,0.0
2024,12,4,3,2024-12-04,F9,6063,ATL,JFK,"Atlanta, GA",Georgia,"New York, NY",New York,1012,1641,-6,-5,1006,1636,23,7,1029,1629,2316,282,302,312,0,,0,0.0,0.0,0.0,0.0,0.0
2024,11,16,6,2024-11-16,AS,1394,MSP,BOS,"Minneapolis, MN",Minnesota,"Boston, MA",Massachusetts,2197,1379,-4,-10,2193,1369,5,17,2198,1352,794,103,123,125,0,,0,0.0,0.0,0.0,0.0,0.0
2024,3,4,1,2024-03-04,AA,6070,PDX,IAH,"Portland, OR",Oregon,"Houston, TX",Texas,2188,814,-6,0,2182,814,14,12,2196,802,2035,256,276,282,0,,0,0.0,0.0,0.0,0.0,0.0
2024,11,22,5,2024-11-22,OH,7650,PDX,DTW,"Portland, OR",Oregon,"Detroit, MI",Michigan,1937,2341,-5,5,1932,2346,26,7,1958,2339,1108,138,158,171,0,,0,0.0,0.0,0.0,0.0,0.0
2024,9,16,1,2024-09-16,9E,2175,EWR,DFW,"Newark, NJ",New Jersey,"Dallas/Fort Worth, TX",Texas,1012,1235,-2,-10,1010,1225,17,3,1027,1222,2835,349,369,369,0,,0,0.0,0.0,0.0,0.0,0.0
2024,7,11,4,2024-07-11,MQ,7466,STL,DEN,"St. Louis, MO",Missouri,"Denver, CO",Colorado,1157,1639,-9,-10,1148,1629,23,15,1171,1614,2754,347,367,385,0,,0,0.0,0.0,0.0,0.0,0.0
2024,5,22,3,2024-05-22,YX,5307,PHX,PDX,"Phoenix, AZ",Arizona,"Portland, OR",Oregon,1172,1276,-4,0,1168,1276,24,6,1192,1270,1461,186,206,216,0,,0,0.0,0.0,0.0,0.0,0.0
2024,4,13,6,2024-04-13,OO,5917,DCA,IAH,"Washington, DC",District of Columbia,"Houston, TX",Texas,1146,1259,11,20,1157,1279,12,10,1169,1269,484,62,82,84,0,,0,6.0,3.0,2.0,0.0,9.0
2024,8,1,4,2024-08-01,AA,1878,PDX,EWR,"Portland, OR",Oregon,"Newark, NJ",New Jersey,1297,2022,-6,-10,1291,2012,9,5,1300,2007,1458,174,194,188,0,,0,0.0,0.0,0.0,0.0,0.0
2024,8,29,4,2024-08-29,YX,473,PHX,ATL,"Phoenix, AZ",Arizona,"Atlanta, GA",Georgia,576,832,14,5,590,837,15,5,605,832,2622,332,352,352,0,,0,0.0,0.0,0.0,0.0,0.0
2024,7,27,6,2024-07-27,AS,7657,CLT,STL,"Charlotte, NC",North Carolina,"St. Louis, MO",Missouri,580,624,17,15,597,639,25,18,622,621,2632,326,346,369,0,,0,0.0,0.0,0.0,0.0,0.0
2024,4,2,2,2024-04-02,MQ,9423,TPA,JFK,"Tampa, FL",Florida,"New York, NY",New York,1053,2024,-4,0,1049,2024,12,14,1061,2010,1794,218,238,244,0,,0,0.0,0.0,0.0,0.0,0.0
2024,5,21,2,2024-05-21,UA,1673,STL,MIA,"St. Louis, MO",Missouri,"Miami, FL",Florida,1135,1988,-2,-5,1133,1983,18,15,1151,1968,1448,175,195,208,0,,0,0.0,0.0,0.0,0.0,0.0
2024,4,21,7,2024-04-21,UA,6126,ORD,SLC,"Chicago, IL",Illinois,"Salt Lake City, UT",Utah,1241,1537,14,5,1255,1542,16,11,1271,1531,648,89,109,116,0,,0,0.0,0.0,0.0,0.0,0.0
2024,2,28,3,2024-02-28,AS,4544,STL,PHX,"St. Louis, MO",Missouri,"Phoenix, AZ",Arizona,1725,1918,-15,-20,1710,1898,15,18,1725,1880,1425,187,207,220,0,,0,0.0,0.0,0.0,0.0,0.0
2024,2,12,1,2024-02-12,MQ,887,MDW,MSP,"Chicago, IL",Illinois,"Minneapolis, MN",Minnesota,1345,1618,-7,-5,1338,1613,17,3,1355,1610,409,43,63,63,0,,0,0.0,0.0,0.0,0.0,0.0
2024,7,25,4,2024-07-25,UA,1645,DFW,SLC,"Dallas/Fort Worth, TX",Texas,"Salt Lake City, UT",Utah,1970,2060,-2,-10,1968,2050,14,18,1982,2032,2940,368,388,400,0,,0,0.0,0.0,0.0,0.0,0.0
2024,9,24,2,2024-09-24,MQ,8661,PHX,HNL,"Phoenix, AZ",Arizona,"Honolulu, HI",Hawaii,606,670,-16,-10,590,660,24,11,614,649,521,73,93,108,0,,0,0.0,0.0,0.0,0.0,0.0
2024,10,22,2,2024-10-22,OO,4474,MSP,BWI,"Minneapolis, MN",Minnesota,"Baltimore, MD",Maryland,1464,2335,-11,-10,1453,2325,12,15,1465,2310,2462,298,318,325,0,,0,0.0,0.0,0.0,0.0,0.0
2024,4,27,6,2024-04-27,9E,5547,PHX,TPA,"Phoenix, AZ",Arizona,"Tampa, FL",Florida,1815,2182,2,5,1817,2187,14,6,1831,2181,1482,180,200,200,0,,0,0.0,0.0,0.0,0.0,0.0
2024,1,20,6,2024-01-20,AS,9994,IAD,DCA,"Washington, DC",District of Columbia,"Washington, DC",District of Columbia,1185,624,23,20,1208,644,25,8,1233,636,2624,329,349,362,0,,0,6.0,5.0,2.0,0.0,7.0
2024,8,9,5,2024-08-09,B6,9949,EWR,STL,"Newark, NJ",New Jersey,"St. Louis, MO",Missouri,1440,2348,-5,-5,1435,2343,10,10,1445,2333,1440,184,204,204,0,,0,0.0,0.0,0.0,0.0,0.0
2024,6,14,5,2024-06-14,WN,4155,DEN,JFK,"Denver, CO",Colorado,"New York, NY",New York,811,1997,-30,-20,781,1977,5,9,786,1968,724,89,109,103,0,,0,0.0,0.0,0.0,0.0,0.0
2024,5,10,5,2024-05-10,F9,706,BOS,LGA,"Boston, MA",Massachusetts,"New York, NY",New York,1098,2168,4,5,1102,2173,13,10,1115,2163,721,85,105,108,0,,0,0.0,0.0,0.0,0.0,0.0
2024,6,4,2,2024-06-04,DL,2676,PHX,SEA,"Phoenix, AZ",Arizona,"Seattle, WA",Washington,2040,1057,-9,0,2031,1057,8,13,2039,1044,1613,202,222,223,0,,0,0.0,0.0,0.0,0.0,0.0
2024,7,2,2,2024-07-02,HA,6669,ATL,BOS,"Atlanta, GA",Georgia,"Boston, MA",Massachusetts,1183,1837,1,5,1184,1842,5,5,1189,1837,1676,212,232,222,0,,0,0.0,0.0,0.0,0.0,0.0
2024,3,30,6,2024-03-30,YX,4224,MCO,EWR,"Orlando, FL",Florida,"Newark, NJ",New Jersey,1132,810,6,0,1138,810,27,6,1165,804,1657,202,222,235,0,,0,0.0,0.0,0.0,0.0,0.0
2024,4,3,3,2024-04-03,OH,5151,SEA,SAN,"Seattle, WA",Washington,"San Diego, CA",California,1167,1140,9,15,1176,1155,14,3,1190,1152,2670,327,347,344,0,,0,0.0,0.0,0.0,0.0,0.0
2024,1,13,6,2024-01-13,OO,422,MDW,BWI,"Chicago, IL",Illinois,"Baltimore, MD",Maryland,1098,1370,-16,-15,1082,1355,24,7,1106,1348,1138,135,155,166,0,,0,0.0,0.0,0.0,0.0,0.0
2024,11,17,7,2024-11-17,NK,683,DCA,MDW,"Washington, DC",District of Columbia,"Chicago, IL",Illinois,1949,1662,-16,-10,1933,1652,25,4,1958,1648,540,74,94,103,0,,0,0.0,0.0,0.0,0.0,0.0
2024,10,19,6,2024-10-19,WN,5489,MIA,SAN,"Miami, FL",Florida,"San Diego, CA",California,2133,1883,-11,-5,2122,1878,11,16,2133,1862,578,75,95,102,0,,0,0.0,0.0,0.0,0.0,0.0
2024,8,17,6,2024-08-17,DL,8947,EWR,LAS,"Newark, NJ",New Jersey,"Las Vegas, NV",Nevada,914,1276,-2,0,912,1276,27,15,939,1261,2031,244,264,286,0,,0,0.0,0.0,0.0,0.0,0.0
2024,11,17,7,2024-11-17,HA,4981,ATL,JFK,"Atlanta, GA",Georgia,"New York, NY",New York,1658,694,15,15,1673,709,29,19,1702,690,1448,190,210,238,0,,0,0.0,0.0,0.0,0.0,0.0
2024,10,18,5,2024-10-18,NK,8514,LGA,LAX,"New York, NY",New York,"Los Angeles, CA",California,2042,2013,19,15,2061,2028,29,15,2090,2013,516,54,74,98,0,,0,0.0,0.0,0.0,0.0,0.0
2024,1,26,5,2024-01-26,MQ,2222,PDX,SLC,"Portland, OR",Oregon,"Salt Lake City, UT",Utah,1271,819,4,10,1275,829,11,10,1286,819,726,89,109,110,0,,0,0.0,0.0,0.0,0.0,0.0
2024,3,15,5,2024-03-15,AA,7799,PHL,SFO,"Philadelphia, PA",Pennsylvania,"San Francisco, CA",California,1887,1505,-4,-10,1883,1495,29,13,1912,1482,1105,128,148,170,0,,0,0.0,0.0,0.0,0.0,0.0
2024,12,29,7,2024-12-29,WN,7896,DEN,PDX,"Denver, CO",Colorado,"Portland, OR",Oregon,883,1891,13,5,896,1896,9,11,905,1885,712,88,108,108,0,,0,0.0,0.0,0.0,0.0,0.0
2024,10,25,5,2024-10-25,G4,2320,LAX,MDW,"Los Angeles, CA",California,"Chicago, IL",Illinois,1555,2117,-2,-5,1553,2112,6,15,1559,2097,2577,316,336,337,0,,0,0.0,0.0,0.0,0.0,0.0
2024,5,29,3,2024-05-29,OH,5223,DCA,TPA,"Washington, DC",District of Columbia,"Tampa, FL",Florida,1039,2253,6,15,1045,2268,13,15,1058,2253,2227,278,298,306,0,,0,0.0,0.0,0.0,0.0,0.0
2024,5,27,1,2024-05-27,WN,3650,MDW,EWR,"Chicago, IL",Illinois,"Newark, NJ",New Jersey,2295,1689,-7,-10,2288,1679,10,9,2298,1670,227,24,44,43,0,,0,0.0,0.0,0.0,0.0,0.0
2024,1,8,1,2024-01-08,YX,5879,DTW,MDW,"Detroit, MI",Michigan,"Chicago, IL",Illinois,986,2010,-6,-15,980,1995,26,13,1006,1982,1260,158,178,197,0,,0,0.0,0.0,0.0,0.0,0.0
2024,1,29,1,2024-01-29,MQ,5028,LAX,HNL,"Los Angeles, CA",California,"Honolulu, HI",Hawaii,2279,792,3,10,2282,802,13,19,2295,783,2082,256,276,288,0,,0,0.0,0.0,0.0,0.0,0.0
2024,10,22,2,2024-10-22,UA,266,LGA,SEA,"New York, NY",New York,"Seattle, WA",Washington,1888,1943,-3,5,1885,1948,19,12,1904,1936,1789,221,241,252,0,,0,0.0,0.0,0.0,0.0,0.0
2024,7,27,6,2024-07-27,9E,6543,DFW,BOS,"Dallas/Fort Worth, TX",Texas,"Boston, MA",Massachusetts,763,2170,14,10,777,2180,17,3,794,2177,2878,353,373,373,0,,0,0.0,0.0,0.0,0.0,0.0
2024,5,7,2,2024-05-07,9E,8409,MIA,SAN,"Miami, FL",Florida,"San Diego, CA",California,1665,774,-5,-10,1660,764,19,10,1679,754,594,64,84,93,0,,0,0.0,0.0,0.0,0.0,0.0
2024,12,5,4,2024-12-05,DL,6755,ORD,CLT,"Chicago, IL",Illinois,"Charlotte, NC",North Carolina,529,711,9,10,538,721,5,17,543,704,924,118,138,140,0,,0,0.0,0.0,0.0,0.0,0.0
2024,4,25,4,2024-04-25,OH,7442,SLC,DEN,"Salt Lake City, UT",Utah,"Denver, CO",Colorado,1398,1931,12,5,1410,1936,19,7,1429,1929,492,69,89,95,0,,0,0.0,0.0,0.0,0.0,0.0
2024,5,23,4,2024-05-23,HA,2306,SFO,DCA,"San Francisco, CA",California,"Washington, DC",District of Columbia,629,1963,13,5,642,1968,22,6,664,1962,2669,325,345,353,0,,0,0.0,0.0,0.0,0.0,0.0
2024,11,13,3,2024-11-13,UA,1350,PHX,BWI,"Phoenix, AZ",Arizona,"Baltimore, MD",Maryland,1593,1703,-9,0,1584,1703,15,15,1599,1688,1472,178,198,208,0,,0,0.0,0.0,0.0,0.0,0.0
2024,8,22,4,2024-08-22,AA,4106,LGA,ATL,"New York, NY",New York,"Atlanta, GA",Georgia,618,2101,4,5,622,2106,7,18,629,2088,1169,136,156,161,0,,0,0.0,0.0,0.0,0.0,0.0
2024,1,7,7,2024-01-07,9E,4658,ATL,HNL,"Atlanta, GA",Georgia,"Honolulu, HI",Hawaii,826,710,-14,-5,812,705,5,10,817,695,2174,270,290,285,0,,0,0.0,0.0,0.0,0.0,0.0
2024,2,14,3,2024-02-14,F9,9963,LAS,SFO,"Las Vegas, NV",Nevada,"San Francisco, CA",California,1593,2110,-10,-15,1583,2095,8,16,1591,2079,2803,359,379,383,0,,0,0.0,0.0,0.0,0.0,0.0
2024,8,26,1,2024-08-26,AA,2251,ORD,LAS,"Chicago, IL",Illinois,"Las Vegas, NV",Nevada,707,1052,-6,0,701,1052,6,14,707,1038,1868,239,259,259,0,,0,0.0,0.0,0.0,0.0,0.0
2024,6,3,1,2024-06-03,UA,5177,IAD,ATL,"Washington, DC",District of Columbia,"Atlanta, GA",Georgia,590,1012,-2,5,588,1017,20,9,608,1008,2502,303,323,332,0,,0,0.0,0.0,0.0,0.0,0.0
2024,6,29,6,2024-06-29,OH,2397,LGA,SAN,"New York, NY",New York,"San Diego, CA",California,619,1203,-4,-10,615,1193,23,7,638,1186,1407,181,201,211,0,,0,0.0,0.0,0.0,0.0,0.0
2024,8,2,5,2024-08-02,UA,9328,ATL,PDX,"Atlanta, GA",Georgia,"Portland, OR",Oregon,1481,1559,-8,-10,1473,1549,20,17,1493,1532,602,83,103,120,0,,0,0.0,0.0,0.0,0.0,0.0
2024,3,28,4,2024-03-28,MQ,2714,SAN,SLC,"San Diego, CA",California,"Salt Lake City, UT",Utah,706,785,6,5,712,790,16,12,728,778,1238,150,170,178,0,,0,0.0,0.0,0.0,0.0,0.0
2024,9,12,4,2024-09-12,HA,1979,MCO,JFK,"Orlando, FL",Florida,"New York, NY",New York,905,2176,-4,-10,901,2166,12,3,913,2163,2554,328,348,343,0,,0,0.0,0.0,0.0,0.0,0.0
2024,3,13,3,2024-03-13,DL,8888,PHL,PDX,"Philadelphia, PA",Pennsylvania,"Portland, OR",Oregon,1267,1710,-12,-10,1255,1700,8,8,1263,1692,1376,174,194,190,0,,0,0.0,0.0,0.0,0.0,0.0
2024,6,27,4,2024-06-27,OH,720,DTW,HNL,"Detroit, MI",Michigan,"Honolulu, HI",Hawaii,1046,1847,19,10,1065,1857,20,10,1085,1847,403,53,73,83,0,,0,0.0,0.0,0.0,0.0,0.0
2024,7,30,2,2024-07-30,B6,6798,CLT,DFW,"Charlotte, NC",North Carolina,"Dallas/Fort Worth, TX",Texas,623,650,-20,-10,603,640,13,13,616,627,1192,150,170,176,0,,0,0.0,0.0,0.0,0.0,0.0
2024,10,19,6,2024-10-19,9E,5607,TPA,DTW,"Tampa, FL",Florida,"Detroit, MI",Michigan,611,1749,-15,-5,596,1744,26,8,622,1736,266,35,55,69,0,,0,0.0,0.0,0.0,0.0,0.0
2024,8,21,3,2024-08-21,UA,8362,PHX,ORD,"Phoenix, AZ",Arizona,"Chicago, IL",Illinois,1509,1769,-14,-5,1495,1764,19,10,1514,1754,1723,219,239,248,0,,0,0.0,0.0,0.0,0.0,0.0
2024,8,26,1,2024-08-26,UA,1903,SAN,SLC,"San Diego, CA",California,"Salt Lake City, UT",Utah,1730,1664,3,0,1733,1664,16,16,1749,1648,1005,118,138,150,0,,0,0.0,0.0,0.0,0.0,0.0
2024,8,10,6,2024-08-10,F9,7216,DFW,IAH,"Dallas/Fort Worth, TX",Texas,"Houston, TX",Texas,1482,954,-11,-5,1471,949,21,11,1492,938,900,102,122,134,0,,0,0.0,0.0,0.0,0.0,0.0
2024,4,28,7,2024-04-28,WN,4633,TPA,ATL,"Tampa, FL",Florida,"Atlanta, GA",Georgia,1113,2068,5,15,1118,2083,26,15,1144,2068,780,90,110,131,0,,0,0.0,0.0,0.0,0.0,0.0
2024,11,8,5,2024-11-08,WN,9359,BWI,TPA,"Baltimore, MD",Maryland,"Tampa, FL",Florida,1444,962,-5,5,1439,967,27,16,1466,951,1269,159,179,202,0,,0,0.0,0.0,0.0,0.0,0.0
2024,9,20,5,2024-09-20,UA,2025,IAD,PHL,"Washington, DC",District of Columbia,"Philadelphia, PA",Pennsylvania,1909,1135,-1,-5,1908,1130,19,5,1927,1125,302,32,52,56,0,,0,0.0,0.0,0.0,0.0,0.0
2024,7,25,4,2024-07-25,OO,1137,BOS,DCA,"Boston, MA",Massachusetts,"Washington, DC",District of Columbia,1205,1907,-15,-5,1190,1902,8,19,1198,1883,950,110,130,137,0,,0,0.0,0.0,0.0,0.0,0.0
2024,4,4,4,2024-04-04,AA,3283,PHL,BOS,"Philadelphia, PA",Pennsylvania,"Boston, MA",Massachusetts,2276,635,5,0,2281,635,12,13,2293,622,823,97,117,122,0,,0,0.0,0.0,0.0,0.0,0.0
2024,8,9,5,2024-08-09,F9,9694,PDX,DEN,"Portland, OR",Oregon,"Denver, CO",Colorado,646,876,-21,-20,625,856,7,15,632,841,1118,144,164,166,0,,0,0.0,0.0,0.0,0.0,0.0
2024,10,2,3,2024-10-02,HA,9730,SLC,PHX,"Salt Lake City, UT",Utah,"Phoenix, AZ",Arizona,631,2319,9,15,640,2334,11,12,651,2322,1626,204,224,227,0,,0,0.0,0.0,0.0,0.0,0.0
2024,8,18,7,2024-08-18,AA,8776,SAN,PHL,"San Diego, CA",California,"Philadelphia, PA",Pennsylvania,1231,1948,-19,-10,1212,1938,11,7,1223,1931,1692,213,233,231,0,,0,0.0,0.0,0.0,0.0,0.0
2024,11,4,1,2024-11-04,NK,4364,BWI,EWR,"Baltimore, MD",Maryland,"Newark, NJ",New Jersey,1349,2289,8,5,1357,2294,19,9,1376,2285,1545,191,211,219,0,,0,0.0,0.0,0.0,0.0,0.0
2024,4,28,7,2024-04-28,B6,4998,PHX,HNL,"Phoenix, AZ",Arizona,"Honolulu, HI",Hawaii,603,1609,5,5,608,1614,24,12,632,1602,1340,160,180,196,0,,0,0.0,0.0,0.0,0.0,0.0
2024,9,24,2,2024-09-24,WN,8537,DFW,PDX,"Dallas/Fort Worth, TX",Texas,"Portland, OR",Oregon,1052,781,18,10,1070,791,21,8,1091,783,1020,121,141,150,0,,0,0.0,0.0,0.0,0.0,0.0
2024,9,29,7,2024-09-29,WN,6221,CLT,IAD,"Charlotte, NC",North Carolina,"Washington, DC",District of Columbia,1067,1070,-2,-10,1065,1060,14,8,1079,1052,2896,362,382,384,0,,0,0.0,0.0,0.0,0.0,0.0
2024,3,4,1,2024-03-04,F9,5889,SEA,SFO,"Seattle, WA",Washington,"San Francisco, CA",California,1261,1016,8,0,1269,1016,20,15,1289,1001,2918,358,378,393,0,,0,0.0,0.0,0.0,0.0,0.0
2024,10,24,4,2024-10-24,OO,3471,ATL,PHL,"Atlanta, GA",Georgia,"Philadelphia, PA",Pennsylvania,1765,2289,-23,-15,1742,2274,20,19,1762,2255,2599,325,345,364,0,,0,0.0,0.0,0.0,0.0,0.0
2024,12,15,7,2024-12-15,OO,1450,SLC,ATL,"Salt Lake City, UT",Utah,"Atlanta, GA",Georgia,1426,1488,10,10,1436,1498,26,9,1462,1489,1599,193,213,228,0,,0,0.0,0.0,0.0,0.0,0.0
2024,1,11,4,2024-01-11,MQ,8821,HNL,ORD,"Honolulu, HI",Hawaii,"Chicago, IL",Illinois,2162,1773,9,0,2171,1773,19,5,2190,1768,785,101,121,125,0,,0,0.0,0.0,0.0,0.0,0.0
2024,4,7,7,2024-04-07,OH,5814,STL,PHX,"St. Louis, MO",Missouri,"Phoenix, AZ",Arizona,1161,1003,-5,-10,1156,993,16,9,1172,984,608,67,87,92,0,,0,0.0,0.0,0.0,0.0,0.0
2024,3,11,1,2024-03-11,AS,3914,MSP,HNL,"Minneapolis, MN",Minnesota,"Honolulu, HI",Hawaii,1854,1113,11,5,1865,1118,11,9,1876,1109,2120,259,279,279,0,,0,0.0,0.0,0.0,0.0,0.0
2024,12,29,7,2024-12-29,OH,7247,DTW,TPA,"Detroit, MI",Michigan,"Tampa, FL",Florida,1443,1165,4,-5,1447,1160,7,4,1454,1156,2973,375,395,386,0,,0,0.0,0.0,0.0,0.0,0.0
2024,2,27,2,2024-02-27,YX,6585,CLT,HNL,"Charlotte, NC",North Carolina,"Honolulu, HI",Hawaii,1347,1040,-22,-15,1325,1025,25,7,1350,1018,1100,129,149,161,0,,0,0.0,0.0,0.0,0.0,0.0
2024,10,16,3,2024-10-16,AA,9994,SEA,MIA,"Seattle, WA",Washington,"Miami, FL",Florida,1395,1869,4,0,1399,1869,28,15,1427,1854,360,54,74,97,0,,0,0.0,0.0,0.0,0.0,0.0
2024,9,7,6,2024-09-07,OH,3725,LGA,JFK,"New York, NY",New York,"New York, NY",New York,1672,1591,-10,-10,1662,1581,27,8,1689,1573,1148,146,166,181,0,,0,0.0,0.0,0.0,0.0,0.0
2024,10,2,3,2024-10-02,9E,9051,PDX,EWR,"Portland, OR",Oregon,"Newark, NJ",New Jersey,668,1669,25,20,693,1689,6,6,699,1683,1924,247,267,259,0,,0,5.0,2.0,2.0,0.0,11.0
2024,2,19,1,2024-02-19,F9,8217,IAH,SLC,"Houston, TX",Texas,"Salt Lake City, UT",Utah,1056,674,4,-5,1060,669,8,3,1068,666,2154,265,285,276,0,,0,0.0,0.0,0.0,0.0,0.0
2024,12,23,1,2024-12-23,MQ,9695,DCA,SEA,"Washington, DC",District of Columbia,"Seattle, WA",Washington,1484,1772,-7,0,1477,1772,27,13,1504,1759,1130,132,152,172,0,,0,0.0,0.0,0.0,0.0,0.0
2024,8,3,6,2024-08-03,OH,9089,IAH,PHL,"Houston, TX",Texas,"Philadelphia, PA",Pennsylvania,1607,1005,9,15,1616,1020,29,3,1645,1017,794,102,122,134,0,,0,0.0,0.0,0.0,0.0,0.0
2024,2,21,3,2024-02-21,DL,631,CLT,LAS,"Charlotte, NC",North Carolina,"Las Vegas, NV",Nevada,1019,602,3,-5,1022,597,27,11,1049,586,338,42,62,80,0,,0,0.0,0.0,0.0,0.0,0.0
2024,9,27,5,2024-09-27,AS,4237,CLT,PHL,"Charlotte, NC",North Carolina,"Philadelphia, PA",Pennsylvania,606,1632,0,-5,606,1627,12,16,618,1611,2481,311,331,339,0,,0,0.0,0.0,0.0,0.0,0.0
2024,3,24,7,2024-03-24,G4,698,JFK,LAS,"New York, NY",New York,"Las Vegas, NV",Nevada,1384,1113,-2,-10,1382,1103,14,9,1396,1094,739,83,103,106,0,,0,0.0,0.0,0.0,0.0,0.0
2024,10,19,6,2024-10-19,AA,7528,CLT,PDX,"Charlotte, NC",North Carolina,"Portland, OR",Oregon,1788,1861,20,15,1808,1876,16,4,1824,1872,2385,301,321,321,0,,0,0.0,0.0,0.0,0.0,0.0
2024,5,5,7,2024-05-05,AS,8597,LAS,MDW,"Las Vegas, NV",Nevada,"Chicago, IL",Illinois,1157,1139,0,10,1157,1149,16,19,1173,1130,1002,119,139,154,0,,0,0.0,0.0,0.0,0.0,0.0
2024,10,22,2,2024-10-22,F9,5004,HNL,LAS,"Honolulu, HI",Hawaii,"Las Vegas, NV",Nevada,530,889,-18,-10,512,879,13,9,525,870,332,36,56,58,0,,0,0.0,0.0,0.0,0.0,0.0
2024,3,12,2,2024-03-12,9E,3009,DEN,ORD,"Denver, CO",Colorado,"Chicago, IL",Illinois,2279,780,-14,-5,2265,775,15,9,2280,766,2917,355,375,379,0,,0,0.0,0.0,0.0,0.0,0.0
2024,10,22,2,2024-10-22,MQ,778,ATL,SEA,"Atlanta, GA",Georgia,"Seattle, WA",Washington,2070,1938,14,15,2084,1953,17,3,2101,1950,2585,326,346,346,0,,0,0.0,0.0,0.0,0.0,0.0
2024,8,23,5,2024-08-23,DL,3484,MIA,ATL,"Miami, FL",Florida,"Atlanta, GA",Georgia,746,865,-5,0,741,865,5,10,746,855,1716,218,238,233,0,,0,0.0,0.0,0.0,0.0,0.0
2024,2,25,7,2024-02-25,B6,9022,LGA,SLC,"New York, NY",New York,"Salt Lake City, UT",Utah,1425,682,-3,0,1422,682,7,16,1429,666,2056,255,275,278,0,,0,0.0,0.0,0.0,0.0,0.0
2024,12,25,3,2024-12-25,AS,2125,LAX,HNL,"Los Angeles, CA",California,"Honolulu, HI",Hawaii,2053,857,-5,0,2048,857,26,15,2074,842,1931,248,268,289,0,,0,0.0,0.0,0.0,0.0,0.0
2024,4,19,5,2024-04-19,B6,4328,HNL,EWR,"Honolulu, HI",Hawaii,"Newark, NJ",New Jersey,523,2183,14,5,537,2188,28,12,565,2176,2437,310,330,350,0,,0,0.0,0.0,0.0,0.0,0.0
2024,7,10,3,2024-07-10,UA,2866,SAN,SEA,"San Diego, CA",California,"Seattle, WA",Washington,997,2269,23,15,1020,2284,15,14,1035,2270,1585,207,227,236,0,,0,0.0,0.0,0.0,0.0,0.0
2024,4,2,2,2024-04-02,WN,2198,IAH,SFO,"Houston, TX",Texas,"San Francisco, CA",California,1353,1549,15,10,1368,1559,19,15,1387,1544,823,93,113,127,0,,0,0.0,0.0,0.0,0.0,0.0
2024,12,15,7,2024-12-15,NK,6861,ORD,IAH,"Chicago, IL",Illinois,"Houston, TX",Texas,803,798,8,15,811,813,11,18,822,795,693,79,99,108,0,,0,0.0,0.0,0.0,0.0,0.0
2024,2,25,7,2024-02-25,WN,491,ORD,EWR,"Chicago, IL",Illinois,"Newark, NJ",New Jersey,1921,1915,15,10,1936,1925,20,15,1956,1910,473,64,84,99,0,,1,0.0,0.0,0.0,0.0,0.0
2024,2,29,4,2024-02-29,G4,3884,IAD,DTW,"Washington, DC",District of Columbia,"Detroit, MI",Michigan,1926,1247,-22,-20,1904,1227,10,17,1914,1210,1829,219,239,246,0,,0,0.0,0.0,0.0,0.0,0.0
2024,5,17,5,2024-05-17,OO,6766,SFO,PDX,"San Francisco, CA",California,"Portland, OR",Oregon,815,1706,-17,-15,798,1691,24,6,822,1685,720,92,112,122,0,,0,0.0,0.0,0.0,0.0,0.0
2024,2,8,4,2024-02-08,YX,3937,MCO,IAH,"Orlando, FL",Florida,"Houston, TX",Texas,777,865,7,10,784,875,28,7,812,868,1915,242,262,277,0,,0,0.0,0.0,0.0,0.0,0.0
2024,1,28,7,2024-01-28,OH,1785,CLT,DFW,"Charlotte, NC",North Carolina,"Dallas/Fort Worth, TX",Texas,1041,2040,-26,-20,1015,2020,14,16,1029,2004,2604,334,354,364,0,,0,0.0,0.0,0.0,0.0,0.0
2024,2,18,7,2024-02-18,MQ,6597,EWR,LAS,"Newark, NJ",New Jersey,"Las Vegas, NV",Nevada,1666,1596,11,5,1677,1601,8,7,1685,1594,2921,355,375,370,0,,0,0.0,0.0,0.0,0.0,0.0
2024,5,4,6,2024-05-04,MQ,3014,STL,LGA,"St. Louis, MO",Missouri,"New York, NY",New York,1288,1469,15,10,1303,1479,10,9,1313,1470,637,82,102,101,0,,0,0.0,0.0,0.0,0.0,0.0
2024,1,13,6,2024-01-13,9E,7216,ATL,PHL,"Atlanta, GA",Georgia,"Philadelphia, PA",Pennsylvania,1933,1330,2,-5,1935,1325,16,16,1951,1309,1234,153,173,185,0,,0,0.0,0.0,0.0,0.0,0.0
2024,2,5,1,2024-02-05,DL,9710,SFO,IAH,"San Francisco, CA",California,"Houston, TX",Texas,855,1460,-10,-5,845,1455,7,4,852,1451,2494,310,330,321,0,,0,0.0,0.0,0.0,0.0,0.0
2024,4,10,3,2024-04-10,B6,3826,ORD,BOS,"Chicago, IL",Illinois,"Boston, MA",Massachusetts,2047,618,-11,-10,2036,608,16,4,2052,604,1673,206,226,226,0,,0,0.0,0.0,0.0,0.0,0.0
2024,10,8,2,2024-10-08,F9,5051,DEN,BOS,"Denver, CO",Colorado,"Boston, MA",Massachusetts,1726,2153,-11,-20,1715,2133,27,3,1742,2130,486,50,70,80,0,,0,0.0,0.0,0.0,0.0,0.0
2024,3,26,2,2024-03-26,OH,6158,PDX,ORD,"Portland, OR",Oregon,"Chicago, IL",Illinois,749,970,10,5,759,975,20,4,779,971,1139,149,169,173,0,,0,0.0,0.0,0.0,0.0,0.0
2024,1,4,4,2024-01-04,B6,7755,LGA,PHX,"New York, NY",New York,"Phoenix, AZ",Arizona,602,2314,-7,-15,595,2299,16,4,611,2295,255,36,56,56,0,,0,0.0,0.0,0.0,0.0,0.0
2024,8,10,6,2024-08-10,9E,4710,ATL,DTW,"Atlanta, GA",Georgia,"Detroit, MI",Michigan,1991,1646,12,15,2003,1661,19,15,2022,1646,544,77,97,111,0,,0,0.0,0.0,0.0,0.0,0.0
2024,12,3,2,2024-12-03,YX,7921,DEN,TPA,"Denver, CO",Colorado,"Tampa, FL",Florida,534,2008,-3,-10,531,1998,26,7,557,1991,346,35,55,68,0,,0,0.0,0.0,0.0,0.0,0.0
2024,6,14,5,2024-06-14,F9,1184,MIA,MCO,"Miami, FL",Florida,"Orlando, FL",Florida,1847,1218,-1,5,1846,1223,27,17,1873,1206,2535,319,339,363,0,,0,0.0,0.0,0.0,0.0,0.0
2024,12,9,1,2024-12-09,F9,7683,EWR,TPA,"Newark, NJ",New Jersey,"Tampa, FL",Florida,1031,1242,-13,-15,1018,1227,25,17,1043,1210,619,69,89,111,0,,0,0.0,0.0,0.0,0.0,0.0
2024,10,4,5,2024-10-04,G4,9299,TPA,MDW,"Tampa, FL",Florida,"Chicago, IL",Illinois,1058,2145,4,0,1062,2145,25,9,1087,2136,782,95,115,129,0,,0,0.0,0.0,0.0,0.0,0.0
2024,5,9,4,2024-05-09,9E,1417,JFK,SLC,"New York, NY",New York,"Salt Lake City, UT",Utah,2119,978,-10,-5,2109,973,22,15,2131,958,2932,364,384,401,0,,0,0.0,0.0,0.0,0.0,0.0
2024,1,31,3,2024-01-31,AS,6980,CLT,MSP,"Charlotte, NC",North Carolina,"Minneapolis, MN",Minnesota,1791,2334,-29,-20,1762,2314,20,18,1782,2296,456,57,77,95,0,,0,0.0,0.0,0.0,0.0,0.0
2024,1,11,4,2024-01-11,YX,2449,LAX,BWI,"Los Angeles, CA",California,"Baltimore, MD",Maryland,1576,1416,9,5,1585,1421,10,15,1595,1406,320,36,56,61,0,,0,0.0,0.0,0.0,0.0,0.0
2024,10,28,1,2024-10-28,WN,7437,ATL,MSP,"Atlanta, GA",Georgia,"Minneapolis, MN",Minnesota,1284,1423,15,15,1299,1438,21,5,1320,1433,2437,307,327,333,0,,0,0.0,0.0,0.0,0.0,0.0
2024,4,5,5,2024-04-05,YX,2793,SFO,DCA,"San Francisco, CA",California,"Washington, DC",District of Columbia,517,689,-26,-20,491,669,27,3,518,666,1043,133,153,163,0,,0,0.0,0.0,0.0,0.0,0.0
2024,7,8,1,2024-07-08,OO,7308,MSP,SEA,"Minneapolis, MN",Minnesota,"Seattle, WA",Washington,1627,743,-11,-10,1616,733,7,7,1623,726,218,27,47,41,0,,0,0.0,0.0,0.0,0.0,0.0
2024,7,10,3,2024-07-10,UA,6981,IAD,MCO,"Washington, DC",District of Columbia,"Orlando, FL",Florida,651,1220,14,5,665,1225,22,11,687,1214,2646,323,343,356,0,,0,0.0,0.0,0.0,0.0,0.0
2024,9,22,7,2024-09-22,HA,3822,SAN,MSP,"San Diego, CA",California,"Minneapolis, MN",Minnesota,2200,1463,19,10,2219,1473,15,5,2234,1468,2194,270,290,290,0,,0,0.0,0.0,0.0,0.0,0.0
2024,5,7,2,2024-05-07,YX,3793,JFK,PHX,"New York, NY",New York,"Phoenix, AZ",Arizona,1515,803,-3,-10,1512,793,27,4,1539,789,1944,240,260,271,0,,0,0.0,0.0,0.0,0.0,0.0
2024,8,25,7,2024-08-25,OH,4492,TPA,BWI,"Tampa, FL",Florida,"Baltimore, MD",Maryland,1372,2179,-14,-15,1358,2164,29,7,1387,2157,2158,278,298,314,0,,0,0.0,0.0,0.0,0.0,0.0
2024,12,20,5,2024-12-20,B6,7324,DFW,STL,"Dallas/Fort Worth, TX",Texas,"St. Louis, MO",Missouri,1937,2143,-14,-20,1923,2123,21,16,1944,2107,852,111,131,148,0,,0,0.0,0.0,0.0,0.0,0.0
2024,4,21,7,2024-04-21,AS,7902,DFW,PDX,"Dallas/Fort Worth, TX",Texas,"Portland, OR",Oregon,1607,2015,-4,-10,1603,2005,10,3,1613,2002,695,83,103,96,0,,0,0.0,0.0,0.0,0.0,0.0
2024,11,11,1,2024-11-11,UA,5817,DEN,MSP,"Denver, CO",Colorado,"Minneapolis, MN",Minnesota,1831,1924,-22,-15,1809,1909,28,19,1837,1890,788,101,121,148,0,,0,0.0,0.0,0.0,0.0,0.0
2024,12,8,7,2024-12-08,DL,3234,LAS,SFO,"Las Vegas, NV",Nevada,"San Francisco, CA",California,1674,2128,3,-5,1677,2123,22,15,1699,2108,527,68,88,105,0,,0,0.0,0.0,0.0,0.0,0.0
2024,5,24,5,2024-05-24,NK,2698,EWR,SLC,"Newark, NJ",New Jersey,"Salt Lake City, UT",Utah,1048,1464,2,-5,1050,1459,9,14,1059,1445,224,30,50,53,0,,0,0.0,0.0,0.0,0.0,0.0
2024,3,5,2,2024-03-05,OO,4152,MCO,IAD,"Orlando, FL",Florida,"Washington, DC",District of Columbia,878,752,9,0,887,752,20,14,907,738,880,101,121,135,0,,0,0.0,0.0,0.0,0.0,0.0
2024,9,3,2,2024-09-03,B6,3924,DFW,MIA,"Dallas/Fort Worth, TX",Texas,"Miami, FL",Florida,957,1128,-16,-15,941,1113,24,10,965,1103,1493,179,199,213,0,,0,0.0,0.0,0.0,0.0,0.0
2024,8,10,6,2024-08-10,G4,3620,DTW,SFO,"Detroit, MI",Michigan,"San Francisco, CA",California,852,938,3,0,855,938,14,13,869,925,2802,343,363,370,0,,0,0.0,0.0,0.0,0.0,0.0
2024,11,8,5,2024-11-08,HA,1349,BOS,HNL,"Boston, MA",Massachusetts,"Honolulu, HI",Hawaii,2187,1348,-11,-20,2176,1328,20,4,2196,1324,2203,274,294,298,0,,0,0.0,0.0,0.0,0.0,0.0
2024,4,15,1,2024-04-15,UA,6686,TPA,DFW,"Tampa, FL",Florida,"Dallas/Fort Worth, TX",Texas,875,2135,-8,-10,867,2125,7,7,874,2118,2715,332,352,346,0,,0,0.0,0.0,0.0,0.0,0.0
2024,6,29,6,2024-06-29,OH,7943,CLT,EWR,"Charlotte, NC",North Carolina,"Newark, NJ",New Jersey,707,1958,-2,-5,705,1953,14,5,719,1948,497,68,88,87,0,,0,0.0,0.0,0.0,0.0,0.0
2024,7,2,2,2024-07-02,HA,2174,BOS,SAN,"Boston, MA",Massachusetts,"San Diego, CA",California,2085,2132,-22,-15,2063,2117,28,17,2091,2100,1122,135,155,180,0,,0,0.0,0.0,0.0,0.0,0.0
2024,8,13,2,2024-08-13,F9,2604,ATL,ORD,"Atlanta, GA",Georgia,"Chicago, IL",Illinois,2255,1679,3,10,2258,1689,22,16,2280,1673,232,29,49,67,0,,0,0.0,0.0,0.0,0.0,0.0
2024,9,21,6,2024-09-21,AS,2114,PDX,IAD,"Portland, OR",Oregon,"Washington, DC",District of Columbia,959,1155,-17,-10,942,1145,20,10,962,1135,1126,132,152,162,0,,0,0.0,0.0,0.0,0.0,0.0
2024,10,4,5,2024-10-04,WN,5044,TPA,PHL,"Tampa, FL",Florida,"Philadelphia, PA",Pennsylvania,1927,1352,5,5,1932,1357,21,8,1953,1349,2903,353,373,382,0,,0,0.0,0.0,0.0,0.0,0.0
2024,3,29,5,2024-03-29,YX,1048,SLC,MSP,"Salt Lake City, UT",Utah,"Minneapolis, MN",Minnesota,2082,1530,-10,0,2072,1530,21,11,2093,1519,846,107,127,139,0,,0,0.0,0.0,0.0,0.0,0.0
2024,6,24,1,2024-06-24,YX,206,PHL,CLT,"Philadelphia, PA",Pennsylvania,"Charlotte, NC",North Carolina,1029,1150,-5,0,1024,1150,14,5,1038,1145,2623,323,343,342,1,,0,0.0,0.0,0.0,0.0,0.0
2024,1,18,4,2024-01-18,HA,4792,CLT,MCO,"Charlotte, NC",North Carolina,"Orlando, FL",Florida,984,1753,-6,0,978,1753,9,15,987,1738,1751,209,229,233,0,,0,0.0,0.0,0.0,0.0,0.0
2024,4,15,1,2024-04-15,G4,8446,LAS,LGA,"Las Vegas, NV",Nevada,"New York, NY",New York,621,697,-26,-20,595,677,29,12,624,665,549,58,78,99,0,,0,0.0,0.0,0.0,0.0,0.0
2024,9,27,5,2024-09-27,B6,3340,LAS,ATL,"Las Vegas, NV",Nevada,"Atlanta, GA",Georgia,1293,1392,-14,-15,1279,1377,8,6,1287,1371,474,66,86,80,0,,0,0.0,0.0,0.0,0.0,0.0
2024,11,14,4,2024-11-14,HA,9087,DFW,MIA,"Dallas/Fort Worth, TX",Texas,"Miami, FL",Florida,1643,1021,-1,-5,1642,1016,19,3,1661,1013,2749,349,369,371,0,,0,0.0,0.0,0.0,0.0,0.0
2024,6,15,6,2024-06-15,9E,9862,LAS,IAH,"Las Vegas, NV",Nevada,"Houston, TX",Texas,750,679,-10,-5,740,674,20,10,760,664,1459,183,203,213,0,,0,0.0,0.0,0.0,0.0,0.0
2024,1,13,6,2024-01-13,AS,5403,MCO,MIA,"Orlando, FL",Florida,"Miami, FL",Florida,1822,887,-4,-5,1818,882,27,10,1845,872,2072,254,274,291,0,,0,0.0,0.0,0.0,0.0,0.0
2024,12,2,1,2024-12-02,OH,1734,IAH,EWR,"Houston, TX",Texas,"Newark, NJ",New Jersey,546,1446,8,5,554,1451,22,16,576,1435,1800,220,240,258,0,,0,0.0,0.0,0.0,0.0,0.0
2024,2,1,4,2024-02-01,HA,1632,DFW,SEA,"Dallas/Fort Worth, TX",Texas,"Seattle, WA",Washington,2120,768,-20,-20,2100,748,23,16,2123,732,476,67,87,106,0,,0,0.0,0.0,0.0,0.0,0.0
2024,2,9,5,2024-02-09,HA,7708,SAN,MCO,"San Diego, CA",California,"Orlando, FL",Florida,1822,1702,17,20,1839,1722,14,14,1853,1708,936,116,136,144,0,,0,1.0,2.0,2.0,0.0,15.0
2024,5,27,1,2024-05-27,MQ,1540,LAX,PHX,"Los Angeles, CA",California,"Phoenix, AZ",Arizona,1395,670,-1,-10,1394,660,15,4,1409,656,382,38,58,57,0,,0,0.0,0.0,0.0,0.0,0.0
2024,8,5,1,2024-08-05,G4,9690,EWR,PDX,"Newark, NJ",New Jersey,"Portland, OR",Oregon,2195,862,-14,-10,2181,852,13,9,2194,843,722,87,107,109,0,,0,0.0,0.0,0.0,0.0,0.0
2024,8,6,2,2024-08-06,NK,3746,EWR,DEN,"Newark, NJ",New Jersey,"Denver, CO",Colorado,2042,1311,10,15,2052,1326,9,6,2061,1320,810,95,115,110,0,,0,0.0,0.0,0.0,0.0,0.0
2024,3,22,5,2024-03-22,YX,5699,HNL,BWI,"Honolulu, HI",Hawaii,"Baltimore, MD",Maryland,744,1322,-18,-20,726,1302,10,12,736,1290,1643,198,218,220,0,,0,0.0,0.0,0.0,0.0,0.0
2024,11,28,4,2024-11-28,B6,1715,IAH,STL,"Houston, TX",Texas,"St. Louis, MO",Missouri,2250,1129,40,45,2290,1174,7,13,2297,1161,238,22,42,42,0,,0,14.0,9.0,1.0,0.0,21.0
2024,7,26,5,2024-07-26,DL,9805,JFK,EWR,"New York, NY",New York,"Newark, NJ",New Jersey,2247,1384,-11,-20,2236,1364,17,12,2253,1352,761,99,119,128,0,,0,0.0,0.0,0.0,0.0,0.0
2024,7,19,5,2024-07-19,WN,8094,HNL,IAH,"Honolulu, HI",Hawaii,"Houston, TX",Texas,1223,809,-24,-15,1199,794,10,6,1209,788,2267,285,305,301,0,,0,0.0,0.0,0.0,0.0,0.0
2024,11,27,3,2024-11-27,DL,6396,HNL,MSP,"Honolulu, HI",Hawaii,"Minneapolis, MN",Minnesota,717,716,-10,-10,707,706,15,9,722,697,1902,231,251,255,0,,0,0.0,0.0,0.0,0.0,0.0
2024,2,7,3,2024-02-07,UA,2698,LAS,ATL,"Las Vegas, NV",Nevada,"Atlanta, GA",Georgia,1262,1215,-8,-5,1254,1210,20,3,1274,1207,690,90,110,113,0,,0,0.0,0.0,0.0,0.0,0.0
2024,7,29,1,2024-07-29,9E,9136,TPA,DTW,"Tampa, FL",Florida,"Detroit, MI",Michigan,1867,1700,-7,0,1860,1700,15,16,1875,1684,1632,213,233,244,0,,0,0.0,0.0,0.0,0.0,0.0
2024,11,22,5,2024-11-22,YX,3630,CLT,MSP,"Charlotte, NC",North Carolina,"Minneapolis, MN",Minnesota,1837,914,-19,-15,1818,899,14,15,1832,884,2118,260,280,289,0,,0,0.0,0.0,0.0,0.0,0.0
2024,9,5,4,2024-09-05,UA,7690,CLT,MDW,"Charlotte, NC",North Carolina,"Chicago, IL",Illinois,2216,610,-11,-15,2205,595,20,8,2225,587,1988,251,271,279,0,,0,0.0,0.0,0.0,0.0,0.0
2024,8,14,3,2024-08-14,WN,2427,DCA,BOS,"Washington, DC",District of Columbia,"Boston, MA",Massachusetts,1103,1674,-12,-20,1091,1654,28,11,1119,1643,1935,242,262,281,0,,0,0.0,0.0,0.0,0.0,0.0
2024,2,17,6,2024-02-17,AS,6665,MIA,LGA,"Miami, FL",Florida,"New York, NY",New York,2253,1630,-11,-10,2242,1620,18,5,2260,1615,411,46,66,69,0,,0,0.0,0.0,0.0,0.0,0.0
2024,1,18,4,2024-01-18,YX,7867,SEA,TPA,"Seattle, WA",Washington,"Tampa, FL",Florida,789,1554,7,15,796,1569,20,19,816,1550,1523,186,206,225,0,,0,0.0,0.0,0.0,0.0,0.0
2024,10,21,1,2024-10-21,UA,2076,HNL,PHX,"Honolulu, HI",Hawaii,"Phoenix, AZ",Arizona,1101,2172,-6,-5,1095,2167,21,18,1116,2149,2843,346,366,385,0,,0,0.0,0.0,0.0,0.0,0.0
2024,7,14,7,2024-07-14,9E,1935,EWR,ORD,"Newark, NJ",New Jersey,"Chicago, IL",Illinois,1495,860,13,5,1508,865,28,6,1536,859,1472,186,206,220,0,,0,0.0,0.0,0.0,0.0,0.0
2024,7,5,5,2024-07-05,OH,4999,IAH,LAX,"Houston, TX",Texas,"Los Angeles, CA",California,1720,2197,-18,-10,1702,2187,12,18,1714,2169,572,79,99,109,0,,0,0.0,0.0,0.0,0.0,0.0
2024,12,10,2,2024-12-10,AA,454,DTW,BWI,"Detroit, MI",Michigan,"Baltimore, MD",Maryland,1195,2135,-8,-15,1187,2120,27,14,1214,2106,660,90,110,131,0,,0,0.0,0.0,0.0,0.0,0.0
2024,8,11,7,2024-08-11,AA,9897,IAD,LAS,"Washington, DC",District of Columbia,"Las Vegas, NV",Nevada,2101,799,-6,0,2095,799,8,9,2103,790,1261,161,181,178,1,,0,0.0,0.0,0.0,0.0,0.0
2024,11,13,3,2024-11-13,G4,4573,SFO,MCO,"San Francisco, CA",California,"Orlando, FL",Florida,1939,929,0,10,1939,939,21,11,1960,928,1693,217,237,249,0,,0,0.0,0.0,0.0,0.0,0.0
2024,12,30,1,2024-12-30,G4,3295,DTW,ORD,"Detroit, MI",Michigan,"Chicago, IL",Illinois,1109,689,5,10,1114,699,14,4,1128,695,2371,299,319,317,0,,0,0.0,0.0,0.0,0.0,0.0
2024,12,2,1,2024-12-02,B6,9279,LGA,LAS,"New York, NY",New York,"Las Vegas, NV",Nevada,805,1190,-4,0,801,1190,6,10,807,1180,1521,184,204,200,0,,0,0.0,0.0,0.0,0.0,0.0
2024,8,16,5,2024-08-16,G4,8445,MSP,HNL,"Minneapolis, MN",Minnesota,"Honolulu, HI",Hawaii,2001,654,-19,-10,1982,644,16,12,1998,632,1298,152,172,180,0,,0,0.0,0.0,0.0,0.0,0.0
2024,3,17,7,2024-03-17,OO,1006,MCO,HNL,"Orlando, FL",Florida,"Honolulu, HI",Hawaii,1035,1844,-9,-15,1026,1829,23,3,1049,1826,1429,186,206,212,0,,0,0.0,0.0,0.0,0.0,0.0
2024,7,6,6,2024-07-06,NK,7298,BWI,MDW,"Baltimore, MD",Maryland,"Chicago, IL",Illinois,1743,691,-3,5,1740,696,25,10,1765,686,1879,237,257,272,0,,0,0.0,0.0,0.0,0.0,0.0
2024,12,11,3,2024-12-11,G4,1720,CLT,BOS,"Charlotte, NC",North Carolina,"Boston, MA",Massachusetts,2209,2209,-19,-10,2190,2199,23,15,2213,2184,2286,283,303,321,0,,0,0.0,0.0,0.0,0.0,0.0
2024,9,26,4,2024-09-26,YX,4518,STL,SAN,"St. Louis, MO",Missouri,"San Diego, CA",California,1256,655,17,10,1273,665,12,9,1285,656,1699,219,239,240,0,,0,0.0,0.0,0.0,0.0,0.0
2024,4,4,4,2024-04-04,NK,8623,MCO,MDW,"Orlando, FL",Florida,"Chicago, IL",Illinois,2149,1802,3,0,2152,1802,10,16,2162,1786,1327,157,177,183,0,,0,0.0,0.0,0.0,0.0,0.0
2024,11,5,2,2024-11-05,G4,4438,ATL,IAD,"Atlanta, GA",Georgia,"Washington, DC",District of Columbia,1513,660,15,10,1528,670,23,9,1551,661,1681,218,238,250,0,,0,0.0,0.0,0.0,0.0,0.0
2024,5,11,6,2024-05-11,HA,529,IAD,BOS,"Washington, DC",District of Columbia,"Boston, MA",Massachusetts,853,716,1,0,854,716,22,19,876,697,1755,221,241,262,0,,0,0.0,0.0,0.0,0.0,0.0
2024,2,8,4,2024-02-08,DL,5401,DFW,EWR,"Dallas/Fort Worth, TX",Texas,"Newark, NJ",New Jersey,1234,1189,12,5,1246,1194,18,4,1264,1190,1570,186,206,208,0,,0,0.0,0.0,0.0,0.0,0.0
2024,3,12,2,2024-03-12,OO,2523,MIA,PHL,"Miami, FL",Florida,"Philadelphia, PA",Pennsylvania,734,835,-13,-10,721,825,7,5,728,820,1053,125,145,137,0,,0,0.0,0.0,0.0,0.0,0.0
2024,10,7,1,2024-10-07,OO,8372,LAS,DEN,"Las Vegas, NV",Nevada,"Denver, CO",Colorado,805,632,-10,0,795,632,22,5,817,627,2535,315,335,342,0,,0,0.0,0.0,0.0,0.0,0.0
2024,11,28,4,2024-11-28,F9,1673,JFK,TPA,"New York, NY",New York,"Tampa, FL",Florida,1633,2190,-28,-20,1605,2170,23,14,1628,2156,2878,359,379,396,0,,0,0.0,0.0,0.0,0.0,0.0
2024,6,8,6,2024-06-08,NK,8135,EWR,SFO,"Newark, NJ",New Jersey,"San Francisco, CA",California,813,1866,-4,0,809,1866,29,6,838,1860,376,43,63,78,0,,0,0.0,0.0,0.0,0.0,0.0
2024,7,5,5,2024-07-05,AS,519,DCA,HNL,"Washington, DC",District of Columbia,"Honolulu, HI",Hawaii,1447,1385,-9,0,1438,1385,19,6,1457,1379,502,62,82,87,0,,0,0.0,0.0,0.0,0.0,0.0
2024,7,9,2,2024-07-09,B6,566,DCA,MCO,"Washington, DC",District of Columbia,"Orlando, FL",Florida,1536,1697,10,5,1546,1702,20,11,1566,1691,2252,286,306,317,0,,0,0.0,0.0,0.0,0.0,0.0
2024,4,29,1,2024-04-29,WN,5276,MDW,SEA,"Chicago, IL",Illinois,"Seattle, WA",Washington,2160,620,3,5,2163,625,21,5,2184,620,2181,278,298,304,0,,0,0.0,0.0,0.0,0.0,0.0
2024,8,7,3,2024-08-07,NK,3493,JFK,CLT,"New York, NY",New York,"Charlotte, NC",North Carolina,1326,2336,-8,0,1318,2336,7,5,1325,2331,2750,350,370,362,0,,0,0.0,0.0,0.0,0.0,0.0
2024,2,22,4,2024-02-22,UA,9857,MSP,MCO,"Minneapolis, MN",Minnesota,"Orlando, FL",Florida,666,1777,-7,-15,659,1762,27,7,686,1755,976,129,149,163,0,,0,0.0,0.0,0.0,0.0,0.0
2024,8,9,5,2024-08-09,F9,9810,IAD,PHL,"Washington, DC",District of Columbia,"Philadelphia, PA",Pennsylvania,552,1877,18,15,570,1892,22,18,592,1874,654,80,100,120,0,,0,0.0,0.0,0.0,0.0,0.0
2024,5,10,5,2024-05-10,DL,7533,MSP,IAD,"Minneapolis, MN",Minnesota,"Washington, DC",District of Columbia,1709,1830,-16,-20,1693,1810,17,7,1710,1803,2905,356,376,380,0,,0,0.0,0.0,0.0,0.0,0.0
2024,8,24,6,2024-08-24,AA,7494,PHL,LAS,"Philadelphia, PA",Pennsylvania,"Las Vegas, NV",Nevada,775,1772,15,10,790,1782,16,10,806,1772,2165,279,299,305,0,,0,0.0,0.0,0.0,0.0,0.0
2024,9,2,1,2024-09-02,OO,2135,CLT,SAN,"Charlotte, NC",North Carolina,"San Diego, CA",California,946,1517,8,0,954,1517,23,14,977,1503,1464,189,209,226,0,,0,0.0,0.0,0.0,0.0,0.0
2024,8,13,2,2024-08-13,DL,9095,MCO,EWR,"Orlando, FL",Florida,"Newark, NJ",New Jersey,851,2318,14,10,865,2328,26,8,891,2320,927,106,126,140,0,,0,0.0,0.0,0.0,0.0,0.0
2024,7,26,5,2024-07-26,G4,9369,IAH,DTW,"Houston, TX",Texas,"Detroit, MI",Michigan,509,901,3,0,512,901,6,4,518,897,2753,351,371,361,0,,0,0.0,0.0,0.0,0.0,0.0
2024,4,5,5,2024-04-05,B6,1732,LGA,BOS,"New York, NY",New York,"Boston, MA",Massachusetts,909,896,-6,0,903,896,5,17,908,879,1944,243,263,265,0,,0,0.0,0.0,0.0,0.0,0.0
2024,7,18,4,2024-07-18,OO,2084,DFW,IAH,"Dallas/Fort Worth, TX",Texas,"Houston, TX",Texas,646,2114,-9,-5,637,2109,14,18,651,2091,2840,345,365,377,0,,0,0.0,0.0,0.0,0.0,0.0
2024,9,3,2,2024-09-03,F9,7221,TPA,IAH,"Tampa, FL",Florida,"Houston, TX",Texas,2000,1372,-3,5,1997,1377,22,6,2019,1371,2483,315,335,343,0,,0,0.0,0.0,0.0,0.0,0.0
2024,3,12,2,2024-03-12,UA,103,PDX,LAS,"Portland, OR",Oregon,"Las Vegas, NV",Nevada,1328,1667,-19,-10,1309,1657,16,17,1325,1640,1756,213,233,246,0,,0,0.0,0.0,0.0,0.0,0.0
2024,11,13,3,2024-11-13,NK,7577,SAN,MIA,"San Diego, CA",California,"Miami, FL",Florida,1129,1767,10,5,1139,1772,17,9,1156,1763,1409,171,191,197,0,,0,0.0,0.0,0.0,0.0,0.0
2024,7,3,3,2024-07-03,HA,6098,IAD,DEN,"Washington, DC",District of Columbia,"Denver, CO",Colorado,1351,1867,-19,-10,1332,1857,8,17,1340,1840,2113,266,286,291,0,,0,0.0,0.0,0.0,0.0,0.0
2024,1,6,6,2024-01-06,DL,702,MCO,STL,"Orlando, FL",Florida,"St. Louis, MO",Missouri,927,1018,-3,5,924,1023,25,18,949,1005,2040,255,275,298,0,,0,0.0,0.0,0.0,0.0,0.0
2024,7,24,3,2024-07-24,F9,7356,ORD,LGA,"Chicago, IL",Illinois,"New York, NY",New York,987,2140,-9,-10,978,2130,5,19,983,2111,1961,248,268,272,0,,0,0.0,0.0,0.0,0.0,0.0
2024,2,1,4,2024-02-01,OH,8792,LGA,BWI,"New York, NY",New York,"Baltimore, MD",Maryland,2053,661,-20,-10,2033,651,8,7,2041,644,2452,302,322,317,0,,0,0.0,0.0,0.0,0.0,0.0
2024,4,8,1,2024-04-08,NK,6814,HNL,LAS,"Honolulu, HI",Hawaii,"Las Vegas, NV",Nevada,1900,1457,14,10,1914,1467,25,8,1939,1459,2389,296,316,329,0,,0,0.0,0.0,0.0,0.0,0.0
2024,9,12,4,2024-09-12,YX,8476,HNL,TPA,"Honolulu, HI",Hawaii,"Tampa, FL",Florida,2261,1137,0,10,2261,1147,24,6,2285,1141,1803,223,243,253,0,,0,0.0,0.0,0.0,0.0,0.0
2024,7,5,5,2024-07-05,B6,3351,IAH,PDX,"Houston, TX",Texas,"Portland, OR",Oregon,1635,1940,-5,5,1630,1945,22,12,1652,1933,581,78,98,112,0,,0,0.0,0.0,0.0,0.0,0.0
2024,3,16,6,2024-03-16,YX,3247,JFK,EWR,"New York, NY",New York,"Newark, NJ",New Jersey,1083,2058,19,15,1102,2073,21,3,1123,2070,2207,270,290,294,0,,0,0.0,0.0,0.0,0.0,0.0
2024,6,25,2,2024-06-25,OO,9587,IAH,CLT,"Houston, TX",Texas,"Charlotte, NC",North Carolina,1155,1295,-18,-10,1137,1285,24,10,1161,1275,2381,293,313,327,0,,0,0.0,0.0,0.0,0.0,0.0
2024,11,10,7,2024-11-10,WN,8244,LAX,HNL,"Los Angeles, CA",California,"Honolulu, HI",Hawaii,1115,1417,-7,-10,1108,1407,18,8,1126,1399,2651,330,350,356,0,,0,0.0,0.0,0.0,0.0,0.0
2024,10,13,7,2024-10-13,AA,154,PHX,PDX,"Phoenix, AZ",Arizona,"Portland, OR",Oregon,714,2004,-11,-10,703,1994,6,12,709,1982,2261,276,296,294,0,,0,0.0,0.0,0.0,0.0,0.0
2024,12,14,6,2024-12-14,B6,3010,HNL,JFK,"Honolulu, HI",Hawaii,"New York, NY",New York,1491,1659,-13,-5,1478,1654,18,6,1496,1648,572,62,82,86,0,,0,0.0,0.0,0.0,0.0,0.0
2024,9,11,3,2024-09-11,YX,1970,CLT,LAS,"Charlotte, NC",North Carolina,"Las Vegas, NV",Nevada,1009,1519,4,-5,1013,1514,14,15,1027,1499,1400,172,192,201,0,,0,0.0,0.0,0.0,0.0,0.0
2024,11,20,3,2024-11-20,G4,3448,BOS,PHL,"Boston, MA",Massachusetts,"Philadelphia, PA",Pennsylvania,1010,1574,12,5,1022,1579,29,4,1051,1575,1486,175,195,208,0,,0,0.0,0.0,0.0,0.0,0.0
2024,7,8,1,2024-07-08,9E,1701,PDX,MSP,"Portland, OR",Oregon,"Minneapolis, MN",Minnesota,2112,1141,-17,-10,2095,1131,24,8,2119,1123,2986,375,395,407,0,,0,0.0,0.0,0.0,0.0,0.0
2024,11,3,7,2024-11-03,WN,5867,DEN,IAD,"Denver, CO",Colorado,"Washington, DC",District of Columbia,525,2204,-4,-10,521,2194,7,13,528,2181,2937,368,388,388,0,,0,0.0,0.0,0.0,0.0,0.0
2024,12,10,2,2024-12-10,MQ,5930,DFW,STL,"Dallas/Fort Worth, TX",Texas,"St. Louis, MO",Missouri,2265,1855,9,0,2274,1855,19,14,2293,1841,2389,291,311,324,0,,0,0.0,0.0,0.0,0.0,0.0
2024,5,6,1,2024-05-06,G4,8220,IAD,LAX,"Washington, DC",District of Columbia,"Los Angeles, CA",California,692,2311,-17,-10,675,2301,11,11,686,2290,731,90,110,112,0,,0,0.0,0.0,0.0,0.0,0.0
2024,10,13,7,2024-10-13,YX,7143,MCO,LAS,"Orlando, FL",Florida,"Las Vegas, NV",Nevada,602,1389,-1,-5,601,1384,19,13,620,1371,2467,303,323,335,0,,0,0.0,0.0,0.0,0.0,0.0
2024,9,10,2,2024-09-10,DL,2190,MSP,PHX,"Minneapolis, MN",Minnesota,"Phoenix, AZ",Arizona,1728,632,-15,-15,1713,617,23,17,1736,600,2132,270,290,310,0,,0,0.0,0.0,0.0,0.0,0.0
2024,7,31,3,2024-07-31,WN,5580,STL,HNL,"St. Louis, MO",Missouri,"Honolulu, HI",Hawaii,910,1180,12,20,922,1200,16,15,938,1185,512,68,88,99,1,,0,3.0,4.0,3.0,0.0,10.0
2024,9,6,5,2024-09-06,G4,9543,MSP,ORD,"Minneapolis, MN",Minnesota,"Chicago, IL",Illinois,2295,951,-9,-5,2286,946,28,4,2314,942,2496,320,340,352,0,,0,0.0,0.0,0.0,0.0,0.0
2024,3,24,7,2024-03-24,WN,6470,BOS,STL,"Boston, MA",Massachusetts,"St. Louis, MO",Missouri,1244,854,9,10,1253,864,25,16,1278,848,376,38,58,79,0,,0,0.0,0.0,0.0,0.0,0.0
2024,1,13,6,2024-01-13,B6,5282,IAD,LAS,"Washington, DC",District of Columbia,"Las Vegas, NV",Nevada,550,1673,8,0,558,1673,8,12,566,1661,1971,243,263,263,0,,0,0.0,0.0,0.0,0.0,0.0
2024,2,14,3,2024-02-14,OO,270,MCO,SLC,"Orlando, FL",Florida,"Salt Lake City, UT",Utah,1654,1646,-1,-10,1653,1636,5,17,1658,1619,654,76,96,98,0,,0,0.0,0.0,0.0,0.0,0.0
2024,5,6,1,2024-05-06,F9,2909,DTW,MCO,"Detroit, MI",Michigan,"Orlando, FL",Florida,842,1877,-13,-10,829,1867,9,12,838,1855,1148,143,163,164,0,,0,0.0,0.0,0.0,0.0,0.0
2024,4,23,2,2024-04-23,AA,7093,PHL,EWR,"Philadelphia, PA",Pennsylvania,"Newark, NJ",New Jersey,2101,2017,9,5,2110,2022,13,11,2123,2011,2171,268,288,292,0,,0,0.0,0.0,0.0,0.0,0.0
2024,10,2,3,2024-10-02,AA,8029,SEA,HNL,"Seattle, WA",Washington,"Honolulu, HI",Hawaii,1923,2299,22,20,1945,2319,12,8,1957,2311,2088,257,277,277,0,,0,1.0,4.0,1.0,0.0,14.0
2024,7,23,2,2024-07-23,G4,6811,DCA,PDX,"Washington, DC",District of Columbia,"Portland, OR",Oregon,701,872,-18,-10,683,862,18,5,701,857,1653,214,234,237,0,,0,0.0,0.0,0.0,0.0,0.0
2024,12,2,1,2024-12-02,G4,4091,IAH,JFK,"Houston, TX",Texas,"New York, NY",New York,799,1292,-11,-15,788,1277,18,14,806,1263,2050,259,279,291,0,,0,0.0,0.0,0.0,0.0,0.0
2024,9,29,7,2024-09-29,WN,7235,SFO,JFK,"San Francisco, CA",California,"New York, NY",New York,645,849,-6,-5,639,844,8,19,647,825,1744,227,247,254,0,,0,0.0,0.0,0.0,0.0,0.0
2024,2,27,2,2024-02-27,MQ,926,TPA,BOS,"Tampa, FL",Florida,"Boston, MA",Massachusetts,1269,1860,-1,-5,1268,1855,29,14,1297,1841,1276,166,186,209,0,,0,0.0,0.0,0.0,0.0,0.0
2024,11,23,6,2024-11-23,DL,9957,JFK,LGA,"New York, NY",New York,"New York, NY",New York,961,1503,13,10,974,1513,11,6,985,1507,1826,225,245,242,0,,0,0.0,0.0,0.0,0.0,0.0
2024,8,6,2,2024-08-06,MQ,229,SEA,MDW,"Seattle, WA",Washington,"Chicago, IL",Illinois,1415,831,-2,0,1413,831,6,16,1419,815,2518,309,329,331,0,,0,0.0,0.0,0.0,0.0,0.0
2024,4,18,4,2024-04-18,G4,1517,TPA,BOS,"Tampa, FL",Florida,"Boston, MA",Massachusetts,1323,1027,-11,-15,1312,1012,15,10,1327,1002,2985,376,396,401,0,,0,0.0,0.0,0.0,0.0,0.0
2024,10,5,6,2024-10-05,OH,6898,SFO,MIA,"San Francisco, CA",California,"Miami, FL",Florida,1003,1556,18,15,1021,1571,11,4,1032,1567,2565,314,334,329,0,,0,0.0,0.0,0.0,0.0,0.0
2024,6,22,6,2024-06-22,WN,6873,BWI,SAN,"Baltimore, MD",Maryland,"San Diego, CA",California,2139,1233,-1,-5,2138,1228,24,16,2162,1212,1436,175,195,215,0,,0,0.0,0.0,0.0,0.0,0.0
2024,11,23,6,2024-11-23,AS,1507,DCA,PDX,"Washington, DC",District of Columbia,"Portland, OR",Oregon,650,841,8,5,658,846,25,6,683,840,363,54,74,85,0,,0,0.0,0.0,0.0,0.0,0.0
2024,9,20,5,2024-09-20,YX,5236,LAX,PDX,"Los Angeles, CA",California,"Portland, OR",Oregon,2153,733,4,5,2157,738,21,4,2178,734,2945,361,381,386,0,,0,0.0,0.0,0.0,0.0,0.0
2024,11,10,7,2024-11-10,AA,8885,ATL,EWR,"Atlanta, GA",Georgia,"Newark, NJ",New Jersey,1839,1694,-14,-15,1825,1679,19,8,1844,1671,2473,309,329,336,0,,0,0.0,0.0,0.0,0.0,0.0
2024,4,20,6,2024-04-20,YX,1137,EWR,IAD,"Newark, NJ",New Jersey,"Washington, DC",District of Columbia,698,2088,-11,-20,687,2068,8,10,695,2058,620,68,88,86,0,,0,0.0,0.0,0.0,0.0,0.0
2024,7,5,5,2024-07-05,G4,7646,SFO,JFK,"San Francisco, CA",California,"New York, NY",New York,928,2044,-12,-15,916,2029,6,5,922,2024,611,79,99,90,0,,0,0.0,0.0,0.0,0.0,0.0
2024,9,25,3,2024-09-25,B6,6003,ORD,EWR,"Chicago, IL",Illinois,"Newark, NJ",New Jersey,802,1933,24,20,826,1953,13,17,839,1936,1475,181,201,211,0,,0,5.0,1.0,2.0,0.0,12.0
2024,8,16,5,2024-08-16,HA,122,MSP,LAS,"Minneapolis, MN",Minnesota,"Las Vegas, NV",Nevada,1403,1623,6,5,1409,1628,16,7,1425,1621,1381,168,188,191,0,,0,0.0,0.0,0.0,0.0,0.0
2024,6,4,2,2024-06-04,UA,9925,LAX,HNL,"Los Angeles, CA",California,"Honolulu, HI",Hawaii,997,1902,-24,-15,973,1887,28,8,1001,1879,1766,229,249,265,0,,0,0.0,0.0,0.0,0.0,0.0
2024,7,7,7,2024-07-07,WN,6387,SLC,MDW,"Salt Lake City, UT",Utah,"Chicago, IL",Illinois,1400,818,8,0,1408,818,23,12,1431,806,2255,289,309,324,0,,0,0.0,0.0,0.0,0.0,0.0
2024,9,28,6,2024-09-28,AA,1505,ATL,IAH,"Atlanta, GA",Georgia,"Houston, TX",Texas,1290,1296,6,0,1296,1296,27,6,1323,1290,2221,283,303,316,0,,0,0.0,0.0,0.0,0.0,0.0
2024,1,2,2,2024-01-02,OH,9770,SEA,HNL,"Seattle, WA",Washington,"Honolulu, HI",Hawaii,604,906,-16,-20,588,886,27,11,615,875,1322,167,187,205,0,,0,0.0,0.0,0.0,0.0,0.0
2024,9,2,1,2024-09-02,G4,6567,LGA,STL,"New York, NY",New York,"St. Louis, MO",Missouri,509,913,-6,-5,503,908,26,12,529,896,1166,139,159,177,0,,0,0.0,0.0,0.0,0.0,0.0
2024,7,28,7,2024-07-28,OH,1294,SLC,PHL,"Salt Lake City, UT",Utah,"Philadelphia, PA",Pennsylvania,2148,2026,5,5,2153,2031,23,7,2176,2024,1049,123,143,153,0,,0,0.0,0.0,0.0,0.0,0.0
2024,10,12,6,2024-10-12,F9,8867,SLC,STL,"Salt Lake City, UT",Utah,"St. Louis, MO",Missouri,1550,1522,-7,-10,1543,1512,29,18,1572,1494,2167,270,290,317,0,,0,0.0,0.0,0.0,0.0,0.0
2024,12,24,2,2024-12-24,WN,8023,DCA,IAD,"Washington, DC",District of Columbia,"Washington, DC",District of Columbia,1110,2352,8,10,1118,2362,29,13,1147,2349,2475,312,332,354,0,,0,0.0,0.0,0.0,0.0,0.0
2024,1,13,6,2024-01-13,DL,1706,CLT,MIA,"Charlotte, NC",North Carolina,"Miami, FL",Florida,1268,2111,-3,5,1265,2116,26,6,1291,2110,2433,305,325,337,0,,0,0.0,0.0,0.0,0.0,0.0
2024,4,5,5,2024-04-05,OH,8743,SEA,DTW,"Seattle, WA",Washington,"Detroit, MI",Michigan,826,2028,-30,-20,796,2008,7,14,803,1994,2332,289,309,310,0,,0,0.0,0.0,0.0,0.0,0.0
2024,8,8,4,2024-08-08,G4,8416,HNL,MIA,"Honolulu, HI",Hawaii,"Miami, FL",Florida,2018,2002,5,10,2023,2012,24,12,2047,2000,1995,252,272,288,0,,0,0.0,0.0,0.0,0.0,0.0
2024,8,25,7,2024-08-25,WN,6350,HNL,MSP,"Honolulu, HI",Hawaii,"Minneapolis, MN",Minnesota,1382,880,-25,-20,1357,860,9,4,1366,856,807,99,119,112,0,,0,0.0,0.0,0.0,0.0,0.0
2024,4,3,3,2024-04-03,G4,1783,LGA,ORD,"New York, NY",New York,"Chicago, IL",Illinois,2171,2260,4,10,2175,2270,13,12,2188,2258,1815,220,240,245,0,,0,0.0,0.0,0.0,0.0,0.0
2024,12,3,2,2024-12-03,9E,9198,MSP,SAN,"Minneapolis, MN",Minnesota,"San Diego, CA",California,1406,2314,-12,-5,1394,2309,23,14,1417,2295,1497,191,211,228,0,,0,0.0,0.0,0.0,0.0,0.0
2024,9,25,3,2024-09-25,UA,8721,DTW,ORD,"Detroit, MI",Michigan,"Chicago, IL",Illinois,1237,1950,-3,5,1234,1955,13,4,1247,1951,2217,284,304,301,0,,0,0.0,0.0,0.0,0.0,0.0
2024,6,19,3,2024-06-19,NK,2851,EWR,LGA,"Newark, NJ",New Jersey,"New York, NY",New York,626,634,7,5,633,639,25,9,658,630,2013,256,276,290,0,,0,0.0,0.0,0.0,0.0,0.0
2024,4,3,3,2024-04-03,NK,7604,LAS,LAX,"Las Vegas, NV",Nevada,"Los Angeles, CA",California,1639,669,-17,-10,1622,659,26,3,1648,656,482,55,75,84,0,,0,0.0,0.0,0.0,0.0,0.0
2024,5,28,2,2024-05-28,9E,7763,PDX,SFO,"Portland, OR",Oregon,"San Francisco, CA",California,1423,959,-9,-5,1414,954,22,13,1436,941,2279,292,312,327,0,,0,0.0,0.0,0.0,0.0,0.0
2024,4,21,7,2024-04-21,MQ,8653,TPA,IAH,"Tampa, FL",Florida,"Houston, TX",Texas,670,2313,8,0,678,2313,20,15,698,2298,1678,208,228,243,0,,0,0.0,0.0,0.0,0.0,0.0
2024,2,24,6,2024-02-24,WN,8723,DFW,LAS,"Dallas/Fort Worth, TX",Texas,"Las Vegas, NV",Nevada,711,1007,0,0,711,1007,6,15,717,992,1459,174,194,195,0,,0,0.0,0.0,0.0,0.0,0.0
2024,12,2,1,2024-12-02,DL,2822,LAX,STL,"Los Angeles, CA",California,"St. Louis, MO",Missouri,1423,2184,-11,-10,1412,2174,16,19,1428,2155,1156,149,169,184,0,,0,0.0,0.0,0.0,0.0,0.0
2024,4,25,4,2024-04-25,OO,5739,DEN,CLT,"Denver, CO",Colorado,"Charlotte, NC",North Carolina,688,1179,53,45,741,1224,22,16,763,1208,1455,187,207,225,0,,0,8.0,1.0,8.0,1.0,27.0
2024,5,22,3,2024-05-22,G4,3323,PDX,PHX,"Portland, OR",Oregon,"Phoenix, AZ",Arizona,2013,1118,13,5,2026,1123,27,18,2053,1105,363,38,58,83,0,,0,0.0,0.0,0.0,0.0,0.0
2024,7,19,5,2024-07-19,WN,5541,BOS,SLC,"Boston, MA",Massachusetts,"Salt Lake City, UT",Utah,1432,1205,-16,-10,1416,1195,15,14,1431,1181,2513,312,332,341,0,,0,0.0,0.0,0.0,0.0,0.0
2024,6,28,5,2024-06-28,F9,9922,DTW,JFK,"Detroit, MI",Michigan,"New York, NY",New York,886,2007,-10,0,876,2007,26,14,902,1993,330,34,54,74,0,,0,0.0,0.0,0.0,0.0,0.0
2024,7,20,6,2024-07-20,OH,7481,SEA,IAH,"Seattle, WA",Washington,"Houston, TX",Texas,1276,680,-5,-5,1271,675,27,14,1298,661,1299,156,176,197,0,,0,0.0,0.0,0.0,0.0,0.0
2024,12,29,7,2024-12-29,DL,5284,DCA,DFW,"Washington, DC",District of Columbia,"Dallas/Fort Worth, TX",Texas,1511,2061,12,10,1523,2071,7,12,1530,2059,1447,173,193,192,0,,0,0.0,0.0,0.0,0.0,0.0
2024,2,22,4,2024-02-22,F9,369,SFO,SEA,"San Francisco, CA",California,"Seattle, WA",Washington,1225,849,-8,-5,1217,844,24,4,1241,840,1798,217,237,245,0,,0,0.0,0.0,0.0,0.0,0.0
2024,6,28,5,2024-06-28,OO,7804,STL,EWR,"St. Louis, MO",Missouri,"Newark, NJ",New Jersey,2124,1661,-5,-10,2119,1651,26,8,2145,1643,2618,332,352,366,0,,0,0.0,0.0,0.0,0.0,0.0
2024,11,8,5,2024-11-08,9E,6215,DEN,LGA,"Denver, CO",Colorado,"New York, NY",New York,1653,644,-22,-20,1631,624,7,3,1638,621,549,69,89,79,0,,0,0.0,0.0,0.0,0.0,0.0
2024,11,3,7,2024-11-03,B6,9415,DTW,IAD,"Detroit, MI",Michigan,"Washington, DC",District of Columbia,522,1982,23,30,545,2012,19,9,564,2003,1105,133,153,161,0,,0,2.0,5.0,2.0,0.0,21.0
2024,5,16,4,2024-05-16,NK,7398,MIA,SEA,"Miami, FL",Florida,"Seattle, WA",Washington,1702,736,3,-5,1705,731,16,3,1721,728,2157,277,297,296,0,,0,0.0,0.0,0.0,0.0,0.0
2024,6,30,7,2024-06-30,NK,4633,PHX,ORD,"Phoenix, AZ",Arizona,"Chicago, IL",Illinois,900,1422,-14,-10,886,1412,5,12,891,1400,219,22,42,39,0,,0,0.0,0.0,0.0,0.0,0.0
2024,1,1,1,2024-01-01,YX,1142,DEN,BOS,"Denver, CO",Colorado,"Boston, MA",Massachusetts,1004,1578,1,0,1005,1578,26,15,1031,1563,2086,263,283,304,0,,0,0.0,0.0,0.0,0.0,0.0
2024,2,13,2,2024-02-13,G4,1741,EWR,ATL,"Newark, NJ",New Jersey,"Atlanta, GA",Georgia,1420,1419,-12,-10,1408,1409,15,11,1423,1398,602,73,93,99,0,,0,0.0,0.0,0.0,0.0,0.0
2024,8,14,3,2024-08-14,UA,6703,BWI,PDX,"Baltimore, MD",Maryland,"Portland, OR",Oregon,1934,2084,-8,-10,1926,2074,6,17,1932,2057,2226,270,290,293,0,,0,0.0,0.0,0.0,0.0,0.0
2024,11,26,2,2024-11-26,9E,3397,BOS,MSP,"Boston, MA",Massachusetts,"Minneapolis, MN",Minnesota,2055,966,1,0,2056,966,27,9,2083,957,625,78,98,114,0,,0,0.0,0.0,0.0,0.0,0.0
2024,4,7,7,2024-04-07,WN,7155,JFK,HNL,"New York, NY",New York,"Honolulu, HI",Hawaii,828,1928,-17,-15,811,1913,25,4,836,1909,989,119,139,148,0,,0,0.0,0.0,0.0,0.0,0.0
2024,7,26,5,2024-07-26,9E,1483,DTW,LGA,"Detroit, MI",Michigan,"New York, NY",New York,970,828,1,0,971,828,18,16,989,812,1851,231,251,265,0,,0,0.0,0.0,0.0,0.0,0.0
2024,9,21,6,2024-09-21,WN,4096,LGA,DCA,"New York, NY",New York,"Washington, DC",District of Columbia,1943,782,0,-5,1943,777,5,7,1948,770,2741,349,369,361,0,,0,0.0,0.0,0.0,0.0,0.0
2024,10,14,1,2024-10-14,HA,114,CLT,LGA,"Charlotte, NC",North Carolina,"New York, NY",New York,911,1066,2,0,913,1066,29,12,942,1054,531,74,94,115,0,,0,0.0,0.0,0.0,0.0,0.0
2024,9,27,5,2024-09-27,MQ,1774,LAX,JFK,"Los Angeles, CA",California,"New York, NY",New York,1253,1437,-13,-5,1240,1432,22,9,1262,1423,2520,322,342,353,0,,0,0.0,0.0,0.0,0.0,0.0
2024,5,19,7,2024-05-19,9E,5199,SEA,ATL,"Seattle, WA",Washington,"Atlanta, GA",Georgia,2275,803,-5,0,2270,803,22,8,2292,795,561,74,94,104,0,,0,0.0,0.0,0.0,0.0,0.0
2024,8,24,6,2024-08-24,B6,3717,MDW,SFO,"Chicago, IL",Illinois,"San Francisco, CA",California,528,1574,-12,-15,516,1559,19,5,535,1554,2259,290,310,314,0,,0,0.0,0.0,0.0,0.0,0.0
2024,3,12,2,2024-03-12,OH,8199,HNL,BWI,"Honolulu, HI",Hawaii,"Baltimore, MD",Maryland,744,1222,-14,-5,730,1217,8,15,738,1202,1830,233,253,256,0,,0,0.0,0.0,0.0,0.0,0.0
2024,6,3,1,2024-06-03,AS,6657,BOS,MDW,"Boston, MA",Massachusetts,"Chicago, IL",Illinois,2155,1691,-1,-10,2154,1681,6,9,2160,1672,2457,303,323,318,0,,0,0.0,0.0,0.0,0.0,0.0
2024,7,8,1,2024-07-08,HA,5574,DCA,SLC,"Washington, DC",District of Columbia,"Salt Lake City, UT",Utah,1437,1468,-13,-5,1424,1463,19,4,1443,1459,2274,283,303,306,0,,0,0.0,0.0,0.0,0.0,0.0
2024,9,24,2,2024-09-24,UA,1580,DEN,DTW,"Denver, CO",Colorado,"Detroit, MI",Michigan,1325,1149,0,-5,1325,1144,17,6,1342,1138,2695,344,364,367,0,,0,0.0,0.0,0.0,0.0,0.0
2024,11,16,6,2024-11-16,MQ,7798,IAH,DEN,"Houston, TX",Texas,"Denver, CO",Colorado,2067,2333,-3,0,2064,2333,14,3,2078,2330,2364,295,315,312,0,,0,0.0,0.0,0.0,0.0,0.0
2024,4,16,2,2024-04-16,WN,3146,PDX,SLC,"Portland, OR",Oregon,"Salt Lake City, UT",Utah,2175,1928,-5,0,2170,1928,19,13,2189,1915,1798,218,238,250,0,,0,0.0,0.0,0.0,0.0,0.0
2024,8,19,1,2024-08-19,UA,7463,BWI,PHX,"Baltimore, MD",Maryland,"Phoenix, AZ",Arizona,2193,1203,-13,-5,2180,1198,10,4,2190,1194,626,73,93,87,0,,0,0.0,0.0,0.0,0.0,0.0
2024,2,11,7,2024-02-11,DL,6057,SLC,SAN,"Salt Lake City, UT",Utah,"San Diego, CA",California,1583,1354,-16,-10,1567,1344,25,4,1592,1340,2445,302,322,331,0,,0,0.0,0.0,0.0,0.0,0.0
2024,7,8,1,2024-07-08,9E,4310,PDX,MSP,"Portland, OR",Oregon,"Minneapolis, MN",Minnesota,638,1227,-7,0,631,1227,14,16,645,1211,355,42,62,72,0,,0,0.0,0.0,0.0,0.0,0.0
2024,5,18,6,2024-05-18,YX,5571,DTW,PHL,"Detroit, MI",Michigan,"Philadelphia, PA",Pennsylvania,856,1615,15,20,871,1635,7,13,878,1622,1349,169,189,189,0,,0,1.0,3.0,2.0,0.0,14.0
2024,4,12,5,2024-04-12,G4,1075,HNL,PHX,"Honolulu, HI",Hawaii,"Phoenix, AZ",Arizona,711,694,-19,-10,692,684,17,4,709,680,601,70,90,91,0,,0,0.0,0.0,0.0,0.0,0.0
2024,6,19,3,2024-06-19,AA,1785,PHX,MSP,"Phoenix, AZ",Arizona,"Minneapolis, MN",Minnesota,1662,2348,-23,-15,1639,2333,22,8,1661,2325,2228,278,298,308,0,,0,0.0,0.0,0.0,0.0,0.0
2024,12,16,1,2024-12-16,DL,2183,MSP,TPA,"Minneapolis, MN",Minnesota,"Tampa, FL",Florida,1891,1869,-13,-10,1878,1859,10,9,1888,1850,818,93,113,112,0,,0,0.0,0.0,0.0,0.0,0.0
2024,9,29,7,2024-09-29,F9,1786,SAN,ATL,"San Diego, CA",California,"Atlanta, GA",Georgia,2146,1284,-1,-5,2145,1279,18,12,2163,1267,2741,333,353,363,0,,0,0.0,0.0,0.0,0.0,0.0
2024,8,8,4,2024-08-08,HA,4258,LAX,IAH,"Los Angeles, CA",California,"Houston, TX",Texas,985,1396,-6,-5,979,1391,22,3,1001,1388,1024,137,157,162,0,,0,0.0,0.0,0.0,0.0,0.0
2024,7,31,3,2024-07-31,NK,6909,SFO,IAD,"San Francisco, CA",California,"Washington, DC",District of Columbia,2016,1702,14,10,2030,1712,15,8,2045,1704,2257,274,294,297,0,,0,0.0,0.0,0.0,0.0,0.0
2024,12,6,5,2024-12-06,YX,8800,ORD,SEA,"Chicago, IL",Illinois,"Seattle, WA",Washington,1859,2056,-5,0,1854,2056,24,16,1878,2040,1762,216,236,256,0,,0,0.0,0.0,0.0,0.0,0.0
2024,2,25,7,2024-02-25,AA,287,DTW,ATL,"Detroit, MI",Michigan,"Atlanta, GA",Georgia,2286,1903,-9,-10,2277,1893,19,8,2296,1885,2521,316,336,343,0,,0,0.0,0.0,0.0,0.0,0.0
2024,12,7,6,2024-12-07,B6,2882,STL,IAH,"St. Louis, MO",Missouri,"Houston, TX",Texas,2134,2284,17,20,2151,2304,25,11,2176,2293,2544,311,331,347,0,,0,0.0,5.0,2.0,0.0,13.0
2024,4,11,4,2024-04-11,9E,4288,PHX,BOS,"Phoenix, AZ",Arizona,"Boston, MA",Massachusetts,677,968,-20,-15,657,953,17,7,674,946,764,103,123,127,0,,0,0.0,0.0,0.0,0.0,0.0
2024,7,10,3,2024-07-10,AS,4200,MIA,LAX,"Miami, FL",Florida,"Los Angeles, CA",California,1012,878,-10,-15,1002,863,20,12,1022,851,212,33,53,65,0,,0,0.0,0.0,0.0,0.0,0.0
2024,11,5,2,2024-11-05,B6,2172,ORD,SFO,"Chicago, IL",Illinois,"San Francisco, CA",California,2124,950,-6,-10,2118,940,28,9,2146,931,2910,356,376,393,0,,0,0.0,0.0,0.0,0.0,0.0
2024,7,18,4,2024-07-18,WN,6751,MDW,BOS,"Chicago, IL",Illinois,"Boston, MA",Massachusetts,612,1849,-6,-15,606,1834,16,10,622,1824,1519,193,213,219,0,,0,0.0,0.0,0.0,0.0,0.0
2024,8,20,2,2024-08-20,OH,197,MDW,MCO,"Chicago, IL",Illinois,"Orlando, FL",Florida,782,1005,9,5,791,1010,5,14,796,996,1970,240,260,259,0,,0,0.0,0.0,0.0,0.0,0.0
2024,8,14,3,2024-08-14,MQ,9583,ATL,MCO,"Atlanta, GA",Georgia,"Orlando, FL",Florida,1639,1045,-8,-5,1631,1040,27,10,1658,1030,2799,342,362,379,0,,0,0.0,0.0,0.0,0.0,0.0
2024,5,18,6,2024-05-18,AA,6905,LAX,BWI,"Los Angeles, CA",California,"Baltimore, MD",Maryland,1043,922,13,5,1056,927,18,12,1074,915,2553,317,337,347,0,,0,0.0,0.0,0.0,0.0,0.0
2024,12,9,1,2024-12-09,NK,3564,IAH,JFK,"Houston, TX",Texas,"New York, NY",New York,2297,1229,8,5,2305,1234,26,11,2331,1223,2879,364,384,401,0,,0,0.0,0.0,0.0,0.0,0.0
2024,10,31,4,2024-10-31,G4,1887,DEN,BWI,"Denver, CO",Colorado,"Baltimore, MD",Maryland,540,672,-5,-10,535,662,7,18,542,644,2616,333,353,358,0,,0,0.0,0.0,0.0,0.0,0.0
2024,5,28,2,2024-05-28,AS,7863,LGA,JFK,"New York, NY",New York,"New York, NY",New York,1431,1117,1,0,1432,1117,14,17,1446,1100,1764,218,238,249,1,,0,0.0,0.0,0.0,0.0,0.0
2024,4,24,3,2024-04-24,UA,5504,LAX,LGA,"Los Angeles, CA",California,"New York, NY",New York,1690,1944,-8,0,1682,1944,14,11,1696,1933,2833,357,377,382,0,,0,0.0,0.0,0.0,0.0,0.0
2024,3,3,7,2024-03-03,HA,783,LAX,PDX,"Los Angeles, CA",California,"Portland, OR",Oregon,1354,621,19,10,1373,631,5,16,1378,615,2877,363,383,384,0,,0,0.0,0.0,0.0,0.0,0.0
2024,4,13,6,2024-04-13,9E,1232,IAD,DEN,"Washington, DC",District of Columbia,"Denver, CO",Colorado,1744,778,-26,-20,1718,758,22,3,1740,755,2981,374,394,399,0,,0,0.0,0.0,0.0,0.0,0.0
2024,12,4,3,2024-12-04,OH,5977,MSP,ORD,"Minneapolis, MN",Minnesota,"Chicago, IL",Illinois,1425,1307,-3,-5,1422,1302,21,18,1443,1284,1373,163,183,202,0,,0,0.0,0.0,0.0,0.0,0.0
2024,12,24,2,2024-12-24,WN,6298,SLC,MDW,"Salt Lake City, UT",Utah,"Chicago, IL",Illinois,2249,1732,14,10,2263,1742,23,9,2286,1733,2945,366,386,398,0,,0,0.0,0.0,0.0,0.0,0.0
2024,6,4,2,2024-06-04,9E,3936,JFK,LAX,"New York, NY",New York,"Los Angeles, CA",California,812,1995,-13,-10,799,1985,5,13,804,1972,1446,171,191,189,0,,0,0.0,0.0,0.0,0.0,0.0
2024,9,29,7,2024-09-29,B6,9906,MIA,JFK,"Miami, FL",Florida,"New York, NY",New York,1869,2320,-12,-15,1857,2305,9,4,1866,2301,2545,326,346,339,0,,0,0.0,0.0,0.0,0.0,0.0
2024,1,6,6,2024-01-06,HA,1141,DTW,DCA,"Detroit, MI",Michigan,"Washington, DC",District of Columbia,970,2079,4,0,974,2079,10,9,984,2070,2270,290,310,309,0,,0,0.0,0.0,0.0,0.0,0.0
2024,5,26,7,2024-05-26,YX,5989,STL,PDX,"St. Louis, MO",Missouri,"Portland, OR",Oregon,1654,2190,3,-5,1657,2185,5,5,1662,2180,2187,280,300,290,0,,0,0.0,0.0,0.0,0.0,0.0
2024,7,2,2,2024-07-02,YX,954,DFW,IAH,"Dallas/Fort Worth, TX",Texas,"Houston, TX",Texas,547,1852,-3,0,544,1852,21,18,565,1834,1711,219,239,258,0,,0,0.0,0.0,0.0,0.0,0.0
2024,1,28,7,2024-01-28,AA,5838,JFK,HNL,"New York, NY",New York,"Honolulu, HI",Hawaii,633,1537,9,10,642,1547,16,6,658,1541,917,112,132,134,0,,0,0.0,0.0,0.0,0.0,0.0
2024,2,7,3,2024-02-07,B6,2126,DEN,DTW,"Denver, CO",Colorado,"Detroit, MI",Michigan,1018,1618,2,0,1020,1618,8,5,1028,1613,574,64,84,77,0,,0,0.0,0.0,0.0,0.0,0.0
2024,4,28,7,2024-04-28,AA,5465,LGA,ATL,"New York, NY",New York,"Atlanta, GA",Georgia,2079,1547,-7,0,2072,1547,8,6,2080,1541,609,76,96,90,0,,0,0.0,0.0,0.0,0.0,0.0
2024,10,19,6,2024-10-19,G4,2650,MCO,HNL,"Orlando, FL",Florida,"Honolulu, HI",Hawaii,1498,1130,-10,-10,1488,1120,28,15,1516,1105,2549,313,333,356,0,,0,0.0,0.0,0.0,0.0,0.0
2024,8,31,6,2024-08-31,NK,7189,LAX,EWR,"Los Angeles, CA",California,"Newark, NJ",New Jersey,816,963,-4,5,812,968,14,16,826,952,559,73,93,103,0,,0,0.0,0.0,0.0,0.0,0.0
2024,3,8,5,2024-03-08,UA,339,DEN,BWI,"Denver, CO",Colorado,"Baltimore, MD",Maryland,1961,1024,13,5,1974,1029,27,12,2001,1017,2475,302,322,341,0,,0,0.0,0.0,0.0,0.0,0.0
2024,8,1,4,2024-08-01,G4,589,MSP,MCO,"Minneapolis, MN",Minnesota,"Orlando, FL",Florida,1958,1558,-3,-10,1955,1548,27,16,1982,1532,914,107,127,150,0,,0,0.0,0.0,0.0,0.0,0.0
2024,8,5,1,2024-08-05,DL,1136,CLT,DTW,"Charlotte, NC",North Carolina,"Detroit, MI",Michigan,585,1839,-10,-5,575,1834,29,19,604,1815,1077,142,162,190,0,,0,0.0,0.0,0.0,0.0,0.0
2024,6,25,2,2024-06-25,YX,9630,MCO,HNL,"Orlando, FL",Florida,"Honolulu, HI",Hawaii,1571,1671,8,5,1579,1676,12,16,1591,1660,2750,336,356,364,0,,0,0.0,0.0,0.0,0.0,0.0
2024,10,25,5,2024-10-25,NK,6232,MSP,LAS,"Minneapolis, MN",Minnesota,"Las Vegas, NV",Nevada,1509,2088,2,-5,1511,2083,16,7,1527,2076,2947,361,381,384,0,,0,0.0,0.0,0.0,0.0,0.0
2024,6,12,3,2024-06-12,G4,4880,BWI,HNL,"Baltimore, MD",Maryland,"Honolulu, HI",Hawaii,989,1271,-5,-5,984,1266,16,5,1000,1261,2583,326,346,347,0,,0,0.0,0.0,0.0,0.0,0.0
2024,2,27,2,2024-02-27,AS,8009,SLC,BOS,"Salt Lake City, UT",Utah,"Boston, MA",Massachusetts,923,1896,-9,-5,914,1891,7,17,921,1874,1713,207,227,231,0,,0,0.0,0.0,0.0,0.0,0.0
2024,9,25,3,2024-09-25,9E,3369,HNL,SEA,"Honolulu, HI",Hawaii,"Seattle, WA",Washington,886,2231,-6,-10,880,2221,20,11,900,2210,598,78,98,109,0,,0,0.0,0.0,0.0,0.0,0.0
2024,11,3,7,2024-11-03,B6,6222,SAN,DEN,"San Diego, CA",California,"Denver, CO",Colorado,1425,1653,-15,-5,1410,1648,8,11,1418,1637,1455,184,204,203,1,,0,0.0,0.0,0.0,0.0,0.0
2024,2,27,2,2024-02-27,YX,5810,DTW,PHX,"Detroit, MI",Michigan,"Phoenix, AZ",Arizona,739,2256,9,10,748,2266,28,12,776,2254,502,66,86,106,0,,0,0.0,0.0,0.0,0.0,0.0
2024,10,14,1,2024-10-14,NK,1867,STL,PHX,"St. Louis, MO",Missouri,"Phoenix, AZ",Arizona,2187,1612,-2,0,2185,1612,9,18,2194,1594,1351,168,188,195,0,,0,0.0,0.0,0.0,0.0,0.0
2024,4,14,7,2024-04-14,OH,4808,JFK,BOS,"New York, NY",New York,"Boston, MA",Massachusetts,1974,1478,5,0,1979,1478,19,10,1998,1468,1562,193,213,222,0,,0,0.0,0.0,0.0,0.0,0.0
2024,8,15,4,2024-08-15,HA,8453,BOS,STL,"Boston, MA",Massachusetts,"St. Louis, MO",Missouri,757,1546,-5,-10,752,1536,25,9,777,1527,515,65,85,99,0,,0,0.0,0.0,0.0,0.0,0.0
2024,9,3,2,2024-09-03,HA,8947,BWI,DFW,"Baltimore, MD",Maryland,"Dallas/Fort Worth, TX",Texas,543,1587,-4,-10,539,1577,28,16,567,1561,1807,232,252,276,0,,0,0.0,0.0,0.0,0.0,0.0
2024,7,6,6,2024-07-06,AS,3106,MCO,ORD,"Orlando, FL",Florida,"Chicago, IL",Illinois,1691,1813,-19,-20,1672,1793,12,17,1684,1776,1094,139,159,168,0,,0,0.0,0.0,0.0,0.0,0.0
2024,3,23,6,2024-03-23,B6,1356,PHX,LAX,"Phoenix, AZ",Arizona,"Los Angeles, CA",California,1714,751,-24,-20,1690,731,26,14,1716,717,2496,304,324,344,0,,0,0.0,0.0,0.0,0.0,0.0
2024,7,4,4,2024-07-04,OH,7177,PHX,MCO,"Phoenix, AZ",Arizona,"Orlando, FL",Florida,1163,1999,-9,0,1154,1999,29,12,1183,1987,2137,276,296,317,0,,0,0.0,0.0,0.0,0.0,0.0
2024,9,8,7,2024-09-08,DL,5451,MIA,BWI,"Miami, FL",Florida,"Baltimore, MD",Maryland,2085,854,-13,-5,2072,849,24,7,2096,842,492,56,76,87,0,,0,0.0,0.0,0.0,0.0,0.0
2024,12,20,5,2024-12-20,F9,849,MDW,PHL,"Chicago, IL",Illinois,"Philadelphia, PA",Pennsylvania,1799,1302,-15,-10,1784,1292,14,19,1798,1273,567,62,82,95,0,,0,0.0,0.0,0.0,0.0,0.0
2024,8,25,7,2024-08-25,HA,808,PDX,MSP,"Portland, OR",Oregon,"Minneapolis, MN",Minnesota,1506,1253,53,45,1559,1298,5,8,1564,1290,991,114,134,127,0,,0,16.0,5.0,3.0,1.0,20.0
2024,12,25,3,2024-12-25,MQ,6516,BWI,LGA,"Baltimore, MD",Maryland,"New York, NY",New York,1892,1357,-8,-5,1884,1352,14,19,1898,1333,792,99,119,132,0,,0,0.0,0.0,0.0,0.0,0.0
2024,7,2,2,2024-07-02,NK,9913,DFW,IAD,"Dallas/Fort Worth, TX",Texas,"Washington, DC",District of Columbia,1829,1657,-2,5,1827,1662,22,16,1849,1646,2902,363,383,401,1,,0,0.0,0.0,0.0,0.0,0.0
2024,10,10,4,2024-10-10,AS,7050,DCA,MSP,"Washington, DC",District of Columbia,"Minneapolis, MN",Minnesota,2130,786,-14,-10,2116,776,21,18,2137,758,2143,272,292,311,0,,0,0.0,0.0,0.0,0.0,0.0
2024,7,28,7,2024-07-28,B6,8757,SEA,PHX,"Seattle, WA",Washington,"Phoenix, AZ",Arizona,1253,1478,-17,-10,1236,1468,8,9,1244,1459,389,50,70,67,0,,0,0.0,0.0,0.0,0.0,0.0
2024,10,30,3,2024-10-30,B6,9392,BOS,DCA,"Boston, MA",Massachusetts,"Washington, DC",District of Columbia,604,2072,7,0,611,2072,29,17,640,2055,1976,252,272,298,0,,0,0.0,0.0,0.0,0.0,0.0
2024,10,22,2,2024-10-22,G4,1813,LAS,ATL,"Las Vegas, NV",Nevada,"Atlanta, GA",Georgia,1453,1709,-24,-20,1429,1689,26,16,1455,1673,646,88,108,130,0,,0,0.0,0.0,0.0,0.0,0.0
2024,4,6,6,2024-04-06,AA,8036,MDW,JFK,"Chicago, IL",Illinois,"New York, NY",New York,1426,1272,-30,-20,1396,1252,17,15,1413,1237,979,113,133,145,0,,0,0.0,0.0,0.0,0.0,0.0
2024,7,26,5,2024-07-26,G4,8408,SLC,DCA,"Salt Lake City, UT",Utah,"Washington, DC",District of Columbia,1944,1475,-21,-15,1923,1460,26,12,1949,1448,298,35,55,73,0,,0,0.0,0.0,0.0,0.0,0.0
2024,5,16,4,2024-05-16,AS,295,JFK,IAH,"New York, NY",New York,"Houston, TX",Texas,1872,717,-11,-10,1861,707,10,16,1871,691,547,61,81,87,0,,0,0.0,0.0,0.0,0.0,0.0
2024,7,2,2,2024-07-02,WN,4814,SLC,LAX,"Salt Lake City, UT",Utah,"Los Angeles, CA",California,2295,2246,3,0,2298,2246,5,16,2303,2230,2001,250,270,271,0,,0,0.0,0.0,0.0,0.0,0.0
2024,3,16,6,2024-03-16,9E,9766,BOS,SEA,"Boston, MA",Massachusetts,"Seattle, WA",Washington,1453,1681,-5,5,1448,1686,5,14,1453,1672,638,78,98,97,0,,0,0.0,0.0,0.0,0.0,0.0
2024,10,13,7,2024-10-13,OH,1374,IAH,LGA,"Houston, TX",Texas,"New York, NY",New York,2173,1641,-4,-5,2169,1636,7,10,2176,1626,1268,154,174,171,0,,0,0.0,0.0,0.0,0.0,0.0
2024,5,21,2,2024-05-21,NK,3809,SLC,LAX,"Salt Lake City, UT",Utah,"Los Angeles, CA",California,1842,1470,-2,-10,1840,1460,9,10,1849,1450,547,62,82,81,0,,0,0.0,0.0,0.0,0.0,0.0
2024,8,24,6,2024-08-24,G4,438,MCO,SAN,"Orlando, FL",Florida,"San Diego, CA",California,1943,1763,1,10,1944,1773,22,19,1966,1754,1260,162,182,203,0,,0,0.0,0.0,0.0,0.0,0.0
2024,1,25,4,2024-01-25,B6,6861,BOS,DCA,"Boston, MA",Massachusetts,"Washington, DC",District of Columbia,1194,1057,-7,-10,1187,1047,16,19,1203,1028,1835,225,245,260,0,,0,0.0,0.0,0.0,0.0,0.0
2024,10,16,3,2024-10-16,OH,3611,MSP,HNL,"Minneapolis, MN",Minnesota,"Honolulu, HI",Hawaii,556,1305,-3,5,553,1310,5,9,558,1301,2602,331,351,345,0,,0,0.0,0.0,0.0,0.0,0.0
2024,3,7,4,2024-03-07,B6,4375,BWI,EWR,"Baltimore, MD",Maryland,"Newark, NJ",New Jersey,739,1241,23,15,762,1256,13,12,775,1244,2098,262,282,287,0,,0,0.0,0.0,0.0,0.0,0.0
2024,9,6,5,2024-09-06,F9,1756,DFW,SLC,"Dallas/Fort Worth, TX",Texas,"Salt Lake City, UT",Utah,1480,1565,-18,-10,1462,1555,21,3,1483,1552,1663,204,224,228,0,,0,0.0,0.0,0.0,0.0,0.0
2024,4,27,6,2024-04-27,NK,6862,TPA,SAN,"Tampa, FL",Florida,"San Diego, CA",California,926,811,-13,-15,913,796,17,18,930,778,1912,230,250,265,0,,0,0.0,0.0,0.0,0.0,0.0
2024,3,13,3,2024-03-13,MQ,8934,LAX,DCA,"Los Angeles, CA",California,"Washington, DC",District of Columbia,1116,1085,26,20,1142,1105,18,7,1160,1098,1153,141,161,166,0,,0,5.0,4.0,3.0,0.0,8.0
2024,10,8,2,2024-10-08,MQ,9972,DFW,HNL,"Dallas/Fort Worth, TX",Texas,"Honolulu, HI",Hawaii,1076,1743,-18,-10,1058,1733,15,10,1073,1723,963,125,145,150,0,,0,0.0,0.0,0.0,0.0,0.0
2024,12,25,3,2024-12-25,F9,9642,TPA,SEA,"Tampa, FL",Florida,"Seattle, WA",Washington,1501,1490,-7,-10,1494,1480,15,14,1509,1466,1788,217,237,246,0,,0,0.0,0.0,0.0,0.0,0.0
2024,1,10,3,2024-01-10,OO,5373,PDX,MSP,"Portland, OR",Oregon,"Minneapolis, MN",Minnesota,639,2177,-9,0,630,2177,8,15,638,2162,2096,259,279,282,0,,0,0.0,0.0,0.0,0.0,0.0
2024,7,29,1,2024-07-29,YX,8910,ORD,BOS,"Chicago, IL",Illinois,"Boston, MA",Massachusetts,561,1626,-8,-10,553,1616,13,19,566,1597,1709,204,224,236,0,,0,0.0,0.0,0.0,0.0,0.0
2024,11,18,1,2024-11-18,9E,1269,ORD,SEA,"Chicago, IL",Illinois,"Seattle, WA",Washington,651,1852,43,45,694,1897,22,12,716,1885,2374,305,325,339,0,,0,8.0,5.0,3.0,0.0,29.0
2024,5,31,5,2024-05-31,DL,8543,DEN,STL,"Denver, CO",Colorado,"St. Louis, MO",Missouri,629,1852,-21,-20,608,1832,23,4,631,1828,2490,313,333,340,0,,0,0.0,0.0,0.0,0.0,0.0
2024,1,5,5,2024-01-05,G4,8273,DFW,CLT,"Dallas/Fort Worth, TX",Texas,"Charlotte, NC",North Carolina,930,1601,-3,0,927,1601,8,5,935,1596,1252,157,177,170,0,,0,0.0,0.0,0.0,0.0,0.0
2024,7,13,6,2024-07-13,UA,401,MCO,IAD,"Orlando, FL",Florida,"Washington, DC",District of Columbia,2161,1584,-4,0,2157,1584,16,5,2173,1579,2475,301,321,322,0,,0,0.0,0.0,0.0,0.0,0.0
2024,10,9,3,2024-10-09,AS,1666,HNL,CLT,"Honolulu, HI",Hawaii,"Charlotte, NC",North Carolina,1963,942,-10,0,1953,942,22,12,1975,930,1964,237,257,271,0,,0,0.0,0.0,0.0,0.0,0.0
2024,4,22,1,2024-04-22,AS,7916,DCA,MSP,"Washington, DC",District of Columbia,"Minneapolis, MN",Minnesota,1735,1764,-3,0,1732,1764,22,13,1754,1751,1723,206,226,241,0,,0,0.0,0.0,0.0,0.0,0.0
2024,9,27,5,2024-09-27,DL,2310,SLC,LGA,"Salt Lake City, UT",Utah,"New York, NY",New York,899,1680,27,30,926,1710,10,6,936,1704,895,114,134,130,0,,0,3.0,2.0,2.0,0.0,23.0
2024,6,11,2,2024-06-11,YX,7330,SAN,CLT,"San Diego, CA",California,"Charlotte, NC",North Carolina,1173,1839,5,10,1178,1849,15,6,1193,1843,2736,345,365,366,0,,0,0.0,0.0,0.0,0.0,0.0
2024,4,14,7,2024-04-14,MQ,8903,SEA,TPA,"Seattle, WA",Washington,"Tampa, FL",Florida,2240,2266,2,-5,2242,2261,9,17,2251,2244,862,99,119,125,0,,0,0.0,0.0,0.0,0.0,0.0
2024,6,29,6,2024-06-29,NK,6688,IAD,PHL,"Washington, DC",District of Columbia,"Philadelphia, PA",Pennsylvania,1040,1737,-7,0,1033,1737,20,18,1053,1719,971,118,138,156,0,,0,0.0,0.0,0.0,0.0,0.0
2024,2,13,2,2024-02-13,G4,2043,MCO,DEN,"Orlando, FL",Florida,"Denver, CO",Colorado,681,2326,-20,-20,661,2306,15,9,676,2297,2727,340,360,364,0,,0,0.0,0.0,0.0,0.0,0.0
2024,10,8,2,2024-10-08,YX,8365,LGA,PDX,"New York, NY",New York,"Portland, OR",Oregon,1574,893,4,-5,1578,888,9,3,1587,885,1495,190,210,202,0,,0,0.0,0.0,0.0,0.0,0.0
2024,6,23,7,2024-06-23,9E,4737,SEA,SLC,"Seattle, WA",Washington,"Salt Lake City, UT",Utah,2270,627,-5,-10,2265,617,13,15,2278,602,2571,327,347,355,0,,0,0.0,0.0,0.0,0.0,0.0
2024,6,10,1,2024-06-10,OO,8448,MSP,IAH,"Minneapolis, MN",Minnesota,"Houston, TX",Texas,1025,2161,6,5,1031,2166,27,19,1058,2147,1187,152,172,198,0,,0,0.0,0.0,0.0,0.0,0.0
2024,12,16,1,2024-12-16,AA,5485,SAN,MIA,"San Diego, CA",California,"Miami, FL",Florida,849,2219,-17,-10,832,2209,15,10,847,2199,2781,346,366,371,0,,0,0.0,0.0,0.0,0.0,0.0
2024,12,5,4,2024-12-05,F9,355,DCA,PHX,"Washington, DC",District of Columbia,"Phoenix, AZ",Arizona,1581,1458,3,5,1584,1463,19,8,1603,1455,2255,277,297,304,0,,0,0.0,0.0,0.0,0.0,0.0
2024,5,19,7,2024-05-19,DL,3210,MDW,DEN,"Chicago, IL",Illinois,"Denver, CO",Colorado,918,1944,-15,-5,903,1939,29,8,932,1931,2990,378,398,415,0,,0,0.0,0.0,0.0,0.0,0.0
2024,5,11,6,2024-05-11,OH,9343,ATL,SLC,"Atlanta, GA",Georgia,"Salt Lake City, UT",Utah,1660,2337,10,15,1670,2352,21,6,1691,2346,2597,329,349,356,0,,0,0.0,0.0,0.0,0.0,0.0
2024,3,27,3,2024-03-27,AA,5132,CLT,PDX,"Charlotte, NC",North Carolina,"Portland, OR",Oregon,1139,1172,-15,-5,1124,1167,22,17,1146,1150,2361,302,322,341,0,,0,0.0,0.0,0.0,0.0,0.0
2024,6,24,1,2024-06-24,F9,6361,MDW,DCA,"Chicago, IL",Illinois,"Washington, DC",District of Columbia,536,2320,19,10,555,2330,25,10,580,2320,1916,229,249,264,0,,0,0.0,0.0,0.0,0.0,0.0
2024,7,1,1,2024-07-01,DL,2517,HNL,IAD,"Honolulu, HI",Hawaii,"Washington, DC",District of Columbia,993,2136,-3,0,990,2136,18,4,1008,2132,2081,264,284,286,0,,0,0.0,0.0,0.0,0.0,0.0
2024,5,8,3,2024-05-08,AS,2356,DCA,LAX,"Washington, DC",District of Columbia,"Los Angeles, CA",California,858,1527,22,20,880,1547,11,11,891,1536,625,74,94,96,0,,0,3.0,2.0,0.0,0.0,15.0
2024,9,2,1,2024-09-02,HA,2734,CLT,LGA,"Charlotte, NC",North Carolina,"New York, NY",New York,1608,1655,13,5,1621,1660,28,14,1649,1646,322,37,57,79,0,,0,0.0,0.0,0.0,0.0,0.0
2024,3,29,5,2024-03-29,AS,1991,HNL,SLC,"Honolulu, HI",Hawaii,"Salt Lake City, UT",Utah,2245,2034,14,5,2259,2039,27,10,2286,2029,253,33,53,70,0,,0,0.0,0.0,0.0,0.0,0.0
2024,3,6,3,2024-03-06,B6,3564,DEN,SAN,"Denver, CO",Colorado,"San Diego, CA",California,1150,996,-17,-10,1133,986,20,8,1153,978,2112,254,274,282,0,,0,0.0,0.0,0.0,0.0,0.0
2024,6,6,4,2024-06-06,F9,7526,STL,DFW,"St. Louis, MO",Missouri,"Dallas/Fort Worth, TX",Texas,1038,1640,-4,0,1034,1640,13,15,1047,1625,1632,197,217,225,0,,0,0.0,0.0,0.0,0.0,0.0
2024,5,28,2,2024-05-28,UA,2070,MIA,LAS,"Miami, FL",Florida,"Las Vegas, NV",Nevada,843,1200,-3,-10,840,1190,7,4,847,1186,2345,285,305,296,0,,0,0.0,0.0,0.0,0.0,0.0
2024,12,5,4,2024-12-05,MQ,4053,PDX,IAD,"Portland, OR",Oregon,"Washington, DC",District of Columbia,1244,1675,-21,-20,1223,1655,25,11,1248,1644,1314,165,185,201,0,,0,0.0,0.0,0.0,0.0,0.0
2024,4,25,4,2024-04-25,9E,5918,SLC,DCA,"Salt Lake City, UT",Utah,"Washington, DC",District of Columbia,670,969,9,5,679,974,20,3,699,971,698,93,113,116,0,,0,0.0,0.0,0.0,0.0,0.0
2024,8,1,4,2024-08-01,HA,6871,MIA,EWR,"Miami, FL",Florida,"Newark, NJ",New Jersey,2213,763,-8,-10,2205,753,26,8,2231,745,1745,226,246,260,0,,0,0.0,0.0,0.0,0.0,0.0
2024,10,20,7,2024-10-20,WN,6848,MIA,DFW,"Miami, FL",Florida,"Dallas/Fort Worth, TX",Texas,1365,1926,4,-5,1369,1921,11,16,1380,1905,441,62,82,89,0,,0,0.0,0.0,0.0,0.0,0.0
2024,9,9,1,2024-09-09,NK,5103,SLC,DTW,"Salt Lake City, UT",Utah,"Detroit, MI",Michigan,519,1049,-3,-10,516,1039,11,8,527,1031,1164,135,155,154,0,,0,0.0,0.0,0.0,0.0,0.0
2024,5,22,3,2024-05-22,HA,748,PHX,DFW,"Phoenix, AZ",Arizona,"Dallas/Fort Worth, TX",Texas,802,1143,-9,-10,793,1133,24,13,817,1120,595,69,89,106,0,,0,0.0,0.0,0.0,0.0,0.0
2024,9,6,5,2024-09-06,NK,9932,BOS,MIA,"Boston, MA",Massachusetts,"Miami, FL",Florida,1275,1309,-11,-15,1264,1294,5,9,1269,1285,2511,308,328,322,0,,0,0.0,0.0,0.0,0.0,0.0
2024,10,28,1,2024-10-28,MQ,8820,ORD,LAS,"Chicago, IL",Illinois,"Las Vegas, NV",Nevada,1496,2125,-8,-5,1488,2120,12,6,1500,2114,543,71,91,89,0,,0,0.0,0.0,0.0,0.0,0.0
2024,1,25,4,2024-01-25,YX,2201,PHL,MIA,"Philadelphia, PA",Pennsylvania,"Miami, FL",Florida,1720,950,-15,-15,1705,935,5,6,1710,929,1992,256,276,267,0,,0,0.0,0.0,0.0,0.0,0.0
2024,10,3,4,2024-10-03,OH,518,DCA,DEN,"Washington, DC",District of Columbia,"Denver, CO",Colorado,826,978,-8,0,818,978,16,13,834,965,992,124,144,153,0,,0,0.0,0.0,0.0,0.0,0.0
2024,3,10,7,2024-03-10,F9,2452,SLC,DTW,"Salt Lake City, UT",Utah,"Detroit, MI",Michigan,1075,2062,-17,-20,1058,2042,21,17,1079,2025,374,45,65,83,0,,0,0.0,0.0,0.0,0.0,0.0
2024,4,22,1,2024-04-22,DL,5875,DFW,DCA,"Dallas/Fort Worth, TX",Texas,"Washington, DC",District of Columbia,2079,800,12,15,2091,815,29,11,2120,804,978,118,138,158,0,,0,0.0,0.0,0.0,0.0,0.0
2024,12,28,6,2024-12-28,OO,8376,TPA,ATL,"Tampa, FL",Florida,"Atlanta, GA",Georgia,2279,1730,15,20,2294,1750,14,18,2308,1732,1413,179,199,211,0,,0,7.0,3.0,0.0,0.0,10.0
2024,4,21,7,2024-04-21,YX,7791,PDX,SEA,"Portland, OR",Oregon,"Seattle, WA",Washington,1535,1104,-15,-5,1520,1099,23,14,1543,1085,2462,312,332,349,0,,0,0.0,0.0,0.0,0.0,0.0
2024,12,29,7,2024-12-29,DL,1851,LAX,MDW,"Los Angeles, CA",California,"Chicago, IL",Illinois,860,1611,-11,-10,849,1601,13,16,862,1585,239,24,44,53,0,,0,0.0,0.0,0.0,0.0,0.0
2024,10,29,2,2024-10-29,WN,2757,STL,DFW,"St. Louis, MO",Missouri,"Dallas/Fort Worth, TX",Texas,1271,2007,-24,-15,1247,1992,14,17,1261,1975,1294,163,183,194,0,,0,0.0,0.0,0.0,0.0,0.0
2024,3,31,7,2024-03-31,MQ,6223,IAD,MSP,"Washington, DC",District of Columbia,"Minneapolis, MN",Minnesota,795,1919,12,15,807,1934,15,15,822,1919,2612,333,353,363,0,,0,0.0,0.0,0.0,0.0,0.0
2024,1,18,4,2024-01-18,9E,5624,MIA,DFW,"Miami, FL",Florida,"Dallas/Fort Worth, TX",Texas,1926,1651,3,0,1929,1651,14,9,1943,1642,2391,288,308,311,0,,0,0.0,0.0,0.0,0.0,0.0
2024,5,28,2,2024-05-28,MQ,2451,PHL,SFO,"Philadelphia, PA",Pennsylvania,"San Francisco, CA",California,1961,936,-10,0,1951,936,21,6,1972,930,893,111,131,138,0,,0,0.0,0.0,0.0,0.0,0.0
2024,8,14,3,2024-08-14,G4,8171,SEA,JFK,"Seattle, WA",Washington,"New York, NY",New York,1268,886,6,10,1274,896,11,16,1285,880,1606,193,213,220,0,,0,0.0,0.0,0.0,0.0,0.0
2024,8,1,4,2024-08-01,9E,1389,SAN,LGA,"San Diego, CA",California,"New York, NY",New York,1898,1230,5,15,1903,1245,9,18,1912,1227,2975,370,390,397,0,,0,0.0,0.0,0.0,0.0,0.0
2024,12,25,3,2024-12-25,YX,2802,DFW,IAH,"Dallas/Fort Worth, TX",Texas,"Houston, TX",Texas,2270,1966,4,10,2274,1976,24,3,2298,1973,901,104,124,131,0,,0,0.0,0.0,0.0,0.0,0.0
2024,5,30,4,2024-05-30,G4,8935,MCO,TPA,"Orlando, FL",Florida,"Tampa, FL",Florida,1258,1654,12,5,1270,1659,16,11,1286,1648,555,73,93,100,0,,0,0.0,0.0,0.0,0.0,0.0
2024,7,10,3,2024-07-10,MQ,3005,TPA,IAD,"Tampa, FL",Florida,"Washington, DC",District of Columbia,1152,1265,16,10,1168,1275,9,15,1177,1260,1486,194,214,218,0,,0,0.0,0.0,0.0,0.0,0.0
2024,2,9,5,2024-02-09,MQ,4769,DFW,SEA,"Dallas/Fort Worth, TX",Texas,"Seattle, WA",Washington,1317,2110,16,10,1333,2120,5,19,1338,2101,1006,119,139,143,0,,0,0.0,0.0,0.0,0.0,0.0
2024,8,29,4,2024-08-29,WN,3022,ORD,DTW,"Chicago, IL",Illinois,"Detroit, MI",Michigan,1192,2242,-3,-5,1189,2237,14,7,1203,2230,1300,167,187,188,0,,0,0.0,0.0,0.0,0.0,0.0
2024,5,17,5,2024-05-17,G4,6754,PHX,MDW,"Phoenix, AZ",Arizona,"Chicago, IL",Illinois,999,1874,13,20,1012,1894,11,11,1023,1883,1786,222,242,244,0,,0,1.0,5.0,1.0,0.0,13.0
2024,12,10,2,2024-12-10,HA,2121,IAD,LGA,"Washington, DC",District of Columbia,"New York, NY",New York,1949,1986,10,5,1959,1991,16,3,1975,1988,1692,216,236,235,0,,0,0.0,0.0,0.0,0.0,0.0
2024,6,28,5,2024-06-28,OH,3724,PHX,LAX,"Phoenix, AZ",Arizona,"Los Angeles, CA",California,2188,706,1,-5,2189,701,6,4,2195,697,1347,172,192,182,0,,0,0.0,0.0,0.0,0.0,0.0
2024,7,18,4,2024-07-18,UA,6444,DTW,ATL,"Detroit, MI",Michigan,"Atlanta, GA",Georgia,1567,1105,2,-5,1569,1100,13,16,1582,1084,1347,177,197,206,0,,0,0.0,0.0,0.0,0.0,0.0
2024,7,21,7,2024-07-21,YX,7878,IAH,SAN,"Houston, TX",Texas,"San Diego, CA",California,1632,2065,-4,5,1628,2070,9,7,1637,2063,1902,230,250,246,0,,0,0.0,0.0,0.0,0.0,0.0
2024,3,1,5,2024-03-01,B6,236,ATL,MDW,"Atlanta, GA",Georgia,"Chicago, IL",Illinois,1621,716,-4,-5,1617,711,9,3,1626,708,916,116,136,128,0,,1,0.0,0.0,0.0,0.0,0.0
2024,7,10,3,2024-07-10,9E,4325,MDW,CLT,"Chicago, IL",Illinois,"Charlotte, NC",North Carolina,2262,1868,9,10,2271,1878,18,18,2289,1860,723,97,117,133,0,,0,0.0,0.0,0.0,0.0,0.0
2024,1,5,5,2024-01-05,G4,9510,IAH,LGA,"Houston, TX",Texas,"New York, NY",New York,1968,678,-17,-15,1951,663,23,8,1974,655,1551,199,219,230,0,,0,0.0,0.0,0.0,0.0,0.0
2024,8,24,6,2024-08-24,AS,9309,SLC,CLT,"Salt Lake City, UT",Utah,"Charlotte, NC",North Carolina,1604,1340,8,15,1612,1355,22,8,1634,1347,695,91,111,121,0,,0,0.0,0.0,0.0,0.0,0.0
2024,6,29,6,2024-06-29,UA,3240,BOS,ATL,"Boston, MA",Massachusetts,"Atlanta, GA",Georgia,1741,2109,-1,-5,1740,2104,12,5,1752,2099,1330,166,186,183,0,,0,0.0,0.0,0.0,0.0,0.0
2024,11,6,3,2024-11-06,9E,2687,JFK,HNL,"New York, NY",New York,"Honolulu, HI",Hawaii,648,622,-11,-10,637,612,29,7,666,605,1579,193,213,229,0,,0,0.0,0.0,0.0,0.0,0.0
2024,2,6,2,2024-02-06,G4,6769,EWR,SFO,"Newark, NJ",New Jersey,"San Francisco, CA",California,1446,1820,8,10,1454,1830,7,16,1461,1814,764,86,106,109,0,,0,0.0,0.0,0.0,0.0,0.0
2024,2,25,7,2024-02-25,AS,2705,MDW,DEN,"Chicago, IL",Illinois,"Denver, CO",Colorado,1599,960,-14,-10,1585,950,18,4,1603,946,1412,184,204,206,0,,0,0.0,0.0,0.0,0.0,0.0
2024,8,24,6,2024-08-24,WN,5104,IAH,SAN,"Houston, TX",Texas,"San Diego, CA",California,2115,1299,10,10,2125,1309,15,17,2140,1292,435,58,78,90,0,,0,0.0,0.0,0.0,0.0,0.0
2024,12,23,1,2024-12-23,OH,8500,STL,SEA,"St. Louis, MO",Missouri,"Seattle, WA",Washington,1063,2050,-19,-10,1044,2040,12,15,1056,2025,222,17,37,44,0,,0,0.0,0.0,0.0,0.0,0.0
2024,12,14,6,2024-12-14,WN,7604,BWI,MDW,"Baltimore, MD",Maryland,"Chicago, IL",Illinois,562,816,24,15,586,831,26,8,612,823,2217,286,306,320,0,,0,0.0,0.0,0.0,0.0,0.0
2024,7,15,1,2024-07-15,F9,3910,JFK,MSP,"New York, NY",New York,"Minneapolis, MN",Minnesota,2119,1589,-1,-10,2118,1579,16,3,2134,1576,2238,287,307,306,0,,0,0.0,0.0,0.0,0.0,0.0
2024,3,13,3,2024-03-13,NK,6180,EWR,BWI,"Newark, NJ",New Jersey,"Baltimore, MD",Maryland,893,2289,-10,-15,883,2274,15,11,898,2263,941,123,143,149,0,,0,0.0,0.0,0.0,0.0,0.0
2024,2,28,3,2024-02-28,AA,7508,SFO,TPA,"San Francisco, CA",California,"Tampa, FL",Florida,2026,1306,10,15,2036,1321,13,13,2049,1308,484,50,70,76,0,,0,0.0,0.0,0.0,0.0,0.0
2024,8,27,2,2024-08-27,AS,4253,BOS,SEA,"Boston, MA",Massachusetts,"Seattle, WA",Washington,1890,1227,-13,-10,1877,1217,8,18,1885,1199,2911,358,378,384,0,,0,0.0,0.0,0.0,0.0,0.0
2024,1,2,2,2024-01-02,F9,3476,PHX,LAS,"Phoenix, AZ",Arizona,"Las Vegas, NV",Nevada,2001,1819,22,15,2023,1834,23,16,2046,1818,1047,126,146,165,0,,0,0.0,0.0,0.0,0.0,0.0
2024,12,25,3,2024-12-25,UA,1468,ATL,DTW,"Atlanta, GA",Georgia,"Detroit, MI",Michigan,1778,1166,10,10,1788,1176,11,12,1799,1164,392,52,72,75,0,,0,0.0,0.0,0.0,0.0,0.0
2024,7,6,6,2024-07-06,OH,7909,LAS,EWR,"Las Vegas, NV",Nevada,"Newark, NJ",New Jersey,558,2310,-22,-15,536,2295,21,10,557,2285,1082,125,145,156,0,,0,0.0,0.0,0.0,0.0,0.0
2024,11,2,6,2024-11-02,G4,3900,ATL,SAN,"Atlanta, GA",Georgia,"San Diego, CA",California,1019,1042,-12,-5,1007,1037,20,18,1027,1019,1125,144,164,182,0,,0,0.0,0.0,0.0,0.0,0.0
2024,1,30,2,2024-01-30,9E,1137,BOS,TPA,"Boston, MA",Massachusetts,"Tampa, FL",Florida,1318,2082,-16,-15,1302,2067,23,14,1325,2053,2283,290,310,327,0,,0,0.0,0.0,0.0,0.0,0.0
2024,9,23,1,2024-09-23,DL,1092,STL,IAD,"St. Louis, MO",Missouri,"Washington, DC",District of Columbia,888,1058,0,-5,888,1053,27,8,915,1045,1777,216,236,251,0,,0,0.0,0.0,0.0,0.0,0.0
2024,4,17,3,2024-04-17,OH,7412,PHX,MIA,"Phoenix, AZ",Arizona,"Miami, FL",Florida,1087,2107,-13,-5,1074,2102,16,5,1090,2097,945,112,132,133,0,,0,0.0,0.0,0.0,0.0,0.0
2024,11,27,3,2024-11-27,AS,4610,LAX,PHX,"Los Angeles, CA",California,"Phoenix, AZ",Arizona,1949,743,1,0,1950,743,11,8,1961,735,2631,336,356,355,0,,0,0.0,0.0,0.0,0.0,0.0
2024,3,30,6,2024-03-30,YX,493,SEA,STL,"Seattle, WA",Washington,"St. Louis, MO",Missouri,1513,913,26,20,1539,933,29,8,1568,925,2670,333,353,370,0,,0,3.0,5.0,2.0,0.0,10.0
2024,7,23,2,2024-07-23,AA,8105,SAN,HNL,"San Diego, CA",California,"Honolulu, HI",Hawaii,2113,1474,-16,-10,2097,1464,18,5,2115,1459,2407,290,310,313,0,,0,0.0,0.0,0.0,0.0,0.0
2024,8,7,3,2024-08-07,YX,3786,HNL,PDX,"Honolulu, HI",Hawaii,"Portland, OR",Oregon,1135,1328,-13,-5,1122,1323,29,14,1151,1309,897,116,136,159,0,,0,0.0,0.0,0.0,0.0,0.0
2024,4,3,3,2024-04-03,OO,457,DFW,SAN,"Dallas/Fort Worth, TX",Texas,"San Diego, CA",California,2025,1880,5,0,2030,1880,15,13,2045,1867,964,128,148,156,0,,0,0.0,0.0,0.0,0.0,0.0
2024,4,12,5,2024-04-12,HA,4104,SLC,SAN,"Salt Lake City, UT",Utah,"San Diego, CA",California,1023,1238,-2,-10,1021,1228,15,8,1036,1220,465,55,75,78,0,,0,0.0,0.0,0.0,0.0,0.0
2024,8,10,6,2024-08-10,DL,1281,BWI,LGA,"Baltimore, MD",Maryland,"New York, NY",New York,779,1073,-2,5,777,1078,11,10,788,1068,2304,287,307,308,0,,0,0.0,0.0,0.0,0.0,0.0
2024,7,4,4,2024-07-04,MQ,6917,SFO,SEA,"San Francisco, CA",California,"Seattle, WA",Washington,1568,1284,-7,-5,1561,1279,15,18,1576,1261,1044,134,154,167,0,,0,0.0,0.0,0.0,0.0,0.0
2024,7,2,2,2024-07-02,B6,2165,PDX,IAH,"Portland, OR",Oregon,"Houston, TX",Texas,1064,1205,8,15,1072,1220,7,14,1079,1206,2326,298,318,319,0,,0,0.0,0.0,0.0,0.0,0.0
2024,6,10,1,2024-06-10,AA,6971,PHX,DEN,"Phoenix, AZ",Arizona,"Denver, CO",Colorado,1704,2122,-1,0,1703,2122,19,17,1722,2105,2629,326,346,362,0,,0,0.0,0.0,0.0,0.0,0.0
2024,9,3,2,2024-09-03,F9,3229,DEN,TPA,"Denver, CO",Colorado,"Tampa, FL",Florida,1924,1501,1,-5,1925,1496,7,9,1932,1487,2277,281,301,297,0,,0,0.0,0.0,0.0,0.0,0.0
2024,1,31,3,2024-01-31,AA,254,BOS,LAS,"Boston, MA",Massachusetts,"Las Vegas, NV",Nevada,1897,1842,10,5,1907,1847,25,14,1932,1833,1020,121,141,160,0,,0,0.0,0.0,0.0,0.0,0.0
2024,2,21,3,2024-02-21,MQ,9846,DTW,TPA,"Detroit, MI",Michigan,"Tampa, FL",Florida,733,2187,6,10,739,2197,13,15,752,2182,1812,228,248,256,0,,0,0.0,0.0,0.0,0.0,0.0
2024,12,10,2,2024-12-10,G4,8778,LAX,MDW,"Los Angeles, CA",California,"Chicago, IL",Illinois,685,2154,14,10,699,2164,21,19,720,2145,1911,238,258,278,0,,0,0.0,0.0,0.0,0.0,0.0
2024,3,16,6,2024-03-16,9E,6394,IAD,DCA,"Washington, DC",District of Columbia,"Washington, DC",District of Columbia,1304,1981,-3,-10,1301,1971,21,15,1322,1956,2841,355,375,391,0,,0,0.0,0.0,0.0,0.0,0.0
2024,10,4,5,2024-10-04,OO,9674,PHX,LAX,"Phoenix, AZ",Arizona,"Los Angeles, CA",California,574,1860,-10,-5,564,1855,29,19,593,1836,1518,192,212,240,0,,0,0.0,0.0,0.0,0.0,0.0
2024,2,9,5,2024-02-09,UA,2515,CLT,SEA,"Charlotte, NC",North Carolina,"Seattle, WA",Washington,1437,2306,4,0,1441,2306,16,13,1457,2293,2131,256,276,285,0,,0,0.0,0.0,0.0,0.0,0.0
2024,4,10,3,2024-04-10,YX,1170,MCO,JFK,"Orlando, FL",Florida,"New York, NY",New York,1209,874,-5,-5,1204,869,11,3,1215,866,2425,310,330,324,0,,0,0.0,0.0,0.0,0.0,0.0
2024,4,20,6,2024-04-20,DL,2354,DEN,STL,"Denver, CO",Colorado,"St. Louis, MO",Missouri,2114,2295,4,-5,2118,2290,15,13,2133,2277,592,76,96,104,0,,0,0.0,0.0,0.0,0.0,0.0
2024,11,16,6,2024-11-16,HA,8142,SAN,IAD,"San Diego, CA",California,"Washington, DC",District of Columbia,732,1351,-1,5,731,1356,18,14,749,1342,2680,343,363,375,0,,0,0.0,0.0,0.0,0.0,0.0
2024,9,5,4,2024-09-05,AA,9798,MCO,SLC,"Orlando, FL",Florida,"Salt Lake City, UT",Utah,1691,2200,-15,-20,1676,2180,24,5,1700,2175,843,98,118,127,0,,0,0.0,0.0,0.0,0.0,0.0
2024,7,9,2,2024-07-09,G4,7907,IAH,DFW,"Houston, TX",Texas,"Dallas/Fort Worth, TX",Texas,1034,816,-9,-10,1025,806,5,9,1030,797,2244,270,290,284,0,,0,0.0,0.0,0.0,0.0,0.0
2024,6,30,7,2024-06-30,HA,6940,DFW,ORD,"Dallas/Fort Worth, TX",Texas,"Chicago, IL",Illinois,1930,2182,-22,-15,1908,2167,10,8,1918,2159,2466,313,333,331,1,,0,0.0,0.0,0.0,0.0,0.0
2024,11,30,6,2024-11-30,WN,6813,HNL,LGA,"Honolulu, HI",Hawaii,"New York, NY",New York,1753,2020,-24,-15,1729,2005,29,5,1758,2000,1827,221,241,255,0,,0,0.0,0.0,0.0,0.0,0.0
2024,7,27,6,2024-07-27,YX,2290,SLC,HNL,"Salt Lake City, UT",Utah,"Honolulu, HI",Hawaii,1395,1697,-5,-10,1390,1687,26,11,1416,1676,223,23,43,60,0,,0,0.0,0.0,0.0,0.0,0.0
2024,1,22,1,2024-01-22,AA,7364,BWI,SAN,"Baltimore, MD",Maryland,"San Diego, CA",California,1471,1275,2,5,1473,1280,25,14,1498,1266,2244,279,299,318,0,,0,0.0,0.0,0.0,0.0,0.0
2024,6,14,5,2024-06-14,AA,9362,ATL,DFW,"Atlanta, GA",Georgia,"Dallas/Fort Worth, TX",Texas,1146,1309,26,20,1172,1329,21,3,1193,1326,2827,344,364,368,0,,0,7.0,0.0,0.0,0.0,13.0
2024,4,8,1,2024-04-08,NK,8482,MDW,SFO,"Chicago, IL",Illinois,"San Francisco, CA",California,792,1522,-2,0,790,1522,29,18,819,1504,2501,307,327,354,0,,0,0.0,0.0,0.0,0.0,0.0
2024,7,26,5,2024-07-26,DL,8431,BWI,TPA,"Baltimore, MD",Maryland,"Tampa, FL",Florida,1923,1951,-10,-5,1913,1946,13,19,1926,1927,1915,237,257,269,0,,0,0.0,0.0,0.0,0.0,0.0
2024,1,8,1,2024-01-08,NK,7498,TPA,ATL,"Tampa, FL",Florida,"Atlanta, GA",Georgia,537,1007,3,10,540,1017,5,15,545,1002,2139,263,283,283,0,,0,0.0,0.0,0.0,0.0,0.0
2024,7,8,1,2024-07-08,YX,3072,HNL,MSP,"Honolulu, HI",Hawaii,"Minneapolis, MN",Minnesota,1755,747,-13,-15,1742,732,16,14,1758,718,1542,188,208,218,0,,0,0.0,0.0,0.0,0.0,0.0
2024,6,23,7,2024-06-23,HA,1614,LAX,MSP,"Los Angeles, CA",California,"Minneapolis, MN",Minnesota,667,1709,-12,-15,655,1694,24,17,679,1677,932,124,144,165,0,,0,0.0,0.0,0.0,0.0,0.0
2024,9,29,7,2024-09-29,NK,4070,DFW,LGA,"Dallas/Fort Worth, TX",Texas,"New York, NY",New York,1808,2144,-4,-5,1804,2139,21,10,1825,2129,1674,205,225,236,0,,0,0.0,0.0,0.0,0.0,0.0
2024,1,17,3,2024-01-17,HA,4819,DEN,HNL,"Denver, CO",Colorado,"Honolulu, HI",Hawaii,602,1102,-13,-5,589,1097,8,6,597,1091,2906,368,388,382,0,,0,0.0,0.0,0.0,0.0,0.0
2024,3,30,6,2024-03-30,9E,1445,STL,ORD,"St. Louis, MO",Missouri,"Chicago, IL",Illinois,644,831,9,5,653,836,27,16,680,820,2396,306,326,349,0,,0,0.0,0.0,0.0,0.0,0.0
2024,5,20,1,2024-05-20,OH,2017,MDW,STL,"Chicago, IL",Illinois,"St. Louis, MO",Missouri,1254,1097,19,15,1273,1112,12,5,1285,1107,2671,329,349,346,0,,0,0.0,0.0,0.0,0.0,0.0
2024,5,24,5,2024-05-24,G4,7741,DCA,MIA,"Washington, DC",District of Columbia,"Miami, FL",Florida,1159,1022,4,0,1163,1022,23,8,1186,1014,1500,192,212,223,0,,0,0.0,0.0,0.0,0.0,0.0
2024,6,14,5,2024-06-14,MQ,8744,IAD,PHL,"Washington, DC",District of Columbia,"Philadelphia, PA",Pennsylvania,865,2090,4,0,869,2090,23,8,892,2082,1563,201,221,232,0,,0,0.0,0.0,0.0,0.0,0.0
2024,12,2,1,2024-12-02,NK,1711,LGA,DTW,"New York, NY",New York,"Detroit, MI",Michigan,652,846,-13,-10,639,836,9,18,648,818,967,110,130,137,0,,0,0.0,0.0,0.0,0.0,0.0
2024,3,18,1,2024-03-18,MQ,2178,BOS,EWR,"Boston, MA",Massachusetts,"Newark, NJ",New Jersey,1327,1993,6,0,1333,1993,15,10,1348,1983,1534,192,212,217,0,,0,0.0,0.0,0.0,0.0,0.0
2024,9,18,3,2024-09-18,OH,2164,LGA,SEA,"New York, NY",New York,"Seattle, WA",Washington,921,2136,18,15,939,2151,10,3,949,2148,1744,209,229,222,0,,0,0.0,0.0,0.0,0.0,0.0
2024,6,11,2,2024-06-11,AA,7479,MSP,TPA,"Minneapolis, MN",Minnesota,"Tampa, FL",Florida,818,704,-10,-5,808,699,17,13,825,686,2297,285,305,315,0,,0,0.0,0.0,0.0,0.0,0.0
2024,1,14,7,2024-01-14,YX,5879,HNL,IAD,"Honolulu, HI",Hawaii,"Washington, DC",District of Columbia,2161,833,-4,-10,2157,823,23,14,2180,809,2854,364,384,401,0,,0,0.0,0.0,0.0,0.0,0.0
2024,8,26,1,2024-08-26,MQ,9550,DCA,ORD,"Washington, DC",District of Columbia,"Chicago, IL",Illinois,2227,2081,-14,-5,2213,2076,10,13,2223,2063,231,18,38,41,0,,0,0.0,0.0,0.0,0.0,0.0
2024,3,12,2,2024-03-12,F9,7250,IAH,DCA,"Houston, TX",Texas,"Washington, DC",District of Columbia,984,1880,0,0,984,1880,27,15,1011,1865,1264,159,179,201,0,,0,0.0,0.0,0.0,0.0,0.0
2024,5,22,3,2024-05-22,F9,453,SFO,SLC,"San Francisco, CA",California,"Salt Lake City, UT",Utah,582,1074,5,0,587,1074,17,12,604,1062,1950,246,266,275,0,,0,0.0,0.0,0.0,0.0,0.0
2024,11,5,2,2024-11-05,WN,5818,LAX,LGA,"Los Angeles, CA",California,"New York, NY",New York,2056,2216,3,-5,2059,2211,10,16,2069,2195,2140,269,289,295,0,,0,0.0,0.0,0.0,0.0,0.0
2024,10,9,3,2024-10-09,MQ,3736,ATL,MIA,"Atlanta, GA",Georgia,"Miami, FL",Florida,1811,2258,11,5,1822,2263,20,9,1842,2254,1299,161,181,190,0,,0,0.0,0.0,0.0,0.0,0.0
2024,9,25,3,2024-09-25,F9,9855,LGA,SEA,"New York, NY",New York,"Seattle, WA",Washington,2012,1603,-5,0,2007,1603,26,16,2033,1587,2845,345,365,387,0,,0,0.0,0.0,0.0,0.0,0.0
2024,8,28,3,2024-08-28,WN,6144,LAX,JFK,"Los Angeles, CA",California,"New York, NY",New York,1791,1795,8,5,1799,1800,22,3,1821,1797,678,82,102,107,0,,0,0.0,0.0,0.0,0.0,0.0
2024,9,1,7,2024-09-01,HA,811,DFW,DCA,"Dallas/Fort Worth, TX",Texas,"Washington, DC",District of Columbia,2156,1896,12,10,2168,1906,15,9,2183,1897,815,105,125,129,0,,0,0.0,0.0,0.0,0.0,0.0
2024,6,11,2,2024-06-11,F9,9148,HNL,SFO,"Honolulu, HI",Hawaii,"San Francisco, CA",California,2146,1358,6,10,2152,1368,24,6,2176,1362,1649,211,231,241,0,,0,0.0,0.0,0.0,0.0,0.0
2024,2,29,4,2024-02-29,B6,4372,DTW,DCA,"Detroit, MI",Michigan,"Washington, DC",District of Columbia,578,1474,-8,-10,570,1464,21,7,591,1457,2915,365,385,393,0,,0,0.0,0.0,0.0,0.0,0.0
2024,1,6,6,2024-01-06,WN,1529,LAS,BWI,"Las Vegas, NV",Nevada,"Baltimore, MD",Maryland,1899,1817,-5,0,1894,1817,14,14,1908,1803,1164,152,172,180,0,,0,0.0,0.0,0.0,0.0,0.0
2024,7,15,1,2024-07-15,AS,6544,DTW,EWR,"Detroit, MI",Michigan,"Newark, NJ",New Jersey,2120,711,-4,5,2116,716,20,19,2136,697,635,72,92,111,0,,0,0.0,0.0,0.0,0.0,0.0
2024,2,27,2,2024-02-27,DL,3520,SAN,IAD,"San Diego, CA",California,"Washington, DC",District of Columbia,2115,622,-21,-15,2094,607,9,8,2103,599,290,40,60,57,0,,0,0.0,0.0,0.0,0.0,0.0
2024,10,31,4,2024-10-31,YX,2168,EWR,SAN,"Newark, NJ",New Jersey,"San Diego, CA",California,650,1536,11,10,661,1546,14,18,675,1528,1188,153,173,185,0,,0,0.0,0.0,0.0,0.0,0.0
2024,8,4,7,2024-08-04,DL,7259,SLC,DFW,"Salt Lake City, UT",Utah,"Dallas/Fort Worth, TX",Texas,1255,914,-6,-10,1249,904,7,3,1256,901,2071,260,280,270,0,,0,0.0,0.0,0.0,0.0,0.0
2024,1,26,5,2024-01-26,DL,4906,SLC,SAN,"Salt Lake City, UT",Utah,"San Diego, CA",California,1229,801,0,5,1229,806,23,14,1252,792,383,55,75,92,0,,0,0.0,0.0,0.0,0.0,0.0
2024,10,29,2,2024-10-29,G4,6944,SFO,IAH,"San Francisco, CA",California,"Houston, TX",Texas,514,2124,-20,-10,494,2114,8,16,502,2098,207,26,46,50,0,,0,0.0,0.0,0.0,0.0,0.0
2024,1,5,5,2024-01-05,HA,8443,DCA,LAX,"Washington, DC",District of Columbia,"Los Angeles, CA",California,600,1217,5,5,605,1222,16,8,621,1214,1426,177,197,201,0,,0,0.0,0.0,0.0,0.0,0.0
2024,1,20,6,2024-01-20,OH,3331,SEA,DCA,"Seattle, WA",Washington,"Washington, DC",District of Columbia,1279,1205,-14,-15,1265,1190,29,11,1294,1179,2057,249,269,289,0,,0,0.0,0.0,0.0,0.0,0.0
2024,7,16,2,2024-07-16,9E,3006,MIA,STL,"Miami, FL",Florida,"St. Louis, MO",Missouri,1911,1594,-13,-5,1898,1589,26,5,1924,1584,1224,155,175,186,0,,0,0.0,0.0,0.0,0.0,0.0
2024,2,28,3,2024-02-28,UA,3651,ATL,STL,"Atlanta, GA",Georgia,"St. Louis, MO",Missouri,1558,624,-7,-15,1551,609,14,13,1565,596,2587,324,344,351,0,,0,0.0,0.0,0.0,0.0,0.0
2024,8,29,4,2024-08-29,HA,9758,TPA,SEA,"Tampa, FL",Florida,"Seattle, WA",Washington,850,1256,-8,-10,842,1246,15,14,857,1232,2214,275,295,304,0,,0,0.0,0.0,0.0,0.0,0.0
2024,5,25,6,2024-05-25,9E,4291,DFW,ATL,"Dallas/Fort Worth, TX",Texas,"Atlanta, GA",Georgia,1456,2131,30,30,1486,2161,12,3,1498,2158,2937,371,391,386,0,,0,8.0,6.0,1.0,0.0,15.0
2024,9,29,7,2024-09-29,WN,3523,SEA,SLC,"Seattle, WA",Washington,"Salt Lake City, UT",Utah,782,1989,-19,-15,763,1974,16,19,779,1955,791,104,124,139,0,,0,0.0,0.0,0.0,0.0,0.0
2024,9,5,4,2024-09-05,9E,4157,MCO,TPA,"Orlando, FL",Florida,"Tampa, FL",Florida,1136,1130,-4,-5,1132,1125,18,15,1150,1110,2682,329,349,362,0,,0,0.0,0.0,0.0,0.0,0.0
2024,1,14,7,2024-01-14,YX,5294,ORD,DTW,"Chicago, IL",Illinois,"Detroit, MI",Michigan,2259,2345,12,5,2271,2350,25,3,2296,2347,1015,119,139,147,0,,0,0.0,0.0,0.0,0.0,0.0
2024,1,13,6,2024-01-13,F9,3765,SFO,TPA,"San Francisco, CA",California,"Tampa, FL",Florida,2196,2217,-10,-15,2186,2202,26,4,2212,2198,2186,275,295,305,0,,0,0.0,0.0,0.0,0.0,0.0
2024,2,13,2,2024-02-13,WN,4835,LAX,EWR,"Los Angeles, CA",California,"Newark, NJ",New Jersey,1024,645,-18,-15,1006,630,7,15,1013,615,494,64,84,86,0,,0,0.0,0.0,0.0,0.0,0.0
2024,1,19,5,2024-01-19,OO,9448,DFW,IAD,"Dallas/Fort Worth, TX",Texas,"Washington, DC",District of Columbia,664,1658,-13,-15,651,1643,15,10,666,1633,1037,134,154,159,0,,0,0.0,0.0,0.0,0.0,0.0
2024,3,3,7,2024-03-03,9E,6489,SEA,JFK,"Seattle, WA",Washington,"New York, NY",New York,927,801,6,0,933,801,11,4,944,797,1132,133,153,148,0,,0,0.0,0.0,0.0,0.0,0.0
2024,8,26,1,2024-08-26,9E,7982,SEA,TPA,"Seattle, WA",Washington,"Tampa, FL",Florida,1781,2158,8,15,1789,2173,19,6,1808,2167,1771,217,237,242,0,,0,0.0,0.0,0.0,0.0,0.0
2024,12,2,1,2024-12-02,MQ,5389,STL,MCO,"St. Louis, MO",Missouri,"Orlando, FL",Florida,1433,964,8,10,1441,974,15,10,1456,964,1299,167,187,192,0,,0,0.0,0.0,0.0,0.0,0.0
2024,4,9,2,2024-04-09,NK,7898,PHL,EWR,"Philadelphia, PA",Pennsylvania,"Newark, NJ",New Jersey,942,1069,28,30,970,1099,29,3,999,1096,2833,348,368,380,0,,0,0.0,5.0,0.0,0.0,25.0
2024,6,11,2,2024-06-11,B6,3508,LAS,IAD,"Las Vegas, NV",Nevada,"Washington, DC",District of Columbia,1125,1923,-1,0,1124,1923,29,13,1153,1910,1214,151,171,193,0,,0,0.0,0.0,0.0,0.0,0.0
2024,5,1,3,2024-05-01,G4,1261,ATL,LAX,"Atlanta, GA",Georgia,"Los Angeles, CA",California,1643,1376,20,20,1663,1396,11,10,1674,1386,2734,337,357,358,0,,0,1.0,0.0,2.0,0.0,17.0
2024,2,13,2,2024-02-13,WN,1359,DFW,PDX,"Dallas/Fort Worth, TX",Texas,"Portland, OR",Oregon,568,1015,-15,-5,553,1010,23,15,576,995,2624,329,349,367,0,,0,0.0,0.0,0.0,0.0,0.0
2024,12,25,3,2024-12-25,UA,4190,MIA,DEN,"Miami, FL",Florida,"Denver, CO",Colorado,773,1969,1,-5,774,1964,20,18,794,1946,1903,236,256,274,0,,0,0.0,0.0,0.0,0.0,0.0
2024,11,12,2,2024-11-12,MQ,5790,EWR,PDX,"Newark, NJ",New Jersey,"Portland, OR",Oregon,1059,1972,-9,-5,1050,1967,25,10,1075,1957,1716,217,237,252,0,,0,0.0,0.0,0.0,0.0,0.0
2024,5,24,5,2024-05-24,DL,3081,SLC,BOS,"Salt Lake City, UT",Utah,"Boston, MA",Massachusetts,1348,1298,-20,-20,1328,1278,29,5,1357,1273,2326,298,318,332,0,,0,0.0,0.0,0.0,0.0,0.0
2024,11,22,5,2024-11-22,AA,8165,DCA,CLT,"Washington, DC",District of Columbia,"Charlotte, NC",North Carolina,1845,1409,12,10,1857,1419,29,11,1886,1408,1896,236,256,276,0,,0,0.0,0.0,0.0,0.0,0.0
2024,12,28,6,2024-12-28,OO,3654,CLT,IAD,"Charlotte, NC",North Carolina,"Washington, DC",District of Columbia,1885,789,-25,-20,1860,769,23,12,1883,757,393,54,74,89,0,,0,0.0,0.0,0.0,0.0,0.0
2024,2,19,1,2024-02-19,AS,9516,LGA,PHX,"New York, NY",New York,"Phoenix, AZ",Arizona,1069,2026,2,5,1071,2031,17,12,1088,2019,1762,213,233,242,0,,0,0.0,0.0,0.0,0.0,0.0
2024,3,5,2,2024-03-05,9E,2489,DEN,DFW,"Denver, CO",Colorado,"Dallas/Fort Worth, TX",Texas,1089,948,-6,-5,1083,943,25,19,1108,924,2591,318,338,362,0,,0,0.0,0.0,0.0,0.0,0.0
2024,12,20,5,2024-12-20,DL,8258,SLC,SAN,"Salt Lake City, UT",Utah,"San Diego, CA",California,998,972,-17,-20,981,952,21,5,1002,947,1338,162,182,188,0,,0,0.0,0.0,0.0,0.0,0.0
2024,10,14,1,2024-10-14,F9,1114,LAX,MSP,"Los Angeles, CA",California,"Minneapolis, MN",Minnesota,703,2262,-9,-10,694,2252,18,12,712,2240,1166,153,173,183,0,,0,0.0,0.0,0.0,0.0,0.0
2024,6,12,3,2024-06-12,AS,5829,MIA,PHX,"Miami, FL",Florida,"Phoenix, AZ",Arizona,2260,2128,-5,-5,2255,2123,27,17,2282,2106,1249,163,183,207,0,,0,0.0,0.0,0.0,0.0,0.0
2024,5,20,1,2024-05-20,YX,3813,MCO,SEA,"Orlando, FL",Florida,"Seattle, WA",Washington,1274,1914,16,20,1290,1934,6,11,1296,1923,452,48,68,65,0,,0,5.0,1.0,2.0,0.0,12.0
2024,11,9,6,2024-11-09,YX,1592,EWR,ORD,"Newark, NJ",New Jersey,"Chicago, IL",Illinois,2029,1584,7,5,2036,1589,26,14,2062,1575,2397,296,316,336,0,,0,0.0,0.0,0.0,0.0,0.0
2024,5,7,2,2024-05-07,B6,7685,PDX,SAN,"Portland, OR",Oregon,"San Diego, CA",California,2138,1586,-9,0,2129,1586,14,18,2143,1568,2697,343,363,375,0,,0,0.0,0.0,0.0,0.0,0.0
2024,8,26,1,2024-08-26,MQ,4222,DTW,STL,"Detroit, MI",Michigan,"St. Louis, MO",Missouri,1632,710,-23,-15,1609,695,10,17,1619,678,599,66,86,93,0,,0,0.0,0.0,0.0,0.0,0.0
2024,11,19,2,2024-11-19,DL,9992,BOS,ORD,"Boston, MA",Massachusetts,"Chicago, IL",Illinois,1788,2178,-15,-5,1773,2173,20,4,1793,2169,2135,261,281,285,0,,0,0.0,0.0,0.0,0.0,0.0
2024,10,22,2,2024-10-22,NK,554,EWR,ATL,"Newark, NJ",New Jersey,"Atlanta, GA",Georgia,887,2126,-25,-20,862,2106,11,9,873,2097,1472,186,206,206,0,,0,0.0,0.0,0.0,0.0,0.0
2024,7,5,5,2024-07-05,DL,1017,PHL,MIA,"Philadelphia, PA",Pennsylvania,"Miami, FL",Florida,915,1924,-5,5,910,1929,23,11,933,1918,2590,332,352,366,0,,0,0.0,0.0,0.0,0.0,0.0
2024,7,26,5,2024-07-26,MQ,6823,MIA,LAX,"Miami, FL",Florida,"Los Angeles, CA",California,1400,1245,-19,-10,1381,1235,28,16,1409,1219,1493,191,211,235,0,,0,0.0,0.0,0.0,0.0,0.0
2024,8,7,3,2024-08-07,OH,8305,ATL,TPA,"Atlanta, GA",Georgia,"Tampa, FL",Florida,2091,1636,-1,0,2090,1636,25,4,2115,1632,1488,188,208,217,0,,0,0.0,0.0,0.0,0.0,0.0
2024,7,8,1,2024-07-08,B6,6341,IAH,PHX,"Houston, TX",Texas,"Phoenix, AZ",Arizona,811,1122,6,5,817,1127,14,12,831,1115,239,29,49,55,0,,0,0.0,0.0,0.0,0.0,0.0
2024,12,11,3,2024-12-11,DL,4474,DCA,DFW,"Washington, DC",District of Columbia,"Dallas/Fort Worth, TX",Texas,751,1725,-11,-5,740,1720,24,9,764,1711,1574,193,213,226,0,,0,0.0,0.0,0.0,0.0,0.0
2024,10,10,4,2024-10-10,OO,6159,LAX,PHL,"Los Angeles, CA",California,"Philadelphia, PA",Pennsylvania,2107,796,-2,0,2105,796,19,10,2124,786,2062,250,270,279,0,,0,0.0,0.0,0.0,0.0,0.0
2024,12,17,2,2024-12-17,9E,589,SLC,LAX,"Salt Lake City, UT",Utah,"Los Angeles, CA",California,2176,2014,6,5,2182,2019,16,8,2198,2011,2625,337,357,361,0,,0,0.0,0.0,0.0,0.0,0.0
2024,8,24,6,2024-08-24,OO,1084,MSP,PHL,"Minneapolis, MN",Minnesota,"Philadelphia, PA",Pennsylvania,1911,654,-13,-10,1898,644,29,8,1927,636,2804,350,370,387,0,,0,0.0,0.0,0.0,0.0,0.0
2024,7,12,5,2024-07-12,OO,1060,DEN,CLT,"Denver, CO",Colorado,"Charlotte, NC",North Carolina,2215,782,-1,0,2214,782,13,17,2227,765,1180,149,169,179,0,,0,0.0,0.0,0.0,0.0,0.0
2024,10,13,7,2024-10-13,DL,8150,MDW,STL,"Chicago, IL",Illinois,"St. Louis, MO",Missouri,702,1642,8,5,710,1647,22,15,732,1632,612,79,99,116,0,,0,0.0,0.0,0.0,0.0,0.0
2024,9,15,7,2024-09-15,HA,1882,HNL,LGA,"Honolulu, HI",Hawaii,"New York, NY",New York,609,962,4,-5,613,957,21,12,634,945,1871,241,261,274,0,,0,0.0,0.0,0.0,0.0,0.0
2024,9,2,1,2024-09-02,NK,6083,LGA,LAX,"New York, NY",New York,"Los Angeles, CA",California,581,1072,-6,-10,575,1062,23,15,598,1047,2448,297,317,335,0,,0,0.0,0.0,0.0,0.0,0.0
2024,5,15,3,2024-05-15,G4,1969,JFK,IAD,"New York, NY",New York,"Washington, DC",District of Columbia,2119,608,-13,-10,2106,598,14,3,2120,595,897,120,140,137,0,,0,0.0,0.0,0.0,0.0,0.0
2024,10,6,7,2024-10-06,B6,2744,DCA,SEA,"Washington, DC",District of Columbia,"Seattle, WA",Washington,1268,1259,13,15,1281,1274,12,18,1293,1256,1242,160,180,190,0,,0,0.0,0.0,0.0,0.0,0.0
2024,9,27,5,2024-09-27,NK,6938,STL,SEA,"St. Louis, MO",Missouri,"Seattle, WA",Washington,692,624,-11,-5,681,619,24,8,705,611,2730,340,360,372,0,,0,0.0,0.0,0.0,0.0,0.0
2024,6,19,3,2024-06-19,WN,4445,ORD,DTW,"Chicago, IL",Illinois,"Detroit, MI",Michigan,638,1929,-25,-15,613,1914,9,4,622,1910,2879,359,379,372,0,,0,0.0,0.0,0.0,0.0,0.0
2024,6,7,5,2024-06-07,DL,5802,EWR,LAS,"Newark, NJ",New Jersey,"Las Vegas, NV",Nevada,720,2207,-15,-15,705,2192,17,12,722,2180,1762,226,246,255,0,,0,0.0,0.0,0.0,0.0,0.0
2024,7,19,5,2024-07-19,UA,8175,MSP,SFO,"Minneapolis, MN",Minnesota,"San Francisco, CA",California,1712,2057,-17,-10,1695,2047,25,4,1720,2043,1948,251,271,280,0,,0,0.0,0.0,0.0,0.0,0.0
2024,2,14,3,2024-02-14,DL,7730,SLC,DCA,"Salt Lake City, UT",Utah,"Washington, DC",District of Columbia,1360,2045,-20,-15,1340,2030,6,5,1346,2025,2206,281,301,292,0,,0,0.0,0.0,0.0,0.0,0.0
2024,9,20,5,2024-09-20,B6,6002,TPA,MCO,"Tampa, FL",Florida,"Orlando, FL",Florida,839,1680,6,0,845,1680,5,6,850,1674,1429,181,201,192,0,,0,0.0,0.0,0.0,0.0,0.0
2024,3,11,1,2024-03-11,AS,6132,IAH,MSP,"Houston, TX",Texas,"Minneapolis, MN",Minnesota,977,2157,-12,-5,965,2152,12,11,977,2141,2451,310,330,333,0,,0,0.0,0.0,0.0,0.0,0.0
2024,12,29,7,2024-12-29,HA,1925,LGA,IAD,"New York, NY",New York,"Washington, DC",District of Columbia,1458,1423,4,10,1462,1433,14,13,1476,1420,2883,355,375,382,0,,0,0.0,0.0,0.0,0.0,0.0
2024,4,12,5,2024-04-12,HA,3210,DFW,SEA,"Dallas/Fort Worth, TX",Texas,"Seattle, WA",Washington,1945,2171,13,10,1958,2181,9,17,1967,2164,637,78,98,104,0,,0,0.0,0.0,0.0,0.0,0.0
2024,5,4,6,2024-05-04,NK,3870,LGA,DEN,"New York, NY",New York,"Denver, CO",Colorado,1720,1802,7,0,1727,1802,22,16,1749,1786,2304,284,304,322,0,,0,0.0,0.0,0.0,0.0,0.0
2024,11,8,5,2024-11-08,UA,129,DTW,MIA,"Detroit, MI",Michigan,"Miami, FL",Florida,1312,667,2,10,1314,677,27,15,1341,662,1484,192,212,234,0,,0,0.0,0.0,0.0,0.0,0.0
2024,10,12,6,2024-10-12,WN,9058,MCO,TPA,"Orlando, FL",Florida,"Tampa, FL",Florida,2109,2119,0,0,2109,2119,6,16,2115,2103,2986,366,386,388,0,,0,0.0,0.0,0.0,0.0,0.0
2024,8,17,6,2024-08-17,F9,8906,PHL,MCO,"Philadelphia, PA",Pennsylvania,"Orlando, FL",Florida,697,1624,4,0,701,1624,26,9,727,1615,1184,153,173,188,0,,0,0.0,0.0,0.0,0.0,0.0
2024,5,25,6,2024-05-25,WN,9296,MDW,PHX,"Chicago, IL",Illinois,"Phoenix, AZ",Arizona,1847,647,-14,-10,1833,637,13,11,1846,626,2341,292,312,316,0,,0,0.0,0.0,0.0,0.0,0.0
2024,7,15,1,2024-07-15,NK,2221,PHL,DTW,"Philadelphia, PA",Pennsylvania,"Detroit, MI",Michigan,1783,2040,-22,-15,1761,2025,20,19,1781,2006,1137,142,162,181,0,,0,0.0,0.0,0.0,0.0,0.0
2024,8,8,4,2024-08-08,YX,3109,DCA,MCO,"Washington, DC",District of Columbia,"Orlando, FL",Florida,698,2287,-15,-10,683,2277,24,7,707,2270,2066,255,275,286,0,,0,0.0,0.0,0.0,0.0,0.0
2024,2,29,4,2024-02-29,AS,3919,DTW,PDX,"Detroit, MI",Michigan,"Portland, OR",Oregon,1315,1544,-11,-10,1304,1534,25,7,1329,1527,2191,270,290,302,0,,0,0.0,0.0,0.0,0.0,0.0
2024,4,7,7,2024-04-07,NK,7839,MDW,DCA,"Chicago, IL",Illinois,"Washington, DC",District of Columbia,1660,1820,1,5,1661,1825,21,11,1682,1814,2349,295,315,327,0,,0,0.0,0.0,0.0,0.0,0.0
2024,6,19,3,2024-06-19,AA,8315,ATL,LAS,"Atlanta, GA",Georgia,"Las Vegas, NV",Nevada,1869,2193,-18,-10,1851,2183,20,13,1871,2170,2131,262,282,295,0,,0,0.0,0.0,0.0,0.0,0.0
2024,6,21,5,2024-06-21,UA,4159,DEN,LAS,"Denver, CO",Colorado,"Las Vegas, NV",Nevada,2023,1671,-11,-15,2012,1656,5,8,2017,1648,2420,302,322,315,0,,0,0.0,0.0,0.0,0.0,0.0
2024,5,30,4,2024-05-30,AS,3010,DCA,DEN,"Washington, DC",District of Columbia,"Denver, CO",Colorado,674,954,20,15,694,969,29,18,723,951,2854,351,371,398,0,,0,0.0,0.0,0.0,0.0,0.0
2024,12,15,7,2024-12-15,UA,2070,TPA,BWI,"Tampa, FL",Florida,"Baltimore, MD",Maryland,988,1857,-3,5,985,1862,9,10,994,1852,2076,257,277,276,0,,0,0.0,0.0,0.0,0.0,0.0
2024,5,1,3,2024-05-01,HA,9830,BOS,MIA,"Boston, MA",Massachusetts,"Miami, FL",Florida,1992,1609,1,0,1993,1609,23,16,2016,1593,2711,332,352,371,0,,0,0.0,0.0,0.0,0.0,0.0
2024,4,17,3,2024-04-17,OH,6755,SEA,DFW,"Seattle, WA",Washington,"Dallas/Fort Worth, TX",Texas,815,1036,-21,-15,794,1021,22,8,816,1013,2463,315,335,345,0,,0,0.0,0.0,0.0,0.0,0.0
2024,1,4,4,2024-01-04,HA,4867,MDW,IAD,"Chicago, IL",Illinois,"Washington, DC",District of Columbia,1319,1299,4,10,1323,1309,27,8,1350,1301,2461,314,334,349,0,,0,0.0,0.0,0.0,0.0,0.0
2024,4,2,2,2024-04-02,OH,8862,DTW,MDW,"Detroit, MI",Michigan,"Chicago, IL",Illinois,879,1225,-25,-15,854,1210,24,16,878,1194,385,47,67,87,0,,0,0.0,0.0,0.0,0.0,0.0
2024,1,6,6,2024-01-06,NK,1342,SEA,LGA,"Seattle, WA",Washington,"New York, NY",New York,941,689,-5,0,936,689,7,10,943,679,980,130,150,147,0,,0,0.0,0.0,0.0,0.0,0.0
2024,10,14,1,2024-10-14,G4,812,MSP,DTW,"Minneapolis, MN",Minnesota,"Detroit, MI",Michigan,1364,968,9,5,1373,973,22,3,1395,970,1488,179,199,204,0,,0,0.0,0.0,0.0,0.0,0.0
2024,4,15,1,2024-04-15,UA,9585,HNL,PHL,"Honolulu, HI",Hawaii,"Philadelphia, PA",Pennsylvania,632,1538,-3,-5,629,1533,15,15,644,1518,1972,252,272,282,0,,0,0.0,0.0,0.0,0.0,0.0
2024,5,25,6,2024-05-25,OH,2966,EWR,DTW,"Newark, NJ",New Jersey,"Detroit, MI",Michigan,1480,1792,11,15,1491,1807,15,6,1506,1801,2102,253,273,274,0,,0,0.0,0.0,0.0,0.0,0.0
2024,9,27,5,2024-09-27,AA,9966,MIA,HNL,"Miami, FL",Florida,"Honolulu, HI",Hawaii,1550,1986,-8,-15,1542,1971,15,17,1557,1954,1551,187,207,219,0,,0,0.0,0.0,0.0,0.0,0.0
2024,4,5,5,2024-04-05,9E,6253,BOS,SAN,"Boston, MA",Massachusetts,"San Diego, CA",California,1436,1554,18,10,1454,1564,14,19,1468,1545,670,78,98,111,0,,0,0.0,0.0,0.0,0.0,0.0
2024,8,16,5,2024-08-16,HA,5687,STL,SEA,"St. Louis, MO",Missouri,"Seattle, WA",Washington,1780,1800,-5,0,1775,1800,14,19,1789,1781,248,26,46,59,1,,0,0.0,0.0,0.0,0.0,0.0
2024,7,20,6,2024-07-20,MQ,9651,MSP,SFO,"Minneapolis, MN",Minnesota,"San Francisco, CA",California,2086,1099,-3,0,2083,1099,8,13,2091,1086,831,95,115,116,0,,0,0.0,0.0,0.0,0.0,0.0
2024,7,30,2,2024-07-30,AS,8927,PHX,CLT,"Phoenix, AZ",Arizona,"Charlotte, NC",North Carolina,1155,1303,22,30,1177,1333,13,14,1190,1319,228,21,41,48,0,,0,6.0,7.0,1.0,0.0,16.0
2024,1,6,6,2024-01-06,YX,9501,TPA,LAS,"Tampa, FL",Florida,"Las Vegas, NV",Nevada,1879,732,6,0,1885,732,14,5,1899,727,1528,195,215,214,0,,0,0.0,0.0,0.0,0.0,0.0
2024,4,21,7,2024-04-21,AA,7813,SAN,SFO,"San Diego, CA",California,"San Francisco, CA",California,735,771,8,5,743,776,17,17,760,759,378,45,65,79,0,,0,0.0,0.0,0.0,0.0,0.0
2024,11,18,1,2024-11-18,AA,6961,MIA,PHL,"Miami, FL",Florida,"Philadelphia, PA",Pennsylvania,2195,2153,-1,-10,2194,2143,27,8,2221,2135,2185,263,283,298,0,,0,0.0,0.0,0.0,0.0,0.0
2024,4,15,1,2024-04-15,OH,1397,BOS,PHL,"Boston, MA",Massachusetts,"Philadelphia, PA",Pennsylvania,1488,1362,13,10,1501,1372,5,7,1506,1365,1039,134,154,146,0,,0,0.0,0.0,0.0,0.0,0.0
2024,5,18,6,2024-05-18,F9,457,LAX,MIA,"Los Angeles, CA",California,"Miami, FL",Florida,1882,1040,-4,5,1878,1045,20,10,1898,1035,2140,264,284,294,0,,0,0.0,0.0,0.0,0.0,0.0
2024,10,25,5,2024-10-25,G4,5202,DFW,SEA,"Dallas/Fort Worth, TX",Texas,"Seattle, WA",Washington,1314,1584,13,20,1327,1604,23,12,1350,1592,1208,144,164,179,0,,0,6.0,1.0,1.0,0.0,12.0
2024,4,5,5,2024-04-05,DL,340,SAN,LAS,"San Diego, CA",California,"Las Vegas, NV",Nevada,1418,711,13,15,1431,726,16,5,1447,721,2216,270,290,291,0,,0,0.0,0.0,0.0,0.0,0.0
2024,12,2,1,2024-12-02,G4,6954,ORD,BWI,"Chicago, IL",Illinois,"Baltimore, MD",Maryland,1794,1663,-5,-10,1789,1653,9,14,1798,1639,1678,209,229,232,0,,0,0.0,0.0,0.0,0.0,0.0
2024,10,23,3,2024-10-23,B6,1926,ATL,BWI,"Atlanta, GA",Georgia,"Baltimore, MD",Maryland,2189,701,-10,0,2179,701,27,14,2206,687,1440,187,207,228,0,,0,0.0,0.0,0.0,0.0,0.0
2024,8,1,4,2024-08-01,MQ,8215,BOS,SLC,"Boston, MA",Massachusetts,"Salt Lake City, UT",Utah,2072,1992,6,15,2078,2007,9,12,2087,1995,754,101,121,122,0,,0,0.0,0.0,0.0,0.0,0.0
2024,10,17,4,2024-10-17,F9,3658,ORD,SEA,"Chicago, IL",Illinois,"Seattle, WA",Washington,2033,1797,1,0,2034,1797,29,19,2063,1778,877,110,130,158,0,,0,0.0,0.0,0.0,0.0,0.0
2024,1,22,1,2024-01-22,NK,3960,PDX,HNL,"Portland, OR",Oregon,"Honolulu, HI",Hawaii,2252,940,5,0,2257,940,11,16,2268,924,1779,216,236,243,0,,0,0.0,0.0,0.0,0.0,0.0
2024,7,11,4,2024-07-11,NK,4547,STL,PHX,"St. Louis, MO",Missouri,"Phoenix, AZ",Arizona,938,1519,-11,-15,927,1504,16,9,943,1495,899,108,128,133,0,,0,0.0,0.0,0.0,0.0,0.0
2024,5,29,3,2024-05-29,WN,4239,BWI,IAH,"Baltimore, MD",Maryland,"Houston, TX",Texas,2165,1413,3,-5,2168,1408,18,13,2186,1395,1041,134,154,165,0,,0,0.0,0.0,0.0,0.0,0.0
2024,9,3,2,2024-09-03,DL,237,PHX,ATL,"Phoenix, AZ",Arizona,"Atlanta, GA",Georgia,1087,795,14,5,1101,800,5,9,1106,791,439,60,80,74,0,,0,0.0,0.0,0.0,0.0,0.0
2024,9,23,1,2024-09-23,B6,3834,SEA,IAD,"Seattle, WA",Washington,"Washington, DC",District of Columbia,1994,2207,0,5,1994,2212,10,19,2004,2193,1121,145,165,174,0,,0,0.0,0.0,0.0,0.0,0.0
2024,9,7,6,2024-09-07,OH,2067,PHL,IAH,"Philadelphia, PA",Pennsylvania,"Houston, TX",Texas,2232,1805,4,-5,2236,1800,22,3,2258,1797,2722,338,358,363,0,,0,0.0,0.0,0.0,0.0,0.0
2024,1,3,3,2024-01-03,OO,6679,MSP,LAX,"Minneapolis, MN",Minnesota,"Los Angeles, CA",California,1834,1946,-7,-15,1827,1931,10,11,1837,1920,1309,165,185,186,0,,0,0.0,0.0,0.0,0.0,0.0
2024,11,11,1,2024-11-11,OO,4949,SFO,STL,"San Francisco, CA",California,"St. Louis, MO",Missouri,1740,1736,4,0,1744,1736,23,9,1767,1727,383,40,60,72,0,,0,0.0,0.0,0.0,0.0,0.0
2024,3,16,6,2024-03-16,UA,8434,DEN,MIA,"Denver, CO",Colorado,"Miami, FL",Florida,1110,2298,8,15,1118,2313,16,16,1134,2297,1909,238,258,270,0,,1,0.0,0.0,0.0,0.0,0.0
2024,3,27,3,2024-03-27,HA,7267,IAH,ORD,"Houston, TX",Texas,"Chicago, IL",Illinois,1835,2174,5,0,1840,2174,22,18,1862,2156,952,122,142,162,0,,0,0.0,0.0,0.0,0.0,0.0
2024,9,26,4,2024-09-26,OH,6042,SEA,DEN,"Seattle, WA",Washington,"Denver, CO",Colorado,729,1858,15,15,744,1873,7,5,751,1868,2465,312,332,324,0,,0,0.0,0.0,0.0,0.0,0.0
2024,8,12,1,2024-08-12,G4,7566,DCA,SLC,"Washington, DC",District of Columbia,"Salt Lake City, UT",Utah,2144,1104,-9,-5,2135,1099,15,18,2150,1081,1516,186,206,219,0,,0,0.0,0.0,0.0,0.0,0.0
2024,1,18,4,2024-01-18,AS,6505,SFO,SAN,"San Francisco, CA",California,"San Diego, CA",California,839,1694,1,10,840,1704,8,15,848,1689,619,72,92,95,0,,0,0.0,0.0,0.0,0.0,0.0
2024,4,22,1,2024-04-22,AA,5615,BWI,ORD,"Baltimore, MD",Maryland,"Chicago, IL",Illinois,2018,818,1,5,2019,823,17,11,2036,812,1700,205,225,233,0,,0,0.0,0.0,0.0,0.0,0.0
2024,9,7,6,2024-09-07,UA,8151,SAN,BOS,"San Diego, CA",California,"Boston, MA",Massachusetts,663,2140,21,20,684,2160,5,7,689,2153,1853,230,250,242,0,,0,3.0,5.0,1.0,0.0,11.0
2024,8,20,2,2024-08-20,YX,2119,EWR,PHL,"Newark, NJ",New Jersey,"Philadelphia, PA",Pennsylvania,615,764,8,5,623,769,24,15,647,754,2452,315,335,354,0,,0,0.0,0.0,0.0,0.0,0.0
2024,11,24,7,2024-11-24,WN,6274,STL,CLT,"St. Louis, MO",Missouri,"Charlotte, NC",North Carolina,570,2136,-1,-5,569,2131,10,19,579,2112,2962,369,389,398,0,,0,0.0,0.0,0.0,0.0,0.0
2024,10,5,6,2024-10-05,G4,7192,LAX,SLC,"Los Angeles, CA",California,"Salt Lake City, UT",Utah,2249,980,24,15,2273,995,25,17,2298,978,2162,279,299,321,0,,0,0.0,0.0,0.0,0.0,0.0
2024,7,20,6,2024-07-20,OO,2949,SEA,MDW,"Seattle, WA",Washington,"Chicago, IL",Illinois,1349,1807,1,5,1350,1812,18,17,1368,1795,575,67,87,102,0,,0,0.0,0.0,0.0,0.0,0.0
2024,3,23,6,2024-03-23,AS,1292,CLT,MDW,"Charlotte, NC",North Carolina,"Chicago, IL",Illinois,1576,968,-3,-10,1573,958,25,8,1598,950,2111,257,277,290,0,,0,0.0,0.0,0.0,0.0,0.0
2024,5,4,6,2024-05-04,WN,2455,PHL,ORD,"Philadelphia, PA",Pennsylvania,"Chicago, IL",Illinois,2120,2071,-20,-20,2100,2051,13,18,2113,2033,1020,123,143,154,0,,0,0.0,0.0,0.0,0.0,0.0
2024,6,23,7,2024-06-23,AA,2606,LGA,PHX,"New York, NY",New York,"Phoenix, AZ",Arizona,841,607,-6,-5,835,602,13,11,848,591,1919,243,263,267,0,,0,0.0,0.0,0.0,0.0,0.0
2024,3,9,6,2024-03-09,F9,433,EWR,DCA,"Newark, NJ",New Jersey,"Washington, DC",District of Columbia,1434,2243,8,5,1442,2248,29,5,1471,2243,394,55,75,89,0,,0,0.0,0.0,0.0,0.0,0.0
2024,2,16,5,2024-02-16,OH,2662,MCO,HNL,"Orlando, FL",Florida,"Honolulu, HI",Hawaii,1087,2005,-8,0,1079,2005,11,7,1090,1998,2611,333,353,351,0,,0,0.0,0.0,0.0,0.0,0.0
2024,9,12,4,2024-09-12,OO,1895,MIA,BOS,"Miami, FL",Florida,"Boston, MA",Massachusetts,1278,2005,7,0,1285,2005,19,9,1304,1996,746,102,122,130,0,,0,0.0,0.0,0.0,0.0,0.0
2024,8,2,5,2024-08-02,DL,353,LAX,PHX,"Los Angeles, CA",California,"Phoenix, AZ",Arizona,2283,1047,-19,-20,2264,1027,14,15,2278,1012,584,64,84,93,0,,0,0.0,0.0,0.0,0.0,0.0
2024,1,30,2,2024-01-30,OO,3757,PDX,IAD,"Portland, OR",Oregon,"Washington, DC",District of Columbia,831,2320,-15,-5,816,2315,13,4,829,2311,1905,240,260,257,0,,0,0.0,0.0,0.0,0.0,0.0
2024,10,7,1,2024-10-07,HA,7602,EWR,TPA,"Newark, NJ",New Jersey,"Tampa, FL",Florida,1602,1777,-8,-10,1594,1767,28,13,1622,1754,1160,152,172,193,0,,0,0.0,0.0,0.0,0.0,0.0
2024,8,24,6,2024-08-24,OO,9715,CLT,ORD,"Charlotte, NC",North Carolina,"Chicago, IL",Illinois,1467,633,-9,0,1458,633,28,3,1486,630,1192,146,166,177,0,,0,0.0,0.0,0.0,0.0,0.0
2024,9,4,3,2024-09-04,F9,3337,JFK,SFO,"New York, NY",New York,"San Francisco, CA",California,606,1096,49,45,655,1141,19,7,674,1134,2273,284,304,310,0,,0,5.0,10.0,4.0,1.0,25.0
2024,1,25,4,2024-01-25,AS,3431,STL,EWR,"St. Louis, MO",Missouri,"Newark, NJ",New Jersey,581,1463,10,10,591,1473,25,6,616,1467,823,103,123,134,0,,0,0.0,0.0,0.0,0.0,0.0
2024,3,14,4,2024-03-14,F9,1127,BOS,ORD,"Boston, MA",Massachusetts,"Chicago, IL",Illinois,1725,621,-10,-5,1715,616,13,17,1728,599,1567,201,221,231,0,,0,0.0,0.0,0.0,0.0,0.0
2024,7,24,3,2024-07-24,AS,2266,BWI,IAD,"Baltimore, MD",Maryland,"Washington, DC",District of Columbia,891,2003,-5,0,886,2003,28,12,914,1991,2858,350,370,390,0,,0,0.0,0.0,0.0,0.0,0.0
2024,11,9,6,2024-11-09,B6,569,SEA,MCO,"Seattle, WA",Washington,"Orlando, FL",Florida,729,1771,1,0,730,1771,11,6,741,1765,2436,313,333,330,0,,0,0.0,0.0,0.0,0.0,0.0
2024,4,3,3,2024-04-03,B6,7760,DEN,DFW,"Denver, CO",Colorado,"Dallas/Fort Worth, TX",Texas,2262,1262,-10,-15,2252,1247,28,9,2280,1238,1860,225,245,262,0,,0,0.0,0.0,0.0,0.0,0.0
2024,5,6,1,2024-05-06,OH,8005,LAX,MSP,"Los Angeles, CA",California,"Minneapolis, MN",Minnesota,519,2202,35,30,554,2232,29,7,583,2225,559,75,95,111,0,,0,7.0,6.0,3.0,0.0,14.0
2024,1,25,4,2024-01-25,OH,6083,IAH,IAD,"Houston, TX",Texas,"Washington, DC",District of Columbia,1279,1189,-6,-5,1273,1184,27,17,1300,1167,1602,199,219,243,0,,0,0.0,0.0,0.0,0.0,0.0
2024,11,29,5,2024-11-29,9E,1193,LAX,DFW,"Los Angeles, CA",California,"Dallas/Fort Worth, TX",Texas,1846,2174,6,0,1852,2174,29,7,1881,2167,372,51,71,87,0,,0,0.0,0.0,0.0,0.0,0.0
2024,12,20,5,2024-12-20,9E,4889,ATL,EWR,"Atlanta, GA",Georgia,"Newark, NJ",New Jersey,1991,1276,9,0,2000,1276,12,15,2012,1261,2839,358,378,385,0,,0,0.0,0.0,0.0,0.0,0.0
2024,4,25,4,2024-04-25,OO,3012,JFK,PHX,"New York, NY",New York,"Phoenix, AZ",Arizona,2213,1722,-19,-10,2194,1712,6,8,2200,1704,950,109,129,123,0,,0,0.0,0.0,0.0,0.0,0.0
2024,2,17,6,2024-02-17,F9,5589,LGA,BWI,"New York, NY",New York,"Baltimore, MD",Maryland,1151,2264,-8,-10,1143,2254,7,18,1150,2236,817,105,125,130,0,,0,0.0,0.0,0.0,0.0,0.0
2024,8,13,2,2024-08-13,NK,280,LGA,DTW,"New York, NY",New York,"Detroit, MI",Michigan,1833,2154,-4,-10,1829,2144,26,11,1855,2133,298,43,63,80,0,,0,0.0,0.0,0.0,0.0,0.0
2024,9,22,7,2024-09-22,F9,9512,CLT,PHX,"Charlotte, NC",North Carolina,"Phoenix, AZ",Arizona,971,870,-7,-5,964,865,26,8,990,857,1301,159,179,193,0,,0,0.0,0.0,0.0,0.0,0.0
2024,4,8,1,2024-04-08,YX,4242,SLC,PDX,"Salt Lake City, UT",Utah,"Portland, OR",Oregon,1091,600,-6,-10,1085,590,27,10,1112,580,2640,327,347,364,0,,0,0.0,0.0,0.0,0.0,0.0
2024,1,11,4,2024-01-11,F9,3723,MCO,BWI,"Orlando, FL",Florida,"Baltimore, MD",Maryland,2217,886,11,15,2228,901,6,6,2234,895,2369,299,319,311,0,,0,0.0,0.0,0.0,0.0,0.0
2024,3,25,1,2024-03-25,NK,4829,SAN,DTW,"San Diego, CA",California,"Detroit, MI",Michigan,573,1803,7,5,580,1808,5,11,585,1797,913,108,128,124,0,,0,0.0,0.0,0.0,0.0,0.0
2024,8,1,4,2024-08-01,DL,5359,ATL,DTW,"Atlanta, GA",Georgia,"Detroit, MI",Michigan,2182,1538,9,10,2191,1548,16,13,2207,1535,2438,313,333,342,0,,0,0.0,0.0,0.0,0.0,0.0
2024,6,21,5,2024-06-21,OO,8129,SLC,PHL,"Salt Lake City, UT",Utah,"Philadelphia, PA",Pennsylvania,2268,1879,17,10,2285,1889,9,13,2294,1876,636,78,98,100,0,,0,0.0,0.0,0.0,0.0,0.0
2024,7,27,6,2024-07-27,HA,9855,MDW,IAH,"Chicago, IL",Illinois,"Houston, TX",Texas,1153,1797,4,5,1157,1802,22,18,1179,1784,2401,307,327,347,0,,0,0.0,0.0,0.0,0.0,0.0
2024,3,4,1,2024-03-04,G4,4784,BWI,MDW,"Baltimore, MD",Maryland,"Chicago, IL",Illinois,1959,1453,-3,-10,1956,1443,29,11,1985,1432,1121,130,150,170,0,,0,0.0,0.0,0.0,0.0,0.0
2024,9,14,6,2024-09-14,MQ,7954,SAN,IAD,"San Diego, CA",California,"Washington, DC",District of Columbia,961,649,3,0,964,649,23,3,987,646,2133,257,277,283,0,,0,0.0,0.0,0.0,0.0,0.0
2024,11,27,3,2024-11-27,NK,3732,DFW,BWI,"Dallas/Fort Worth, TX",Texas,"Baltimore, MD",Maryland,1673,2155,-2,-10,1671,2145,6,3,1677,2142,1111,134,154,143,0,,0,0.0,0.0,0.0,0.0,0.0
2024,4,30,2,2024-04-30,YX,6073,EWR,IAH,"Newark, NJ",New Jersey,"Houston, TX",Texas,2167,1216,-25,-15,2142,1201,20,9,2162,1192,2542,312,332,341,0,,0,0.0,0.0,0.0,0.0,0.0
2024,10,24,4,2024-10-24,OO,6517,PHX,PHL,"Phoenix, AZ",Arizona,"Philadelphia, PA",Pennsylvania,2274,789,-7,0,2267,789,27,5,2294,784,2192,270,290,302,0,,0,0.0,0.0,0.0,0.0,0.0
2024,2,23,5,2024-02-23,HA,1662,PHX,MSP,"Phoenix, AZ",Arizona,"Minneapolis, MN",Minnesota,814,1666,3,0,817,1666,10,9,827,1657,264,37,57,56,0,,0,0.0,0.0,0.0,0.0,0.0
2024,11,26,2,2024-11-26,AS,1513,STL,IAH,"St. Louis, MO",Missouri,"Houston, TX",Texas,2197,2140,-16,-10,2181,2130,28,3,2209,2127,574,70,90,101,0,,0,0.0,0.0,0.0,0.0,0.0
2024,9,28,6,2024-09-28,G4,6604,JFK,DFW,"New York, NY",New York,"Dallas/Fort Worth, TX",Texas,1773,1359,-11,-5,1762,1354,29,3,1791,1351,430,56,76,88,0,,0,0.0,0.0,0.0,0.0,0.0
2024,8,28,3,2024-08-28,MQ,1117,LAX,DTW,"Los Angeles, CA",California,"Detroit, MI",Michigan,1139,665,-6,-15,1133,650,7,9,1140,641,841,97,117,113,0,,0,0.0,0.0,0.0,0.0,0.0
2024,8,30,5,2024-08-30,AA,3754,DTW,DFW,"Detroit, MI",Michigan,"Dallas/Fort Worth, TX",Texas,773,995,8,5,781,1000,12,6,793,994,2270,275,295,293,0,,0,0.0,0.0,0.0,0.0,0.0
2024,1,18,4,2024-01-18,OO,6942,STL,ATL,"St. Louis, MO",Missouri,"Atlanta, GA",Georgia,981,1874,27,30,1008,1904,8,7,1016,1897,2537,315,335,330,0,,0,9.0,6.0,1.0,0.0,14.0
2024,7,5,5,2024-07-05,DL,9049,MDW,IAH,"Chicago, IL",Illinois,"Houston, TX",Texas,581,727,6,5,587,732,22,16,609,716,1544,190,210,228,0,,0,0.0,0.0,0.0,0.0,0.0
2024,12,11,3,2024-12-11,MQ,6198,MDW,IAD,"Chicago, IL",Illinois,"Washington, DC",District of Columbia,1755,1296,16,10,1771,1306,24,17,1795,1289,1840,226,246,267,0,,0,0.0,0.0,0.0,0.0,0.0
2024,5,23,4,2024-05-23,AA,8912,DFW,CLT,"Dallas/Fort Worth, TX",Texas,"Charlotte, NC",North Carolina,530,787,-8,0,522,787,8,6,530,781,2289,289,309,303,0,,0,0.0,0.0,0.0,0.0,0.0
2024,9,18,3,2024-09-18,9E,3684,LAX,DCA,"Los Angeles, CA",California,"Washington, DC",District of Columbia,1245,1806,-22,-15,1223,1791,12,4,1235,1787,1393,167,187,183,0,,0,0.0,0.0,0.0,0.0,0.0
2024,12,29,7,2024-12-29,YX,281,DFW,EWR,"Dallas/Fort Worth, TX",Texas,"Newark, NJ",New Jersey,1607,2206,-1,5,1606,2211,28,13,1634,2198,2060,266,286,307,0,,0,0.0,0.0,0.0,0.0,0.0
2024,8,26,1,2024-08-26,UA,6929,DCA,JFK,"Washington, DC",District of Columbia,"New York, NY",New York,1495,1177,-20,-10,1475,1167,11,17,1486,1150,1646,212,232,240,0,,0,0.0,0.0,0.0,0.0,0.0
2024,10,30,3,2024-10-30,OO,2767,EWR,JFK,"Newark, NJ",New Jersey,"New York, NY",New York,541,1440,-14,-5,527,1435,24,8,551,1427,2449,310,330,342,0,,0,0.0,0.0,0.0,0.0,0.0
2024,10,24,4,2024-10-24,B6,6273,BOS,IAH,"Boston, MA",Massachusetts,"Houston, TX",Texas,2237,1361,-1,5,2236,1366,22,7,2258,1359,2781,342,362,371,0,,0,0.0,0.0,0.0,0.0,0.0
2024,3,16,6,2024-03-16,AA,5521,DTW,TPA,"Detroit, MI",Michigan,"Tampa, FL",Florida,750,1266,23,15,773,1281,5,13,778,1268,1985,243,263,261,0,,0,0.0,0.0,0.0,0.0,0.0
2024,7,6,6,2024-07-06,WN,9791,BOS,PHL,"Boston, MA",Massachusetts,"Philadelphia, PA",Pennsylvania,2033,2035,-6,0,2027,2035,22,12,2049,2023,1258,148,168,182,0,,0,0.0,0.0,0.0,0.0,0.0
2024,11,28,4,2024-11-28,OH,9276,LAX,SEA,"Los Angeles, CA",California,"Seattle, WA",Washington,886,1532,22,20,908,1552,6,15,914,1537,934,120,140,141,0,,0,1.0,3.0,0.0,0.0,16.0
2024,9,2,1,2024-09-02,MQ,2464,SLC,PDX,"Salt Lake City, UT",Utah,"Portland, OR",Oregon,2120,678,-6,0,2114,678,23,18,2137,660,2291,295,315,336,0,,0,0.0,0.0,0.0,0.0,0.0
2024,5,9,4,2024-05-09,F9,5616,SFO,LAS,"San Francisco, CA",California,"Las Vegas, NV",Nevada,1495,1642,-18,-15,1477,1627,14,12,1491,1615,2041,250,270,276,0,,0,0.0,0.0,0.0,0.0,0.0
2024,11,10,7,2024-11-10,AS,3405,MIA,BOS,"Miami, FL",Florida,"Boston, MA",Massachusetts,2218,2101,-2,0,2216,2101,25,8,2241,2093,1719,214,234,247,0,,0,0.0,0.0,0.0,0.0,0.0
2024,10,9,3,2024-10-09,MQ,2315,PDX,CLT,"Portland, OR",Oregon,"Charlotte, NC",North Carolina,765,644,14,10,779,654,5,4,784,650,2434,309,329,318,0,,0,0.0,0.0,0.0,0.0,0.0
2024,3,19,2,2024-03-19,AA,225,SFO,MSP,"San Francisco, CA",California,"Minneapolis, MN",Minnesota,2106,1845,-8,0,2098,1845,25,3,2123,1842,2024,258,278,286,0,,1,0.0,0.0,0.0,0.0,0.0
2024,3,12,2,2024-03-12,YX,2720,LAS,EWR,"Las Vegas, NV",Nevada,"Newark, NJ",New Jersey,521,728,-5,5,516,733,11,7,527,726,1751,219,239,237,0,,0,0.0,0.0,0.0,0.0,0.0
2024,9,19,4,2024-09-19,AA,4315,DFW,PHL,"Dallas/Fort Worth, TX",Texas,"Philadelphia, PA",Pennsylvania,1930,1217,9,0,1939,1217,18,13,1957,1204,2374,291,311,322,0,,0,0.0,0.0,0.0,0.0,0.0
2024,7,9,2,2024-07-09,UA,1551,DCA,DTW,"Washington, DC",District of Columbia,"Detroit, MI",Michigan,575,1362,-4,0,571,1362,5,5,576,1357,972,117,137,127,0,,0,0.0,0.0,0.0,0.0,0.0
2024,3,3,7,2024-03-03,OH,9300,BWI,IAH,"Baltimore, MD",Maryland,"Houston, TX",Texas,2010,2256,-8,-10,2002,2246,8,5,2010,2241,1951,244,264,257,0,,0,0.0,0.0,0.0,0.0,0.0
2024,1,12,5,2024-01-12,9E,9505,CLT,TPA,"Charlotte, NC",North Carolina,"Tampa, FL",Florida,1179,1853,-18,-10,1161,1843,15,12,1176,1831,2675,342,362,369,0,,0,0.0,0.0,0.0,0.0,0.0
2024,5,20,1,2024-05-20,HA,5647,MIA,BOS,"Miami, FL",Florida,"Boston, MA",Massachusetts,1390,1392,-11,-10,1379,1382,6,7,1385,1375,2466,302,322,315,0,,0,0.0,0.0,0.0,0.0,0.0
2024,9,10,2,2024-09-10,F9,6803,HNL,MDW,"Honolulu, HI",Hawaii,"Chicago, IL",Illinois,1364,1850,2,-5,1366,1845,12,5,1378,1840,1213,144,164,161,0,,0,0.0,0.0,0.0,0.0,0.0
2024,2,12,1,2024-02-12,OO,7469,PHX,TPA,"Phoenix, AZ",Arizona,"Tampa, FL",Florida,1874,996,15,10,1889,1006,22,8,1911,998,469,61,81,91,0,,0,0.0,0.0,0.0,0.0,0.0
2024,1,17,3,2024-01-17,OO,3230,LAX,MSP,"Los Angeles, CA",California,"Minneapolis, MN",Minnesota,739,874,8,10,747,884,21,12,768,872,1088,135,155,168,0,,0,0.0,0.0,0.0,0.0,0.0
2024,3,3,7,2024-03-03,OH,796,BWI,SAN,"Baltimore, MD",Maryland,"San Diego, CA",California,550,737,-6,-10,544,727,18,10,562,717,1559,190,210,218,0,,0,0.0,0.0,0.0,0.0,0.0
2024,9,9,1,2024-09-09,F9,2370,SLC,SAN,"Salt Lake City, UT",Utah,"San Diego, CA",California,1459,1796,3,0,1462,1796,22,6,1484,1790,2198,268,288,296,0,,0,0.0,0.0,0.0,0.0,0.0
2024,10,18,5,2024-10-18,MQ,9807,EWR,STL,"Newark, NJ",New Jersey,"St. Louis, MO",Missouri,975,1950,3,-5,978,1945,14,8,992,1937,669,75,95,97,0,,0,0.0,0.0,0.0,0.0,0.0
2024,1,8,1,2024-01-08,UA,9326,SEA,STL,"Seattle, WA",Washington,"St. Louis, MO",Missouri,2118,1382,-5,0,2113,1382,24,15,2137,1367,2098,271,291,310,0,,0,0.0,0.0,0.0,0.0,0.0
2024,11,20,3,2024-11-20,NK,9827,LGA,PDX,"New York, NY",New York,"Portland, OR",Oregon,1363,814,-4,0,1359,814,25,12,1384,802,2048,247,267,284,0,,0,0.0,0.0,0.0,0.0,0.0
2024,3,30,6,2024-03-30,YX,9105,LGA,MIA,"New York, NY",New York,"Miami, FL",Florida,2125,827,-16,-10,2109,817,22,14,2131,803,269,25,45,61,0,,0,0.0,0.0,0.0,0.0,0.0
2024,7,26,5,2024-07-26,UA,8601,PHL,SEA,"Philadelphia, PA",Pennsylvania,"Seattle, WA",Washington,1393,706,17,15,1410,721,24,14,1434,707,2370,290,310,328,0,,0,0.0,0.0,0.0,0.0,0.0
2024,10,18,5,2024-10-18,WN,9303,TPA,BWI,"Tampa, FL",Florida,"Baltimore, MD",Maryland,1024,758,9,15,1033,773,27,8,1060,765,1850,235,255,270,0,,0,0.0,0.0,0.0,0.0,0.0
2024,10,10,4,2024-10-10,G4,9310,LAX,DTW,"Los Angeles, CA",California,"Detroit, MI",Michigan,656,1759,-12,-15,644,1744,9,14,653,1730,2038,244,264,267,0,,0,0.0,0.0,0.0,0.0,0.0
2024,4,27,6,2024-04-27,MQ,3511,MDW,SAN,"Chicago, IL",Illinois,"San Diego, CA",California,698,629,-5,5,693,634,12,8,705,626,436,59,79,79,0,,0,0.0,0.0,0.0,0.0,0.0
2024,12,14,6,2024-12-14,WN,3818,BWI,PDX,"Baltimore, MD",Maryland,"Portland, OR",Oregon,1523,1721,-11,-20,1512,1701,14,5,1526,1696,2394,308,328,327,0,,0,0.0,0.0,0.0,0.0,0.0
2024,6,23,7,2024-06-23,UA,6817,PHL,BWI,"Philadelphia, PA",Pennsylvania,"Baltimore, MD",Maryland,1954,1208,-30,-20,1924,1188,29,18,1953,1170,1873,238,258,285,0,,0,0.0,0.0,0.0,0.0,0.0
2024,3,16,6,2024-03-16,B6,5020,PDX,JFK,"Portland, OR",Oregon,"New York, NY",New York,1165,1368,18,20,1183,1388,5,18,1188,1370,255,23,43,46,0,,0,7.0,5.0,0.0,0.0,8.0
2024,4,10,3,2024-04-10,NK,2144,MCO,MIA,"Orlando, FL",Florida,"Miami, FL",Florida,2233,1383,3,5,2236,1388,21,3,2257,1385,2483,308,328,332,0,,0,0.0,0.0,0.0,0.0,0.0
2024,5,30,4,2024-05-30,B6,1216,DEN,BWI,"Denver, CO",Colorado,"Baltimore, MD",Maryland,1235,1481,-1,-5,1234,1476,23,4,1257,1472,805,93,113,120,1,,0,0.0,0.0,0.0,0.0,0.0
2024,9,26,4,2024-09-26,WN,1256,STL,JFK,"St. Louis, MO",Missouri,"New York, NY",New York,1641,2146,-1,5,1640,2151,28,13,1668,2138,2965,372,392,413,0,,0,0.0,0.0,0.0,0.0,0.0
2024,3,11,1,2024-03-11,F9,1088,BOS,ATL,"Boston, MA",Massachusetts,"Atlanta, GA",Georgia,2186,1522,6,10,2192,1532,21,5,2213,1527,1815,225,245,251,0,,0,0.0,0.0,0.0,0.0,0.0
2024,6,28,5,2024-06-28,WN,5687,DFW,PDX,"Dallas/Fort Worth, TX",Texas,"Portland, OR",Oregon,2279,941,1,10,2280,951,14,13,2294,938,1614,204,224,231,0,,0,0.0,0.0,0.0,0.0,0.0
2024,5,3,5,2024-05-03,DL,1928,DCA,SLC,"Washington, DC",District of Columbia,"Salt Lake City, UT",Utah,574,767,-20,-20,554,747,22,19,576,728,2947,372,392,413,0,,0,0.0,0.0,0.0,0.0,0.0
2024,10,19,6,2024-10-19,9E,7972,LAS,DEN,"Las Vegas, NV",Nevada,"Denver, CO",Colorado,1451,1834,9,10,1460,1844,5,13,1465,1831,2298,289,309,307,0,,0,0.0,0.0,0.0,0.0,0.0
2024,10,11,5,2024-10-11,MQ,6188,IAD,DCA,"Washington, DC",District of Columbia,"Washington, DC",District of Columbia,1224,1283,18,10,1242,1293,21,16,1263,1277,1351,159,179,196,0,,0,0.0,0.0,0.0,0.0,0.0
2024,7,13,6,2024-07-13,OH,2445,BWI,LAS,"Baltimore, MD",Maryland,"Las Vegas, NV",Nevada,1508,1231,-6,0,1502,1231,17,18,1519,1213,1450,188,208,223,0,,0,0.0,0.0,0.0,0.0,0.0
2024,8,15,4,2024-08-15,AS,9376,BWI,TPA,"Baltimore, MD",Maryland,"Tampa, FL",Florida,866,1808,4,0,870,1808,29,9,899,1799,1104,138,158,176,1,,0,0.0,0.0,0.0,0.0,0.0
2024,10,1,2,2024-10-01,DL,3105,SFO,ATL,"San Francisco, CA",California,"Atlanta, GA",Georgia,1255,1031,-24,-15,1231,1016,14,5,1245,1011,1144,141,161,160,0,,0,0.0,0.0,0.0,0.0,0.0
2024,4,15,1,2024-04-15,UA,4535,SFO,STL,"San Francisco, CA",California,"St. Louis, MO",Missouri,1701,2047,-10,-10,1691,2037,5,11,1696,2026,1488,184,204,200,0,,0,0.0,0.0,0.0,0.0,0.0
2024,1,21,7,2024-01-21,AA,6728,MCO,HNL,"Orlando, FL",Florida,"Honolulu, HI",Hawaii,607,638,-7,0,600,638,24,9,624,629,1511,192,212,225,0,,0,0.0,0.0,0.0,0.0,0.0
2024,3,4,1,2024-03-04,B6,176,SAN,MDW,"San Diego, CA",California,"Chicago, IL",Illinois,1188,1579,16,10,1204,1589,11,15,1215,1574,949,120,140,146,0,,0,0.0,0.0,0.0,0.0,0.0
2024,6,13,4,2024-06-13,G4,5852,DCA,IAH,"Washington, DC",District of Columbia,"Houston, TX",Texas,2002,986,1,10,2003,996,25,3,2028,993,2048,263,283,291,0,,0,0.0,0.0,0.0,0.0,0.0
2024,1,27,6,2024-01-27,DL,2662,DFW,TPA,"Dallas/Fort Worth, TX",Texas,"Tampa, FL",Florida,2209,1368,-1,0,2208,1368,17,12,2225,1356,545,58,78,87,0,,0,0.0,0.0,0.0,0.0,0.0
2024,11,6,3,2024-11-06,YX,1672,STL,DTW,"St. Louis, MO",Missouri,"Detroit, MI",Michigan,592,1390,5,5,597,1395,25,3,622,1392,1536,198,218,226,0,,0,0.0,0.0,0.0,0.0,0.0
2024,10,11,5,2024-10-11,NK,7187,MCO,HNL,"Orlando, FL",Florida,"Honolulu, HI",Hawaii,1465,1341,-5,5,1460,1346,11,16,1471,1330,1370,172,192,199,0,,0,0.0,0.0,0.0,0.0,0.0
2024,5,27,1,2024-05-27,B6,6070,STL,IAH,"St. Louis, MO",Missouri,"Houston, TX",Texas,599,2074,7,0,606,2074,10,8,616,2066,1084,143,163,161,0,,0,0.0,0.0,0.0,0.0,0.0
2024,10,7,1,2024-10-07,DL,8052,PHL,LAX,"Philadelphia, PA",Pennsylvania,"Los Angeles, CA",California,680,1738,-16,-10,664,1728,26,13,690,1715,1266,148,168,187,0,,0,0.0,0.0,0.0,0.0,0.0
2024,11,21,4,2024-11-21,F9,6709,DEN,ATL,"Denver, CO",Colorado,"Atlanta, GA",Georgia,1170,1000,-11,-5,1159,995,17,17,1176,978,1547,186,206,220,0,,0,0.0,0.0,0.0,0.0,0.0
2024,11,14,4,2024-11-14,OO,8156,DTW,BOS,"Detroit, MI",Michigan,"Boston, MA",Massachusetts,595,1927,-17,-10,578,1917,12,14,590,1903,1543,200,220,226,0,,0,0.0,0.0,0.0,0.0,0.0
2024,6,12,3,2024-06-12,HA,3211,MDW,DEN,"Chicago, IL",Illinois,"Denver, CO",Colorado,731,2226,-22,-20,709,2206,20,9,729,2197,2900,358,378,387,0,,0,0.0,0.0,0.0,0.0,0.0
2024,8,11,7,2024-08-11,MQ,2837,PHX,IAH,"Phoenix, AZ",Arizona,"Houston, TX",Texas,750,1932,-7,-15,743,1917,13,13,756,1904,1361,170,190,196,0,,0,0.0,0.0,0.0,0.0,0.0
2024,9,28,6,2024-09-28,MQ,9644,MSP,SFO,"Minneapolis, MN",Minnesota,"San Francisco, CA",California,2102,2196,-3,5,2099,2201,17,4,2116,2197,1911,243,263,264,0,,0,0.0,0.0,0.0,0.0,0.0
2024,5,25,6,2024-05-25,AS,5504,TPA,SEA,"Tampa, FL",Florida,"Seattle, WA",Washington,1403,1726,-16,-20,1387,1706,6,19,1393,1687,2907,366,386,391,0,,0,0.0,0.0,0.0,0.0,0.0
2024,12,21,6,2024-12-21,WN,9238,JFK,SLC,"New York, NY",New York,"Salt Lake City, UT",Utah,2272,2350,-2,-5,2270,2345,16,16,2286,2329,827,111,131,143,0,,0,0.0,0.0,0.0,0.0,0.0
2024,1,30,2,2024-01-30,MQ,4749,EWR,PDX,"Newark, NJ",New Jersey,"Portland, OR",Oregon,518,701,20,30,538,731,16,17,554,714,2509,307,327,340,1,,0,10.0,0.0,1.0,0.0,19.0
2024,2,14,3,2024-02-14,WN,3968,LAS,DFW,"Las Vegas, NV",Nevada,"Dallas/Fort Worth, TX",Texas,1810,1254,4,5,1814,1259,19,11,1833,1248,1651,207,227,237,0,,0,0.0,0.0,0.0,0.0,0.0
2024,10,1,2,2024-10-01,DL,3237,DFW,STL,"Dallas/Fort Worth, TX",Texas,"St. Louis, MO",Missouri,706,1713,7,5,713,1718,24,17,737,1701,1655,208,228,249,0,,0,0.0,0.0,0.0,0.0,0.0
2024,2,3,6,2024-02-03,UA,7924,PHX,PDX,"Phoenix, AZ",Arizona,"Portland, OR",Oregon,810,1741,-9,-10,801,1731,14,3,815,1728,263,32,52,49,0,,0,0.0,0.0,0.0,0.0,0.0
2024,5,20,1,2024-05-20,HA,6236,IAD,BWI,"Washington, DC",District of Columbia,"Baltimore, MD",Maryland,602,1762,-10,0,592,1762,29,14,621,1748,2629,318,338,361,0,,0,0.0,0.0,0.0,0.0,0.0
2024,11,13,3,2024-11-13,NK,7899,DFW,LGA,"Dallas/Fort Worth, TX",Texas,"New York, NY",New York,658,1502,-9,0,649,1502,18,12,667,1490,662,74,94,104,0,,0,0.0,0.0,0.0,0.0,0.0
2024,8,8,4,2024-08-08,UA,3586,STL,IAH,"St. Louis, MO",Missouri,"Houston, TX",Texas,2230,1926,0,0,2230,1926,21,4,2251,1922,2745,350,370,375,0,,0,0.0,0.0,0.0,0.0,0.0
2024,12,21,6,2024-12-21,MQ,1102,PDX,STL,"Portland, OR",Oregon,"St. Louis, MO",Missouri,2086,1351,-4,-5,2082,1346,14,13,2096,1333,2256,272,292,299,0,,0,0.0,0.0,0.0,0.0,0.0
2024,1,22,1,2024-01-22,B6,9111,SEA,ORD,"Seattle, WA",Washington,"Chicago, IL",Illinois,877,2271,-10,0,867,2271,28,11,895,2260,2468,302,322,341,0,,0,0.0,0.0,0.0,0.0,0.0
2024,6,28,5,2024-06-28,9E,8714,LAX,HNL,"Los Angeles, CA",California,"Honolulu, HI",Hawaii,1747,2140,29,30,1776,2170,15,19,1791,2151,1758,209,229,243,0,,0,2.0,1.0,5.0,0.0,22.0
2024,11,24,7,2024-11-24,AS,8863,HNL,TPA,"Honolulu, HI",Hawaii,"Tampa, FL",Florida,1213,1832,-13,-5,1200,1827,21,13,1221,1814,1723,206,226,240,0,,0,0.0,0.0,0.0,0.0,0.0
2024,8,18,7,2024-08-18,AS,8006,SLC,PHX,"Salt Lake City, UT",Utah,"Phoenix, AZ",Arizona,591,686,-12,-10,579,676,15,15,594,661,2558,309,329,339,0,,0,0.0,0.0,0.0,0.0,0.0
2024,2,7,3,2024-02-07,OH,5459,DTW,LAS,"Detroit, MI",Michigan,"Las Vegas, NV",Nevada,1166,1458,1,-5,1167,1453,19,19,1186,1434,2067,255,275,293,1,,0,0.0,0.0,0.0,0.0,0.0
2024,3,10,7,2024-03-10,WN,4630,CLT,LAS,"Charlotte, NC",North Carolina,"Las Vegas, NV",Nevada,675,918,8,0,683,918,8,3,691,915,1123,142,162,153,0,,0,0.0,0.0,0.0,0.0,0.0
2024,4,25,4,2024-04-25,AS,9715,LAS,SFO,"Las Vegas, NV",Nevada,"San Francisco, CA",California,1633,1566,-8,-15,1625,1551,29,12,1654,1539,630,68,88,109,0,,0,0.0,0.0,0.0,0.0,0.0
2024,8,26,1,2024-08-26,UA,1733,DEN,ATL,"Denver, CO",Colorado,"Atlanta, GA",Georgia,1234,1486,4,10,1238,1496,8,3,1246,1493,435,50,70,61,0,,0,0.0,0.0,0.0,0.0,0.0
2024,11,30,6,2024-11-30,NK,6769,CLT,IAH,"Charlotte, NC",North Carolina,"Houston, TX",Texas,678,1232,-9,-5,669,1227,25,13,694,1214,1878,226,246,264,0,,0,0.0,0.0,0.0,0.0,0.0
2024,5,27,1,2024-05-27,NK,1853,TPA,MDW,"Tampa, FL",Florida,"Chicago, IL",Illinois,1237,1868,-1,-5,1236,1863,19,16,1255,1847,2489,319,339,354,0,,0,0.0,0.0,0.0,0.0,0.0
2024,1,9,2,2024-01-09,WN,8759,LAS,IAD,"Las Vegas, NV",Nevada,"Washington, DC",District of Columbia,952,1713,0,5,952,1718,18,6,970,1712,1188,139,159,163,0,,0,0.0,0.0,0.0,0.0,0.0
2024,10,14,1,2024-10-14,DL,6453,DCA,EWR,"Washington, DC",District of Columbia,"Newark, NJ",New Jersey,1598,2101,-1,5,1597,2106,13,11,1610,2095,623,68,88,92,0,,0,0.0,0.0,0.0,0.0,0.0
2024,2,19,1,2024-02-19,OO,9998,MIA,MDW,"Miami, FL",Florida,"Chicago, IL",Illinois,1082,1251,38,30,1120,1281,20,10,1140,1271,345,38,58,68,0,,0,3.0,4.0,5.0,0.0,18.0
2024,12,3,2,2024-12-03,NK,8364,PHL,BWI,"Philadelphia, PA",Pennsylvania,"Baltimore, MD",Maryland,2244,1735,-8,-10,2236,1725,28,17,2264,1708,206,17,37,62,0,,0,0.0,0.0,0.0,0.0,0.0
2024,1,5,5,2024-01-05,UA,246,IAH,STL,"Houston, TX",Texas,"St. Louis, MO",Missouri,991,1549,-9,-5,982,1544,5,3,987,1541,921,114,134,122,0,,0,0.0,0.0,0.0,0.0,0.0
2024,12,8,7,2024-12-08,HA,7607,IAH,MDW,"Houston, TX",Texas,"Chicago, IL",Illinois,1456,2017,-19,-10,1437,2007,7,18,1444,1989,1457,175,195,200,0,,0,0.0,0.0,0.0,0.0,0.0
2024,5,5,7,2024-05-05,AA,416,LAX,BWI,"Los Angeles, CA",California,"Baltimore, MD",Maryland,602,839,5,10,607,849,8,14,615,835,2042,246,266,268,0,,0,0.0,0.0,0.0,0.0,0.0
2024,3,15,5,2024-03-15,DL,8897,LAX,HNL,"Los Angeles, CA",California,"Honolulu, HI",Hawaii,540,1895,4,0,544,1895,23,19,567,1876,2154,265,285,307,0,,0,0.0,0.0,0.0,0.0,0.0
2024,6,13,4,2024-06-13,9E,8866,LAS,JFK,"Las Vegas, NV",Nevada,"New York, NY",New York,934,742,4,10,938,752,13,3,951,749,2093,270,290,286,0,,0,0.0,0.0,0.0,0.0,0.0
2024,10,4,5,2024-10-04,G4,1277,SLC,EWR,"Salt Lake City, UT",Utah,"Newark, NJ",New Jersey,1857,1553,24,30,1881,1583,26,16,1907,1567,2779,337,357,379,0,,0,9.0,6.0,3.0,0.0,12.0
2024,11,19,2,2024-11-19,YX,3522,DEN,HNL,"Denver, CO",Colorado,"Honolulu, HI",Hawaii,1803,2342,-7,0,1796,2342,23,8,1819,2334,1169,144,164,175,0,,0,0.0,0.0,0.0,0.0,0.0
2024,10,26,6,2024-10-26,HA,2694,ORD,DTW,"Chicago, IL",Illinois,"Detroit, MI",Michigan,2065,718,-13,-15,2052,703,12,14,2064,689,1876,224,244,250,0,,0,0.0,0.0,0.0,0.0,0.0
2024,10,16,3,2024-10-16,F9,8603,IAD,MDW,"Washington, DC",District of Columbia,"Chicago, IL",Illinois,2029,1195,2,-5,2031,1190,29,15,2060,1175,828,93,113,137,0,,0,0.0,0.0,0.0,0.0,0.0
2024,3,17,7,2024-03-17,HA,864,LGA,BOS,"New York, NY",New York,"Boston, MA",Massachusetts,1766,1874,-30,-20,1736,1854,8,8,1744,1846,2783,343,363,359,0,,0,0.0,0.0,0.0,0.0,0.0
2024,10,24,4,2024-10-24,HA,7936,ORD,SEA,"Chicago, IL",Illinois,"Seattle, WA",Washington,2087,1901,2,10,2089,1911,17,19,2106,1892,1137,140,160,176,0,,0,0.0,0.0,0.0,0.0,0.0
2024,5,16,4,2024-05-16,OH,6377,MSP,SEA,"Minneapolis, MN",Minnesota,"Seattle, WA",Washington,1445,762,-24,-20,1421,742,25,3,1446,739,1158,149,169,177,0,,0,0.0,0.0,0.0,0.0,0.0
2024,4,15,1,2024-04-15,AS,535,SEA,DCA,"Seattle, WA",Washington,"Washington, DC",District of Columbia,2092,1253,-10,0,2082,1253,23,13,2105,1240,1338,174,194,210,0,,0,0.0,0.0,0.0,0.0,0.0
2024,4,4,4,2024-04-04,OH,3451,BOS,SAN,"Boston, MA",Massachusetts,"San Diego, CA",California,1201,949,-12,-15,1189,934,18,7,1207,927,2180,280,300,305,0,,0,0.0,0.0,0.0,0.0,0.0
2024,5,14,2,2024-05-14,AS,3030,CLT,DFW,"Charlotte, NC",North Carolina,"Dallas/Fort Worth, TX",Texas,1602,630,-16,-20,1586,610,9,9,1595,601,2578,325,345,343,0,,0,0.0,0.0,0.0,0.0,0.0
2024,3,8,5,2024-03-08,OH,234,DCA,MDW,"Washington, DC",District of Columbia,"Chicago, IL",Illinois,936,1057,-5,-10,931,1047,22,3,953,1044,1158,147,167,172,0,,0,0.0,0.0,0.0,0.0,0.0
2024,5,26,7,2024-05-26,AA,4718,SAN,MDW,"San Diego, CA",California,"Chicago, IL",Illinois,1207,690,-6,0,1201,690,22,17,1223,673,2112,258,278,297,0,,0,0.0,0.0,0.0,0.0,0.0
2024,6,7,5,2024-06-07,DL,9095,PHX,CLT,"Phoenix, AZ",Arizona,"Charlotte, NC",North Carolina,1984,727,-23,-15,1961,712,25,13,1986,699,1627,198,218,236,0,,0,0.0,0.0,0.0,0.0,0.0
2024,6,11,2,2024-06-11,WN,2466,IAD,STL,"Washington, DC",District of Columbia,"St. Louis, MO",Missouri,1720,1378,6,0,1726,1378,19,3,1745,1375,2007,258,278,280,0,,0,0.0,0.0,0.0,0.0,0.0
2024,12,6,5,2024-12-06,UA,9768,EWR,BOS,"Newark, NJ",New Jersey,"Boston, MA",Massachusetts,1554,2171,-1,5,1553,2176,27,4,1580,2172,746,88,108,119,0,,0,0.0,0.0,0.0,0.0,0.0
2024,7,7,7,2024-07-07,OH,3515,HNL,LAS,"Honolulu, HI",Hawaii,"Las Vegas, NV",Nevada,529,1569,10,20,539,1589,21,12,560,1577,2708,332,352,365,0,,0,6.0,0.0,3.0,0.0,11.0
2024,12,4,3,2024-12-04,AA,1106,PHX,STL,"Phoenix, AZ",Arizona,"St. Louis, MO",Missouri,1636,1447,12,10,1648,1457,7,14,1655,1443,2512,314,334,335,0,,0,0.0,0.0,0.0,0.0,0.0
2024,4,4,4,2024-04-04,F9,8008,DCA,MIA,"Washington, DC",District of Columbia,"Miami, FL",Florida,2173,1391,7,0,2180,1391,5,9,2185,1382,2667,329,349,343,0,,0,0.0,0.0,0.0,0.0,0.0
2024,6,29,6,2024-06-29,NK,9284,ORD,MIA,"Chicago, IL",Illinois,"Miami, FL",Florida,2257,2348,-5,5,2252,2353,28,15,2280,2338,1597,198,218,241,0,,0,0.0,0.0,0.0,0.0,0.0
2024,10,14,1,2024-10-14,WN,4791,SAN,DFW,"San Diego, CA",California,"Dallas/Fort Worth, TX",Texas,1485,1108,3,-5,1488,1103,22,4,1510,1099,213,33,53,59,0,,0,0.0,0.0,0.0,0.0,0.0
2024,11,17,7,2024-11-17,YX,7769,SFO,BWI,"San Francisco, CA",California,"Baltimore, MD",Maryland,1183,1535,-5,0,1178,1535,26,8,1204,1527,2162,267,287,301,1,,0,0.0,0.0,0.0,0.0,0.0
2024,7,5,5,2024-07-05,YX,7929,JFK,ORD,"New York, NY",New York,"Chicago, IL",Illinois,889,1344,-7,-5,882,1339,20,9,902,1330,2323,280,300,309,0,,0,0.0,0.0,0.0,0.0,0.0
2024,5,17,5,2024-05-17,G4,1996,PHX,JFK,"Phoenix, AZ",Arizona,"New York, NY",New York,2190,1339,-2,-5,2188,1334,10,4,2198,1330,1758,223,243,237,0,,0,0.0,0.0,0.0,0.0,0.0
2024,5,9,4,2024-05-09,OO,3165,MDW,HNL,"Chicago, IL",Illinois,"Honolulu, HI",Hawaii,775,836,5,5,780,841,13,19,793,822,376,47,67,79,0,,0,0.0,0.0,0.0,0.0,0.0
2024,7,12,5,2024-07-12,OH,2848,HNL,ORD,"Honolulu, HI",Hawaii,"Chicago, IL",Illinois,1743,2156,-17,-10,1726,2146,26,4,1752,2142,1703,219,239,249,0,,0,0.0,0.0,0.0,0.0,0.0
2024,11,11,1,2024-11-11,WN,6792,LGA,SLC,"New York, NY",New York,"Salt Lake City, UT",Utah,1799,2231,-9,-5,1790,2226,14,11,1804,2215,712,81,101,106,0,,0,0.0,0.0,0.0,0.0,0.0
2024,9,29,7,2024-09-29,AA,2761,TPA,MSP,"Tampa, FL",Florida,"Minneapolis, MN",Minnesota,511,1612,2,-5,513,1607,26,13,539,1594,761,103,123,142,0,,0,0.0,0.0,0.0,0.0,0.0
2024,12,17,2,2024-12-17,HA,3078,SAN,DTW,"San Diego, CA",California,"Detroit, MI",Michigan,2016,1576,17,10,2033,1586,21,16,2054,1570,2450,308,328,345,0,,0,0.0,0.0,0.0,0.0,0.0
2024,5,23,4,2024-05-23,9E,7049,SFO,CLT,"San Francisco, CA",California,"Charlotte, NC",North Carolina,2120,1622,-15,-10,2105,1612,11,7,2116,1605,2532,324,344,342,0,,0,0.0,0.0,0.0,0.0,0.0
2024,1,16,2,2024-01-16,HA,6475,HNL,DEN,"Honolulu, HI",Hawaii,"Denver, CO",Colorado,2257,1674,-11,-5,2246,1669,18,3,2264,1666,201,25,45,46,0,,0,0.0,0.0,0.0,0.0,0.0
2024,10,28,1,2024-10-28,AA,6559,EWR,MIA,"Newark, NJ",New Jersey,"Miami, FL",Florida,548,1068,5,10,553,1078,18,4,571,1074,279,28,48,50,0,,0,0.0,0.0,0.0,0.0,0.0
2024,9,1,7,2024-09-01,AA,6207,IAH,TPA,"Houston, TX",Texas,"Tampa, FL",Florida,2215,987,-29,-20,2186,967,16,13,2202,954,1377,174,194,203,0,,0,0.0,0.0,0.0,0.0,0.0
2024,4,16,2,2024-04-16,AA,6601,LAX,TPA,"Los Angeles, CA",California,"Tampa, FL",Florida,509,1685,6,15,515,1700,10,16,525,1684,1298,154,174,180,0,,0,0.0,0.0,0.0,0.0,0.0
2024,3,28,4,2024-03-28,WN,2761,EWR,JFK,"Newark, NJ",New Jersey,"New York, NY",New York,760,1966,0,10,760,1976,18,7,778,1969,462,66,86,91,0,,0,0.0,0.0,0.0,0.0,0.0
2024,5,8,3,2024-05-08,AA,6265,PHX,STL,"Phoenix, AZ",Arizona,"St. Louis, MO",Missouri,819,1776,2,-5,821,1771,12,3,833,1768,1901,243,263,258,0,,0,0.0,0.0,0.0,0.0,0.0
2024,12,6,5,2024-12-06,DL,8310,SLC,TPA,"Salt Lake City, UT",Utah,"Tampa, FL",Florida,685,1335,4,5,689,1340,21,12,710,1328,2029,245,265,278,0,,0,0.0,0.0,0.0,0.0,0.0
2024,1,4,4,2024-01-04,WN,3458,TPA,IAD,"Tampa, FL",Florida,"Washington, DC",District of Columbia,728,1253,41,45,769,1298,12,7,781,1291,1915,232,252,251,0,,0,4.0,9.0,6.0,0.0,26.0
2024,11,22,5,2024-11-22,NK,375,PDX,SEA,"Portland, OR",Oregon,"Seattle, WA",Washington,1169,640,-9,0,1160,640,12,11,1172,629,2553,309,329,332,0,,0,0.0,0.0,0.0,0.0,0.0
2024,11,1,5,2024-11-01,DL,4178,SAN,PHL,"San Diego, CA",California,"Philadelphia, PA",Pennsylvania,1284,2109,-7,-15,1277,2094,21,15,1298,2079,655,77,97,113,0,,0,0.0,0.0,0.0,0.0,0.0
2024,4,4,4,2024-04-04,F9,4854,TPA,CLT,"Tampa, FL",Florida,"Charlotte, NC",North Carolina,1334,1552,9,10,1343,1562,15,15,1358,1547,513,73,93,103,0,,0,0.0,0.0,0.0,0.0,0.0
2024,7,27,6,2024-07-27,MQ,4798,STL,MSP,"St. Louis, MO",Missouri,"Minneapolis, MN",Minnesota,520,2301,-14,-15,506,2286,11,6,517,2280,2351,296,316,313,0,,0,0.0,0.0,0.0,0.0,0.0
2024,8,12,1,2024-08-12,NK,464,LGA,DEN,"New York, NY",New York,"Denver, CO",Colorado,515,2325,-9,-10,506,2315,27,18,533,2297,996,124,144,169,0,,0,0.0,0.0,0.0,0.0,0.0
2024,12,13,5,2024-12-13,G4,894,MIA,DFW,"Miami, FL",Florida,"Dallas/Fort Worth, TX",Texas,979,1408,14,10,993,1418,11,6,1004,1412,1259,165,185,182,0,,0,0.0,0.0,0.0,0.0,0.0
2024,11,16,6,2024-11-16,OH,6895,TPA,MCO,"Tampa, FL",Florida,"Orlando, FL",Florida,2150,2180,-3,-10,2147,2170,16,13,2163,2157,461,59,79,88,0,,0,0.0,0.0,0.0,0.0,0.0
2024,2,16,5,2024-02-16,AS,5970,MSP,PHX,"Minneapolis, MN",Minnesota,"Phoenix, AZ",Arizona,505,2343,-5,5,500,2348,20,6,520,2342,2326,287,307,313,0,,0,0.0,0.0,0.0,0.0,0.0
2024,6,29,6,2024-06-29,WN,689,LAX,EWR,"Los Angeles, CA",California,"Newark, NJ",New Jersey,797,981,-10,-5,787,976,17,4,804,972,2404,294,314,315,0,,0,0.0,0.0,0.0,0.0,0.0
2024,4,15,1,2024-04-15,AS,4394,SEA,ATL,"Seattle, WA",Washington,"Atlanta, GA",Georgia,1411,695,3,5,1414,700,19,19,1433,681,534,73,93,111,0,,0,0.0,0.0,0.0,0.0,0.0
2024,7,17,3,2024-07-17,HA,4413,DTW,SFO,"Detroit, MI",Michigan,"San Francisco, CA",California,1440,1511,-15,-10,1425,1501,23,14,1448,1487,2259,285,305,322,0,,0,0.0,0.0,0.0,0.0,0.0
2024,4,15,1,2024-04-15,WN,9032,ORD,MDW,"Chicago, IL",Illinois,"Chicago, IL",Illinois,758,1386,-10,-5,748,1381,7,14,755,1367,2047,261,281,282,0,,0,0.0,0.0,0.0,0.0,0.0
2024,10,6,7,2024-10-06,NK,4845,CLT,MIA,"Charlotte, NC",North Carolina,"Miami, FL",Florida,1513,892,-10,-5,1503,887,15,10,1518,877,1095,137,157,162,0,,0,0.0,0.0,0.0,0.0,0.0
2024,9,16,1,2024-09-16,G4,7477,BOS,LGA,"Boston, MA",Massachusetts,"New York, NY",New York,1563,1858,-5,-10,1558,1848,28,12,1586,1836,2765,342,362,382,0,,1,0.0,0.0,0.0,0.0,0.0
2024,4,17,3,2024-04-17,UA,8961,LGA,EWR,"New York, NY",New York,"Newark, NJ",New Jersey,775,940,-1,-5,774,935,12,19,786,916,1147,135,155,166,0,,0,0.0,0.0,0.0,0.0,0.0
2024,1,19,5,2024-01-19,UA,1537,BWI,MCO,"Baltimore, MD",Maryland,"Orlando, FL",Florida,1243,1318,-8,-5,1235,1313,12,6,1247,1307,1260,152,172,170,0,,0,0.0,0.0,0.0,0.0,0.0
2024,10,22,2,2024-10-22,DL,9147,STL,TPA,"St. Louis, MO",Missouri,"Tampa, FL",Florida,1018,1556,11,20,1029,1576,16,15,1045,1561,1327,166,186,197,0,,0,6.0,4.0,1.0,0.0,9.0
2024,11,1,5,2024-11-01,AA,4133,MDW,DCA,"Chicago, IL",Illinois,"Washington, DC",District of Columbia,1326,1137,0,0,1326,1137,7,15,1333,1122,1262,163,183,185,0,,0,0.0,0.0,0.0,0.0,0.0
2024,6,19,3,2024-06-19,OH,1993,DTW,BWI,"Detroit, MI",Michigan,"Baltimore, MD",Maryland,1104,1973,-2,0,1102,1973,24,4,1126,1969,2414,294,314,322,0,,0,0.0,0.0,0.0,0.0,0.0
2024,11,26,2,2024-11-26,AA,7619,LGA,DEN,"New York, NY",New York,"Denver, CO",Colorado,2034,1471,5,0,2039,1471,6,15,2045,1456,1790,214,234,235,0,,0,0.0,0.0,0.0,0.0,0.0
2024,7,13,6,2024-07-13,MQ,9478,LGA,DFW,"New York, NY",New York,"Dallas/Fort Worth, TX",Texas,1831,1830,51,60,1882,1890,7,18,1889,1872,2933,356,376,381,0,,0,23.0,4.0,10.0,0.0,23.0
2024,1,12,5,2024-01-12,UA,1942,EWR,PHX,"Newark, NJ",New Jersey,"Phoenix, AZ",Arizona,2056,1559,5,5,2061,1564,20,15,2081,1549,2812,359,379,394,0,,0,0.0,0.0,0.0,0.0,0.0
2024,7,13,6,2024-07-13,OH,6344,EWR,MCO,"Newark, NJ",New Jersey,"Orlando, FL",Florida,1448,2114,11,5,1459,2119,25,6,1484,2113,2180,279,299,310,0,,0,0.0,0.0,0.0,0.0,0.0
2024,10,9,3,2024-10-09,NK,426,MSP,CLT,"Minneapolis, MN",Minnesota,"Charlotte, NC",North Carolina,979,980,-10,-5,969,975,23,11,992,964,721,81,101,115,0,,0,0.0,0.0,0.0,0.0,0.0
2024,6,30,7,2024-06-30,HA,2500,SLC,MCO,"Salt Lake City, UT",Utah,"Orlando, FL",Florida,913,1764,-5,0,908,1764,24,14,932,1750,2154,265,285,303,0,,0,0.0,0.0,0.0,0.0,0.0
2024,10,31,4,2024-10-31,OO,8206,PHL,DTW,"Philadelphia, PA",Pennsylvania,"Detroit, MI",Michigan,1498,1458,-12,-10,1486,1448,11,8,1497,1440,2572,321,341,340,0,,0,0.0,0.0,0.0,0.0,0.0
2024,5,23,4,2024-05-23,G4,4378,DFW,MIA,"Dallas/Fort Worth, TX",Texas,"Miami, FL",Florida,2046,1198,-5,5,2041,1203,23,8,2064,1195,1214,152,172,183,0,,0,0.0,0.0,0.0,0.0,0.0
2024,11,11,1,2024-11-11,OH,4650,DEN,LAS,"Denver, CO",Colorado,"Las Vegas, NV",Nevada,1988,1529,-4,-5,1984,1524,5,8,1989,1516,206,33,53,46,0,,0,0.0,0.0,0.0,0.0,0.0
2024,6,30,7,2024-06-30,DL,7600,TPA,MSP,"Tampa, FL",Florida,"Minneapolis, MN",Minnesota,1932,2233,5,5,1937,2238,17,15,1954,2223,2157,264,284,296,0,,0,0.0,0.0,0.0,0.0,0.0
2024,1,30,2,2024-01-30,NK,4115,LAS,JFK,"Las Vegas, NV",Nevada,"New York, NY",New York,1573,1646,-4,-10,1569,1636,18,6,1587,1630,1743,215,235,239,0,,0,0.0,0.0,0.0,0.0,0.0
2024,3,24,7,2024-03-24,AA,5552,DFW,SEA,"Dallas/Fort Worth, TX",Texas,"Seattle, WA",Washington,1276,1361,-9,-5,1267,1356,5,19,1272,1337,1070,138,158,162,0,,0,0.0,0.0,0.0,0.0,0.0
2024,6,14,5,2024-06-14,DL,4406,MCO,PHL,"Orlando, FL",Florida,"Philadelphia, PA",Pennsylvania,544,963,-7,0,537,963,8,5,545,958,1979,255,275,268,0,,0,0.0,0.0,0.0,0.0,0.0
2024,10,10,4,2024-10-10,AS,8342,IAH,LAS,"Houston, TX",Texas,"Las Vegas, NV",Nevada,1329,1771,-12,-10,1317,1761,21,10,1338,1751,1092,140,160,171,0,,0,0.0,0.0,0.0,0.0,0.0
2024,10,7,1,2024-10-07,OO,9760,STL,DEN,"St. Louis, MO",Missouri,"Denver, CO",Colorado,1794,1165,-7,-15,1787,1150,10,3,1797,1147,353,35,55,48,0,,0,0.0,0.0,0.0,0.0,0.0
2024,4,5,5,2024-04-05,B6,7926,JFK,SAN,"New York, NY",New York,"San Diego, CA",California,774,1568,-1,-5,773,1563,24,3,797,1560,461,60,80,87,0,,0,0.0,0.0,0.0,0.0,0.0
2024,9,22,7,2024-09-22,F9,9301,PHL,CLT,"Philadelphia, PA",Pennsylvania,"Charlotte, NC",North Carolina,1946,1426,-5,0,1941,1426,25,7,1966,1419,2049,263,283,295,0,,0,0.0,0.0,0.0,0.0,0.0
2024,10,24,4,2024-10-24,YX,6883,SFO,SLC,"San Francisco, CA",California,"Salt Lake City, UT",Utah,1558,2174,-2,5,1556,2179,10,3,1566,2176,557,63,83,76,0,,0,0.0,0.0,0.0,0.0,0.0
2024,10,22,2,2024-10-22,OO,3657,BWI,SFO,"Baltimore, MD",Maryland,"San Francisco, CA",California,2027,1104,-11,-5,2016,1099,6,19,2022,1080,209,21,41,46,0,,0,0.0,0.0,0.0,0.0,0.0
2024,8,12,1,2024-08-12,DL,9366,PDX,MDW,"Portland, OR",Oregon,"Chicago, IL",Illinois,2011,817,2,0,2013,817,21,3,2034,814,1071,142,162,166,0,,0,0.0,0.0,0.0,0.0,0.0
2024,11,28,4,2024-11-28,AA,253,STL,DTW,"St. Louis, MO",Missouri,"Detroit, MI",Michigan,1152,1081,-6,0,1146,1081,20,6,1166,1075,2268,278,298,304,0,,0,0.0,0.0,0.0,0.0,0.0
2024,12,26,4,2024-12-26,NK,8873,LAX,HNL,"Los Angeles, CA",California,"Honolulu, HI",Hawaii,643,2039,-9,0,634,2039,16,7,650,2032,2082,269,289,292,0,,0,0.0,0.0,0.0,0.0,0.0
2024,2,11,7,2024-02-11,AS,887,DFW,STL,"Dallas/Fort Worth, TX",Texas,"St. Louis, MO",Missouri,1334,1536,-15,-15,1319,1521,16,10,1335,1511,2067,259,279,285,0,,0,0.0,0.0,0.0,0.0,0.0
2024,10,29,2,2024-10-29,F9,4986,CLT,BOS,"Charlotte, NC",North Carolina,"Boston, MA",Massachusetts,1256,1348,2,-5,1258,1343,22,17,1280,1326,2532,310,330,349,0,,0,0.0,0.0,0.0,0.0,0.0
2024,9,2,1,2024-09-02,OO,3481,MIA,PHL,"Miami, FL",Florida,"Philadelphia, PA",Pennsylvania,692,1948,-6,-10,686,1938,20,15,706,1923,1989,244,264,279,0,,0,0.0,0.0,0.0,0.0,0.0
2024,7,26,5,2024-07-26,HA,7666,DTW,IAD,"Detroit, MI",Michigan,"Washington, DC",District of Columbia,1046,1435,6,0,1052,1435,10,9,1062,1426,1825,219,239,238,0,,0,0.0,0.0,0.0,0.0,0.0
2024,8,24,6,2024-08-24,HA,6377,IAH,SFO,"Houston, TX",Texas,"San Francisco, CA",California,1283,1088,11,5,1294,1093,17,16,1311,1077,441,53,73,86,0,,0,0.0,0.0,0.0,0.0,0.0
2024,1,22,1,2024-01-22,MQ,2367,MCO,ORD,"Orlando, FL",Florida,"Chicago, IL",Illinois,677,2031,9,0,686,2031,29,6,715,2025,801,94,114,129,0,,0,0.0,0.0,0.0,0.0,0.0
2024,7,3,3,2024-07-03,OH,4358,IAH,CLT,"Houston, TX",Texas,"Charlotte, NC",North Carolina,1281,1767,-2,-10,1279,1757,20,4,1299,1753,1082,133,153,157,0,,0,0.0,0.0,0.0,0.0,0.0
2024,8,29,4,2024-08-29,F9,1070,BWI,DFW,"Baltimore, MD",Maryland,"Dallas/Fort Worth, TX",Texas,817,1399,-1,-10,816,1389,28,19,844,1370,1749,226,246,273,0,,0,0.0,0.0,0.0,0.0,0.0
2024,12,28,6,2024-12-28,DL,8939,PDX,DEN,"Portland, OR",Oregon,"Denver, CO",Colorado,1914,810,-15,-20,1899,790,14,18,1913,772,1888,232,252,264,0,,0,0.0,0.0,0.0,0.0,0.0
2024,10,9,3,2024-10-09,OH,1045,ORD,EWR,"Chicago, IL",Illinois,"Newark, NJ",New Jersey,650,1265,-5,-5,645,1260,15,8,660,1252,878,110,130,133,0,,0,0.0,0.0,0.0,0.0,0.0
2024,2,10,6,2024-02-10,F9,5718,DEN,MSP,"Denver, CO",Colorado,"Minneapolis, MN",Minnesota,1110,858,1,-5,1111,853,5,16,1116,837,2818,349,369,370,0,,0,0.0,0.0,0.0,0.0,0.0
2024,12,1,7,2024-12-01,AS,8291,HNL,BWI,"Honolulu, HI",Hawaii,"Baltimore, MD",Maryland,1970,1850,-13,-10,1957,1840,25,3,1982,1837,399,50,70,78,0,,0,0.0,0.0,0.0,0.0,0.0
2024,6,10,1,2024-06-10,G4,1595,MSP,IAH,"Minneapolis, MN",Minnesota,"Houston, TX",Texas,1040,2217,2,5,1042,2222,11,14,1053,2208,1925,234,254,259,0,,0,0.0,0.0,0.0,0.0,0.0
2024,6,8,6,2024-06-08,YX,2147,MCO,LGA,"Orlando, FL",Florida,"New York, NY",New York,649,971,-4,-5,645,966,28,18,673,948,2710,343,363,389,0,,0,0.0,0.0,0.0,0.0,0.0
2024,3,29,5,2024-03-29,NK,9464,SAN,LAX,"San Diego, CA",California,"Los Angeles, CA",California,1731,2014,9,5,1740,2019,27,11,1767,2008,1378,170,190,208,0,,0,0.0,0.0,0.0,0.0,0.0
2024,11,17,7,2024-11-17,DL,2986,MCO,ORD,"Orlando, FL",Florida,"Chicago, IL",Illinois,1872,1591,-7,0,1865,1591,21,18,1886,1573,1584,190,210,229,0,,0,0.0,0.0,0.0,0.0,0.0
2024,1,12,5,2024-01-12,F9,5288,PHL,STL,"Philadelphia, PA",Pennsylvania,"St. Louis, MO",Missouri,761,687,-3,0,758,687,16,15,774,672,1194,146,166,177,0,,0,0.0,0.0,0.0,0.0,0.0
2024,3,13,3,2024-03-13,G4,4258,LAX,DCA,"Los Angeles, CA",California,"Washington, DC",District of Columbia,2245,999,19,15,2264,1014,24,3,2288,1011,2892,361,381,388,0,,0,0.0,0.0,0.0,0.0,0.0
2024,3,16,6,2024-03-16,NK,9024,SAN,MCO,"San Diego, CA",California,"Orlando, FL",Florida,912,908,-26,-20,886,888,24,5,910,883,1915,246,266,275,0,,0,0.0,0.0,0.0,0.0,0.0
2024,12,11,3,2024-12-11,WN,3561,DFW,STL,"Dallas/Fort Worth, TX",Texas,"St. Louis, MO",Missouri,1612,603,-16,-15,1596,588,19,17,1615,571,956,118,138,154,0,,0,0.0,0.0,0.0,0.0,0.0
2024,7,19,5,2024-07-19,G4,6833,SFO,SAN,"San Francisco, CA",California,"San Diego, CA",California,2272,1796,14,5,2286,1801,13,18,2299,1783,539,57,77,88,0,,0,0.0,0.0,0.0,0.0,0.0
2024,1,10,3,2024-01-10,WN,1757,BOS,SFO,"Boston, MA",Massachusetts,"San Francisco, CA",California,2283,2167,3,-5,2286,2162,26,16,2312,2146,1918,243,263,285,0,,0,0.0,0.0,0.0,0.0,0.0
2024,12,17,2,2024-12-17,YX,5143,PHX,ATL,"Phoenix, AZ",Arizona,"Atlanta, GA",Georgia,1781,825,34,30,1815,855,10,3,1825,852,2863,356,376,369,0,,0,6.0,2.0,4.0,0.0,18.0
2024,8,13,2,2024-08-13,WN,6460,MSP,PHL,"Minneapolis, MN",Minnesota,"Philadelphia, PA",Pennsylvania,991,938,-15,-10,976,928,9,3,985,925,2826,354,374,366,0,,0,0.0,0.0,0.0,0.0,0.0
2024,6,24,1,2024-06-24,G4,578,DCA,DEN,"Washington, DC",District of Columbia,"Denver, CO",Colorado,2227,1829,-12,-10,2215,1819,9,7,2224,1812,2795,357,377,373,0,,0,0.0,0.0,0.0,0.0,0.0
2024,10,2,3,2024-10-02,OH,9429,PDX,DTW,"Portland, OR",Oregon,"Detroit, MI",Michigan,2131,1725,-5,0,2126,1725,13,7,2139,1718,1624,195,215,215,0,,0,0.0,0.0,0.0,0.0,0.0
2024,2,8,4,2024-02-08,F9,4053,CLT,MIA,"Charlotte, NC",North Carolina,"Miami, FL",Florida,2071,657,-12,-10,2059,647,6,10,2065,637,1592,189,209,205,0,,0,0.0,0.0,0.0,0.0,0.0
2024,2,29,4,2024-02-29,WN,9268,SFO,ORD,"San Francisco, CA",California,"Chicago, IL",Illinois,1619,1773,-8,-5,1611,1768,14,3,1625,1765,236,21,41,38,0,,0,0.0,0.0,0.0,0.0,0.0
2024,3,6,3,2024-03-06,OH,8528,SEA,PHX,"Seattle, WA",Washington,"Phoenix, AZ",Arizona,1500,1875,20,15,1520,1890,9,3,1529,1887,2424,293,313,305,0,,0,0.0,0.0,0.0,0.0,0.0
2024,11,16,6,2024-11-16,F9,4143,MCO,TPA,"Orlando, FL",Florida,"Tampa, FL",Florida,1927,2102,-21,-20,1906,2082,21,16,1927,2066,647,73,93,110,0,,0,0.0,0.0,0.0,0.0,0.0
2024,5,3,5,2024-05-03,HA,697,DCA,LGA,"Washington, DC",District of Columbia,"New York, NY",New York,1962,1155,-2,0,1960,1155,25,13,1985,1142,384,47,67,85,0,,0,0.0,0.0,0.0,0.0,0.0
2024,6,12,3,2024-06-12,F9,9994,LGA,MCO,"New York, NY",New York,"Orlando, FL",Florida,536,2051,-8,-5,528,2046,8,12,536,2034,905,117,137,137,0,,0,0.0,0.0,0.0,0.0,0.0
2024,6,7,5,2024-06-07,NK,8456,SEA,BWI,"Seattle, WA",Washington,"Baltimore, MD",Maryland,2269,2165,-2,-5,2267,2160,8,12,2275,2148,1984,246,266,266,0,,0,0.0,0.0,0.0,0.0,0.0
2024,2,26,1,2024-02-26,9E,2424,EWR,BWI,"Newark, NJ",New Jersey,"Baltimore, MD",Maryland,2137,1518,-14,-10,2123,1508,17,15,2140,1493,2110,266,286,298,0,,0,0.0,0.0,0.0,0.0,0.0
2024,3,18,1,2024-03-18,MQ,7399,DCA,MCO,"Washington, DC",District of Columbia,"Orlando, FL",Florida,980,1123,-15,-15,965,1108,24,11,989,1097,1234,160,180,195,0,,0,0.0,0.0,0.0,0.0,0.0
2024,7,12,5,2024-07-12,AS,669,EWR,DFW,"Newark, NJ",New Jersey,"Dallas/Fort Worth, TX",Texas,679,2114,-11,-20,668,2094,23,11,691,2083,557,78,98,112,0,,0,0.0,0.0,0.0,0.0,0.0
2024,10,11,5,2024-10-11,F9,3428,DTW,PHX,"Detroit, MI",Michigan,"Phoenix, AZ",Arizona,1848,1125,35,30,1883,1155,10,10,1893,1145,1178,156,176,176,0,,0,0.0,1.0,5.0,0.0,24.0
2024,1,15,1,2024-01-15,NK,240,ORD,LAS,"Chicago, IL",Illinois,"Las Vegas, NV",Nevada,1081,1915,11,5,1092,1920,23,15,1115,1905,868,98,118,136,0,,0,0.0,0.0,0.0,0.0,0.0
2024,1,12,5,2024-01-12,B6,8977,BWI,DTW,"Baltimore, MD",Maryland,"Detroit, MI",Michigan,1929,1668,2,5,1931,1673,26,9,1957,1664,1300,163,183,198,0,,0,0.0,0.0,0.0,0.0,0.0
2024,4,10,3,2024-04-10,YX,8978,DCA,EWR,"Washington, DC",District of Columbia,"Newark, NJ",New Jersey,1992,1823,-14,-15,1978,1808,20,4,1998,1804,2396,307,327,331,0,,0,0.0,0.0,0.0,0.0,0.0
2024,6,4,2,2024-06-04,MQ,3380,MCO,SFO,"Orlando, FL",Florida,"San Francisco, CA",California,1478,623,-14,-20,1464,603,10,3,1474,600,1580,191,211,204,0,,0,0.0,0.0,0.0,0.0,0.0
2024,12,5,4,2024-12-05,MQ,2863,PHL,LAS,"Philadelphia, PA",Pennsylvania,"Las Vegas, NV",Nevada,2142,1362,4,0,2146,1362,15,13,2161,1349,2019,257,277,285,0,,0,0.0,0.0,0.0,0.0,0.0
2024,5,4,6,2024-05-04,WN,3690,IAH,CLT,"Houston, TX",Texas,"Charlotte, NC",North Carolina,1794,2254,1,5,1795,2259,14,3,1809,2256,1878,232,252,249,0,,0,0.0,0.0,0.0,0.0,0.0
2024,12,24,2,2024-12-24,OH,2138,LAS,SAN,"Las Vegas, NV",Nevada,"San Diego, CA",California,853,2010,3,-5,856,2005,22,19,878,1986,2210,279,299,320,0,,0,0.0,0.0,0.0,0.0,0.0
2024,10,6,7,2024-10-06,YX,1174,LAX,SAN,"Los Angeles, CA",California,"San Diego, CA",California,2082,2213,1,-5,2083,2208,13,10,2096,2198,1227,151,171,174,0,,0,0.0,0.0,0.0,0.0,0.0
2024,4,19,5,2024-04-19,DL,5722,STL,JFK,"St. Louis, MO",Missouri,"New York, NY",New York,1466,2058,-3,-5,1463,2053,14,11,1477,2042,1222,155,175,180,0,,0,0.0,0.0,0.0,0.0,0.0
2024,11,29,5,2024-11-29,OO,2325,LGA,ATL,"New York, NY",New York,"Atlanta, GA",Georgia,1988,841,-13,-10,1975,831,19,17,1994,814,877,112,132,148,0,,0,0.0,0.0,0.0,0.0,0.0
2024,12,22,7,2024-12-22,F9,7623,DFW,DCA,"Dallas/Fort Worth, TX",Texas,"Washington, DC",District of Columbia,2143,802,8,5,2151,807,28,10,2179,797,2698,333,353,371,0,,0,0.0,0.0,0.0,0.0,0.0
2024,5,25,6,2024-05-25,G4,9633,EWR,DCA,"Newark, NJ",New Jersey,"Washington, DC",District of Columbia,863,836,-13,-10,850,826,18,5,868,821,2751,341,361,364,0,,0,0.0,0.0,0.0,0.0,0.0
2024,8,3,6,2024-08-03,WN,9981,PHX,PHL,"Phoenix, AZ",Arizona,"Philadelphia, PA",Pennsylvania,568,1550,-2,-5,566,1545,20,19,586,1526,2916,365,385,404,0,,0,0.0,0.0,0.0,0.0,0.0
2024,6,10,1,2024-06-10,WN,463,SAN,EWR,"San Diego, CA",California,"Newark, NJ",New Jersey,807,1621,-1,5,806,1626,11,13,817,1613,2002,248,268,272,1,,0,0.0,0.0,0.0,0.0,0.0
2024,5,7,2,2024-05-07,B6,9359,MIA,IAH,"Miami, FL",Florida,"Houston, TX",Texas,922,893,-19,-20,903,873,29,13,932,860,1658,210,230,252,0,,0,0.0,0.0,0.0,0.0,0.0
2024,11,9,6,2024-11-09,DL,2130,DEN,SLC,"Denver, CO",Colorado,"Salt Lake City, UT",Utah,1013,1971,14,5,1027,1976,12,4,1039,1972,2923,373,393,389,0,,0,0.0,0.0,0.0,0.0,0.0
2024,11,27,3,2024-11-27,NK,6785,DFW,IAD,"Dallas/Fort Worth, TX",Texas,"Washington, DC",District of Columbia,718,1710,10,10,728,1720,29,18,757,1702,1186,139,159,186,0,,0,0.0,0.0,0.0,0.0,0.0
2024,5,29,3,2024-05-29,HA,6565,DEN,CLT,"Denver, CO",Colorado,"Charlotte, NC",North Carolina,1568,809,-22,-15,1546,794,12,5,1558,789,1326,164,184,181,0,,0,0.0,0.0,0.0,0.0,0.0
2024,2,5,1,2024-02-05,B6,6891,DFW,HNL,"Dallas/Fort Worth, TX",Texas,"Honolulu, HI",Hawaii,1756,1387,9,0,1765,1387,17,15,1782,1372,682,89,109,121,0,,0,0.0,0.0,0.0,0.0,0.0
2024,6,21,5,2024-06-21,AS,6257,EWR,ATL,"Newark, NJ",New Jersey,"Atlanta, GA",Georgia,2224,2232,-14,-5,2210,2227,23,15,2233,2212,1280,165,185,203,0,,0,0.0,0.0,0.0,0.0,0.0
2024,1,22,1,2024-01-22,WN,717,BOS,MCO,"Boston, MA",Massachusetts,"Orlando, FL",Florida,866,1625,-16,-15,850,1610,14,19,864,1591,588,77,97,110,0,,0,0.0,0.0,0.0,0.0,0.0
2024,7,24,3,2024-07-24,F9,5537,SEA,HNL,"Seattle, WA",Washington,"Honolulu, HI",Hawaii,621,828,4,5,625,833,5,16,630,817,1888,230,250,251,0,,0,0.0,0.0,0.0,0.0,0.0
2024,5,6,1,2024-05-06,F9,2082,BOS,HNL,"Boston, MA",Massachusetts,"Honolulu, HI",Hawaii,994,1009,-4,0,990,1009,26,4,1016,1005,1274,153,173,183,0,,0,0.0,0.0,0.0,0.0,0.0
2024,12,1,7,2024-12-01,YX,5810,SAN,BWI,"San Diego, CA",California,"Baltimore, MD",Maryland,1076,1866,1,0,1077,1866,20,18,1097,1848,1465,174,194,212,0,,0,0.0,0.0,0.0,0.0,0.0
2024,12,21,6,2024-12-21,B6,293,MIA,IAD,"Miami, FL",Florida,"Washington, DC",District of Columbia,1383,1369,15,10,1398,1379,7,10,1405,1369,1644,204,224,221,0,,0,0.0,0.0,0.0,0.0,0.0
2024,8,4,7,2024-08-04,YX,8264,MIA,SEA,"Miami, FL",Florida,"Seattle, WA",Washington,1672,1562,-11,-10,1661,1552,7,12,1668,1540,2318,282,302,301,0,,0,0.0,0.0,0.0,0.0,0.0
2024,4,5,5,2024-04-05,AS,4558,EWR,PHL,"Newark, NJ",New Jersey,"Philadelphia, PA",Pennsylvania,2284,2091,2,5,2286,2096,10,18,2296,2078,1582,187,207,215,0,,0,0.0,0.0,0.0,0.0,0.0
2024,6,12,3,2024-06-12,UA,1219,SEA,DEN,"Seattle, WA",Washington,"Denver, CO",Colorado,1394,1057,2,5,1396,1062,16,9,1412,1053,2250,282,302,307,0,,0,0.0,0.0,0.0,0.0,0.0
2024,5,27,1,2024-05-27,AA,7011,PHX,HNL,"Phoenix, AZ",Arizona,"Honolulu, HI",Hawaii,1999,1153,-16,-10,1983,1143,29,8,2012,1135,1921,230,250,267,0,,0,0.0,0.0,0.0,0.0,0.0
2024,1,18,4,2024-01-18,G4,6640,STL,MSP,"St. Louis, MO",Missouri,"Minneapolis, MN",Minnesota,1078,812,13,20,1091,832,9,6,1100,826,1328,175,195,190,0,,0,0.0,3.0,0.0,0.0,17.0
2024,10,20,7,2024-10-20,G4,626,DCA,SFO,"Washington, DC",District of Columbia,"San Francisco, CA",California,849,985,-4,-5,845,980,20,5,865,975,2831,351,371,376,0,,0,0.0,0.0,0.0,0.0,0.0
2024,7,13,6,2024-07-13,UA,7254,BWI,PHL,"Baltimore, MD",Maryland,"Philadelphia, PA",Pennsylvania,2094,2035,5,5,2099,2040,21,13,2120,2027,1884,233,253,267,0,,0,0.0,0.0,0.0,0.0,0.0
2024,5,30,4,2024-05-30,WN,4979,LGA,DCA,"New York, NY",New York,"Washington, DC",District of Columbia,614,2138,9,5,623,2143,14,12,637,2131,1113,144,164,170,0,,0,0.0,0.0,0.0,0.0,0.0
2024,12,30,1,2024-12-30,MQ,5945,LGA,SLC,"New York, NY",New York,"Salt Lake City, UT",Utah,1127,1127,2,0,1129,1127,11,16,1140,1111,2689,326,346,353,0,,0,0.0,0.0,0.0,0.0,0.0
2024,5,2,4,2024-05-02,NK,8071,TPA,JFK,"Tampa, FL",Florida,"New York, NY",New York,736,2011,-25,-15,711,1996,29,7,740,1989,1755,227,247,263,0,,0,0.0,0.0,0.0,0.0,0.0
2024,7,5,5,2024-07-05,DL,2773,DFW,SAN,"Dallas/Fort Worth, TX",Texas,"San Diego, CA",California,546,1902,-16,-10,530,1892,14,4,544,1888,2735,331,351,349,0,,0,0.0,0.0,0.0,0.0,0.0
2024,5,28,2,2024-05-28,YX,7860,MSP,PDX,"Minneapolis, MN",Minnesota,"Portland, OR",Oregon,2144,1589,-15,-10,2129,1579,6,15,2135,1564,1848,225,245,246,0,,0,0.0,0.0,0.0,0.0,0.0
2024,4,13,6,2024-04-13,UA,7297,MCO,DCA,"Orlando, FL",Florida,"Washington, DC",District of Columbia,773,701,2,0,775,701,19,5,794,696,549,76,96,100,0,,0,0.0,0.0,0.0,0.0,0.0
2024,8,30,5,2024-08-30,AS,5201,TPA,SAN,"Tampa, FL",Florida,"San Diego, CA",California,612,2212,-11,-10,601,2202,29,13,630,2189,2411,299,319,341,0,,0,0.0,0.0,0.0,0.0,0.0
2024,8,18,7,2024-08-18,OO,3626,TPA,SLC,"Tampa, FL",Florida,"Salt Lake City, UT",Utah,1044,989,1,0,1045,989,25,8,1070,981,1255,164,184,197,1,,0,0.0,0.0,0.0,0.0,0.0
2024,7,24,3,2024-07-24,F9,3949,SFO,MCO,"San Francisco, CA",California,"Orlando, FL",Florida,898,1825,-18,-10,880,1815,21,5,901,1810,1549,196,216,222,0,,0,0.0,0.0,0.0,0.0,0.0
2024,7,16,2,2024-07-16,HA,1734,HNL,ATL,"Honolulu, HI",Hawaii,"Atlanta, GA",Georgia,1291,2190,-20,-20,1271,2170,8,3,1279,2167,2884,367,387,378,0,,0,0.0,0.0,0.0,0.0,0.0
2024,12,2,1,2024-12-02,AA,193,PDX,DCA,"Portland, OR",Oregon,"Washington, DC",District of Columbia,1815,2344,-1,-5,1814,2339,12,8,1826,2331,1064,126,146,146,0,,0,0.0,0.0,0.0,0.0,0.0
2024,3,27,3,2024-03-27,WN,3466,DFW,DEN,"Dallas/Fort Worth, TX",Texas,"Denver, CO",Colorado,815,2015,6,0,821,2015,23,8,844,2007,651,74,94,105,0,,0,0.0,0.0,0.0,0.0,0.0
2024,5,21,2,2024-05-21,HA,7816,DFW,PHL,"Dallas/Fort Worth, TX",Texas,"Philadelphia, PA",Pennsylvania,1685,1440,-1,5,1684,1445,25,10,1709,1435,2066,263,283,298,0,,0,0.0,0.0,0.0,0.0,0.0
2024,11,12,2,2024-11-12,AA,3046,IAD,ATL,"Washington, DC",District of Columbia,"Atlanta, GA",Georgia,1613,1977,-26,-20,1587,1957,6,5,1593,1952,1363,172,192,183,0,,0,0.0,0.0,0.0,0.0,0.0
2024,7,17,3,2024-07-17,DL,188,BWI,DFW,"Baltimore, MD",Maryland,"Dallas/Fort Worth, TX",Texas,550,2216,-10,-10,540,2206,25,15,565,2191,2284,277,297,317,0,,0,0.0,0.0,0.0,0.0,0.0
2024,2,15,4,2024-02-15,F9,2650,LAS,BOS,"Las Vegas, NV",Nevada,"Boston, MA",Massachusetts,1947,834,27,30,1974,864,20,19,1994,845,1909,245,265,284,0,,0,7.0,5.0,3.0,0.0,15.0
2024,10,14,1,2024-10-14,AS,6237,LGA,SFO,"New York, NY",New York,"San Francisco, CA",California,1929,713,-10,-10,1919,703,18,16,1937,687,2278,277,297,311,0,,0,0.0,0.0,0.0,0.0,0.0
2024,1,15,1,2024-01-15,G4,6457,IAD,DCA,"Washington, DC",District of Columbia,"Washington, DC",District of Columbia,643,1581,14,5,657,1586,16,5,673,1581,843,99,119,120,0,,0,0.0,0.0,0.0,0.0,0.0
2024,2,13,2,2024-02-13,DL,1545,DFW,DCA,"Dallas/Fort Worth, TX",Texas,"Washington, DC",District of Columbia,2139,1690,4,0,2143,1690,13,6,2156,1684,1878,242,262,261,0,,0,0.0,0.0,0.0,0.0,0.0
2024,6,17,1,2024-06-17,UA,4721,PHL,EWR,"Philadelphia, PA",Pennsylvania,"Newark, NJ",New Jersey,2205,1408,-17,-15,2188,1393,16,5,2204,1388,2477,312,332,333,0,,0,0.0,0.0,0.0,0.0,0.0
2024,11,5,2,2024-11-05,G4,6435,ATL,ORD,"Atlanta, GA",Georgia,"Chicago, IL",Illinois,1027,1663,7,0,1034,1663,7,17,1041,1646,2387,305,325,329,0,,0,0.0,0.0,0.0,0.0,0.0
2024,2,13,2,2024-02-13,G4,1930,SEA,MSP,"Seattle, WA",Washington,"Minneapolis, MN",Minnesota,1656,2356,15,20,1671,2376,27,13,1698,2363,1485,190,210,230,0,,0,4.0,3.0,3.0,0.0,10.0
2024,4,7,7,2024-04-07,MQ,6885,PHL,SAN,"Philadelphia, PA",Pennsylvania,"San Diego, CA",California,2022,702,5,10,2027,712,17,4,2044,708,2053,250,270,271,0,,0,0.0,0.0,0.0,0.0,0.0
2024,9,17,2,2024-09-17,AS,7491,PHX,PHL,"Phoenix, AZ",Arizona,"Philadelphia, PA",Pennsylvania,889,1010,5,5,894,1015,10,15,904,1000,1190,145,165,170,0,,0,0.0,0.0,0.0,0.0,0.0
2024,4,18,4,2024-04-18,OH,654,LAS,IAH,"Las Vegas, NV",Nevada,"Houston, TX",Texas,1693,1918,9,0,1702,1918,6,18,1708,1900,1111,146,166,170,0,,0,0.0,0.0,0.0,0.0,0.0
2024,10,9,3,2024-10-09,HA,2534,ORD,DTW,"Chicago, IL",Illinois,"Detroit, MI",Michigan,2065,2188,-13,-5,2052,2183,11,8,2063,2175,2990,380,400,399,0,,0,0.0,0.0,0.0,0.0,0.0
2024,12,8,7,2024-12-08,UA,8972,JFK,PHL,"New York, NY",New York,"Philadelphia, PA",Pennsylvania,1683,1407,-5,-5,1678,1402,24,17,1702,1385,373,40,60,81,0,,0,0.0,0.0,0.0,0.0,0.0
2024,4,13,6,2024-04-13,B6,7019,HNL,DCA,"Honolulu, HI",Hawaii,"Washington, DC",District of Columbia,2182,2187,-13,-5,2169,2182,18,6,2187,2176,1669,211,231,235,0,,0,0.0,0.0,0.0,0.0,0.0
2024,9,12,4,2024-09-12,HA,5693,MDW,PHL,"Chicago, IL",Illinois,"Philadelphia, PA",Pennsylvania,1318,1660,22,15,1340,1675,10,17,1350,1658,641,79,99,106,0,,0,0.0,0.0,0.0,0.0,0.0
2024,7,24,3,2024-07-24,DL,9923,BOS,ATL,"Boston, MA",Massachusetts,"Atlanta, GA",Georgia,1248,666,-18,-10,1230,656,27,19,1257,637,1131,135,155,181,0,,0,0.0,0.0,0.0,0.0,0.0
2024,11,30,6,2024-11-30,NK,302,BOS,MSP,"Boston, MA",Massachusetts,"Minneapolis, MN",Minnesota,911,1002,4,-5,915,997,13,14,928,983,2276,286,306,313,0,,0,0.0,0.0,0.0,0.0,0.0
2024,2,12,1,2024-02-12,9E,7253,CLT,PHL,"Charlotte, NC",North Carolina,"Philadelphia, PA",Pennsylvania,2210,2297,-6,-5,2204,2292,11,4,2215,2288,2890,362,382,377,0,,0,0.0,0.0,0.0,0.0,0.0
2024,12,18,3,2024-12-18,OO,4642,DTW,BOS,"Detroit, MI",Michigan,"Boston, MA",Massachusetts,2107,805,-12,-5,2095,800,23,7,2118,793,1018,134,154,164,0,,0,0.0,0.0,0.0,0.0,0.0
2024,9,1,7,2024-09-01,F9,8110,JFK,BWI,"New York, NY",New York,"Baltimore, MD",Maryland,883,940,-27,-20,856,920,29,14,885,906,1489,186,206,229,0,,0,0.0,0.0,0.0,0.0,0.0
2024,10,13,7,2024-10-13,AS,9978,JFK,PHX,"New York, NY",New York,"Phoenix, AZ",Arizona,1374,1675,-20,-10,1354,1665,20,11,1374,1654,2844,345,365,376,0,,0,0.0,0.0,0.0,0.0,0.0
2024,12,20,5,2024-12-20,F9,928,STL,PHX,"St. Louis, MO",Missouri,"Phoenix, AZ",Arizona,2162,1025,6,0,2168,1025,17,12,2185,1013,2381,288,308,317,0,,0,0.0,0.0,0.0,0.0,0.0
2024,9,29,7,2024-09-29,DL,7270,BOS,ATL,"Boston, MA",Massachusetts,"Atlanta, GA",Georgia,1396,1555,0,5,1396,1560,10,7,1406,1553,307,29,49,46,1,,0,0.0,0.0,0.0,0.0,0.0
2024,3,23,6,2024-03-23,UA,2122,SAN,MSP,"San Diego, CA",California,"Minneapolis, MN",Minnesota,1207,808,-7,0,1200,808,8,3,1208,805,2919,366,386,377,0,,0,0.0,0.0,0.0,0.0,0.0
2024,4,19,5,2024-04-19,NK,8394,DCA,PDX,"Washington, DC",District of Columbia,"Portland, OR",Oregon,1708,2137,-7,-5,1701,2132,16,4,1717,2128,2867,356,376,376,0,,0,0.0,0.0,0.0,0.0,0.0
2024,7,8,1,2024-07-08,9E,9849,PHX,LGA,"Phoenix, AZ",Arizona,"New York, NY",New York,2185,2264,4,5,2189,2269,25,5,2214,2264,1955,249,269,279,0,,0,0.0,0.0,0.0,0.0,0.0
2024,10,14,1,2024-10-14,YX,4311,MCO,SFO,"Orlando, FL",Florida,"San Francisco, CA",California,713,1801,-1,5,712,1806,14,10,726,1796,2443,310,330,334,0,,0,0.0,0.0,0.0,0.0,0.0
2024,9,7,6,2024-09-07,AA,5054,MIA,EWR,"Miami, FL",Florida,"Newark, NJ",New Jersey,1617,1275,-13,-10,1604,1265,20,14,1624,1251,2692,334,354,368,0,,0,0.0,0.0,0.0,0.0,0.0
2024,7,30,2,2024-07-30,NK,4187,BOS,LGA,"Boston, MA",Massachusetts,"New York, NY",New York,1069,1645,-8,-15,1061,1630,5,12,1066,1618,2456,303,323,320,0,,0,0.0,0.0,0.0,0.0,0.0
2024,10,17,4,2024-10-17,AS,8395,DCA,STL,"Washington, DC",District of Columbia,"St. Louis, MO",Missouri,718,968,7,10,725,978,16,14,741,964,2055,253,273,283,0,,0,0.0,0.0,0.0,0.0,0.0
2024,5,12,7,2024-05-12,F9,6885,DFW,MIA,"Dallas/Fort Worth, TX",Texas,"Miami, FL",Florida,718,1593,7,0,725,1593,24,6,749,1587,2750,342,362,372,0,,0,0.0,0.0,0.0,0.0,0.0
2024,7,19,5,2024-07-19,NK,9098,LGA,SFO,"New York, NY",New York,"San Francisco, CA",California,512,681,-14,-10,498,671,23,6,521,665,1159,146,166,175,0,,0,0.0,0.0,0.0,0.0,0.0
2024,10,11,5,2024-10-11,WN,7266,ATL,PHL,"Atlanta, GA",Georgia,"Philadelphia, PA",Pennsylvania,922,1787,-13,-10,909,1777,26,6,935,1771,931,116,136,148,0,,0,0.0,0.0,0.0,0.0,0.0
2024,11,21,4,2024-11-21,UA,4755,IAD,HNL,"Washington, DC",District of Columbia,"Honolulu, HI",Hawaii,1946,976,1,5,1947,981,29,11,1976,970,2798,352,372,392,0,,0,0.0,0.0,0.0,0.0,0.0
2024,4,4,4,2024-04-04,UA,2174,DTW,SAN,"Detroit, MI",Michigan,"San Diego, CA",California,985,602,13,5,998,607,23,5,1021,602,890,105,125,133,0,,0,0.0,0.0,0.0,0.0,0.0
2024,10,4,5,2024-10-04,HA,8818,MIA,SEA,"Miami, FL",Florida,"Seattle, WA",Washington,1900,1283,15,15,1915,1298,25,3,1940,1295,2497,319,339,347,0,,1,0.0,0.0,0.0,0.0,0.0
2024,11,20,3,2024-11-20,WN,7018,HNL,JFK,"Honolulu, HI",Hawaii,"New York, NY",New York,1467,1741,0,0,1467,1741,22,9,1489,1732,1959,249,269,280,0,,0,0.0,0.0,0.0,0.0,0.0
2024,8,6,2,2024-08-06,HA,3536,JFK,PDX,"New York, NY",New York,"Portland, OR",Oregon,2175,2279,-23,-15,2152,2264,13,10,2165,2254,1021,122,142,145,0,,0,0.0,0.0,0.0,0.0,0.0
2024,3,29,5,2024-03-29,G4,5148,MIA,MDW,"Miami, FL",Florida,"Chicago, IL",Illinois,1931,1363,14,5,1945,1368,28,9,1973,1359,2651,332,352,369,0,,0,0.0,0.0,0.0,0.0,0.0
2024,3,12,2,2024-03-12,G4,8589,PDX,TPA,"Portland, OR",Oregon,"Tampa, FL",Florida,1285,2018,-8,-10,1277,2008,8,14,1285,1994,2368,298,318,320,0,,0,0.0,0.0,0.0,0.0,0.0
2024,9,3,2,2024-09-03,MQ,4972,LAS,EWR,"Las Vegas, NV",Nevada,"Newark, NJ",New Jersey,618,865,-6,-5,612,860,15,5,627,855,1440,171,191,191,0,,0,0.0,0.0,0.0,0.0,0.0
2024,5,8,3,2024-05-08,DL,460,ATL,JFK,"Atlanta, GA",Georgia,"New York, NY",New York,770,1034,-15,-10,755,1024,28,6,783,1018,2221,283,303,317,0,,0,0.0,0.0,0.0,0.0,0.0
2024,7,30,2,2024-07-30,B6,4699,SEA,STL,"Seattle, WA",Washington,"St. Louis, MO",Missouri,1411,1281,-13,-5,1398,1276,20,7,1418,1269,2760,354,374,381,0,,0,0.0,0.0,0.0,0.0,0.0
2024,12,8,7,2024-12-08,AA,6831,DEN,MDW,"Denver, CO",Colorado,"Chicago, IL",Illinois,1620,1324,9,10,1629,1334,24,3,1653,1331,765,104,124,131,0,,0,0.0,0.0,0.0,0.0,0.0
2024,4,5,5,2024-04-05,WN,2177,MDW,DFW,"Chicago, IL",Illinois,"Dallas/Fort Worth, TX",Texas,1341,1392,-9,0,1332,1392,6,12,1338,1380,2244,273,293,291,0,,0,0.0,0.0,0.0,0.0,0.0
2024,3,15,5,2024-03-15,DL,2273,IAH,SLC,"Houston, TX",Texas,"Salt Lake City, UT",Utah,1570,1850,-25,-15,1545,1835,13,5,1558,1830,1174,136,156,154,0,,0,0.0,0.0,0.0,0.0,0.0
2024,2,23,5,2024-02-23,F9,4791,BOS,ATL,"Boston, MA",Massachusetts,"Atlanta, GA",Georgia,1163,975,1,0,1164,975,22,8,1186,967,1705,220,240,250,0,,0,0.0,0.0,0.0,0.0,0.0
2024,12,9,1,2024-12-09,WN,9881,MIA,ATL,"Miami, FL",Florida,"Atlanta, GA",Georgia,1523,1885,-7,0,1516,1885,21,5,1537,1880,2334,292,312,318,0,,0,0.0,0.0,0.0,0.0,0.0
2024,2,23,5,2024-02-23,B6,1489,HNL,PHX,"Honolulu, HI",Hawaii,"Phoenix, AZ",Arizona,672,965,19,10,691,975,21,7,712,968,2724,335,355,363,0,,0,0.0,0.0,0.0,0.0,0.0
2024,8,5,1,2024-08-05,OO,8062,STL,LGA,"St. Louis, MO",Missouri,"New York, NY",New York,1286,1366,10,10,1296,1376,18,4,1314,1372,825,103,123,125,0,,0,0.0,0.0,0.0,0.0,0.0
2024,1,16,2,2024-01-16,WN,6071,IAH,MDW,"Houston, TX",Texas,"Chicago, IL",Illinois,846,1027,-25,-15,821,1012,17,13,838,999,457,55,75,85,0,,0,0.0,0.0,0.0,0.0,0.0
2024,4,8,1,2024-04-08,B6,3614,SEA,DEN,"Seattle, WA",Washington,"Denver, CO",Colorado,736,1631,15,10,751,1641,23,8,774,1633,1775,218,238,249,0,,0,0.0,0.0,0.0,0.0,0.0
2024,1,20,6,2024-01-20,B6,8554,DFW,DCA,"Dallas/Fort Worth, TX",Texas,"Washington, DC",District of Columbia,1436,1664,-20,-15,1416,1649,27,3,1443,1646,1730,222,242,252,0,,0,0.0,0.0,0.0,0.0,0.0
2024,2,15,4,2024-02-15,B6,3019,PHL,EWR,"Philadelphia, PA",Pennsylvania,"Newark, NJ",New Jersey,1042,1880,-6,-10,1036,1870,10,12,1046,1858,2269,277,297,299,0,,0,0.0,0.0,0.0,0.0,0.0
2024,7,11,4,2024-07-11,OO,101,DEN,TPA,"Denver, CO",Colorado,"Tampa, FL",Florida,1736,1242,-16,-15,1720,1227,16,14,1736,1213,258,25,45,55,0,,0,0.0,0.0,0.0,0.0,0.0
2024,2,27,2,2024-02-27,UA,2033,TPA,SEA,"Tampa, FL",Florida,"Seattle, WA",Washington,1795,1163,-13,-10,1782,1153,17,18,1799,1135,1022,121,141,156,0,,0,0.0,0.0,0.0,0.0,0.0
2024,4,20,6,2024-04-20,NK,493,SEA,SAN,"Seattle, WA",Washington,"San Diego, CA",California,906,1725,16,10,922,1735,7,7,929,1728,1494,190,210,204,0,,0,0.0,0.0,0.0,0.0,0.0
2024,5,8,3,2024-05-08,UA,8597,IAH,MCO,"Houston, TX",Texas,"Orlando, FL",Florida,577,1842,7,5,584,1847,20,6,604,1841,2368,291,311,317,0,,0,0.0,0.0,0.0,0.0,0.0
2024,12,2,1,2024-12-02,DL,629,TPA,BWI,"Tampa, FL",Florida,"Baltimore, MD",Maryland,2076,843,3,5,2079,848,25,4,2104,844,916,108,128,137,0,,0,0.0,0.0,0.0,0.0,0.0
2024,7,12,5,2024-07-12,UA,4723,DCA,TPA,"Washington, DC",District of Columbia,"Tampa, FL",Florida,1669,1444,10,15,1679,1459,14,7,1693,1452,2366,297,317,318,0,,0,0.0,0.0,0.0,0.0,0.0
2024,12,5,4,2024-12-05,OO,9256,HNL,IAD,"Honolulu, HI",Hawaii,"Washington, DC",District of Columbia,511,1538,1,-5,512,1533,26,16,538,1517,2405,308,328,350,0,,0,0.0,0.0,0.0,0.0,0.0
2024,11,21,4,2024-11-21,UA,8962,DCA,LAS,"Washington, DC",District of Columbia,"Las Vegas, NV",Nevada,2283,902,-29,-20,2254,882,14,16,2268,866,864,100,120,130,0,,0,0.0,0.0,0.0,0.0,0.0
2024,1,8,1,2024-01-08,F9,4168,CLT,SLC,"Charlotte, NC",North Carolina,"Salt Lake City, UT",Utah,728,969,7,0,735,969,22,15,757,954,1564,192,212,229,0,,0,0.0,0.0,0.0,0.0,0.0
2024,1,29,1,2024-01-29,WN,7607,SAN,LAS,"San Diego, CA",California,"Las Vegas, NV",Nevada,1342,1450,15,10,1357,1460,7,19,1364,1441,2072,262,282,288,0,,0,0.0,0.0,0.0,0.0,0.0
2024,4,21,7,2024-04-21,UA,6595,DCA,LAS,"Washington, DC",District of Columbia,"Las Vegas, NV",Nevada,1464,874,15,20,1479,894,17,15,1496,879,1195,153,173,185,0,,0,1.0,5.0,1.0,0.0,13.0
2024,6,9,7,2024-06-09,9E,7053,ATL,BOS,"Atlanta, GA",Georgia,"Boston, MA",Massachusetts,2214,669,-13,-5,2201,664,20,19,2221,645,622,74,94,113,0,,0,0.0,0.0,0.0,0.0,0.0
2024,5,10,5,2024-05-10,B6,5153,EWR,HNL,"Newark, NJ",New Jersey,"Honolulu, HI",Hawaii,1864,646,2,10,1866,656,8,18,1874,638,233,26,46,52,0,,0,0.0,0.0,0.0,0.0,0.0
2024,7,6,6,2024-07-06,WN,2772,LAS,TPA,"Las Vegas, NV",Nevada,"Tampa, FL",Florida,1171,716,13,10,1184,726,28,6,1212,720,688,88,108,122,0,,0,0.0,0.0,0.0,0.0,0.0
2024,6,11,2,2024-06-11,G4,1813,BWI,JFK,"Baltimore, MD",Maryland,"New York, NY",New York,2256,2213,-16,-15,2240,2198,15,18,2255,2180,1833,223,243,256,0,,0,0.0,0.0,0.0,0.0,0.0
2024,7,15,1,2024-07-15,F9,4144,PDX,DCA,"Portland, OR",Oregon,"Washington, DC",District of Columbia,1338,1116,-1,0,1337,1116,21,6,1358,1110,1400,177,197,204,0,,0,0.0,0.0,0.0,0.0,0.0
2024,12,29,7,2024-12-29,OO,735,DFW,BWI,"Dallas/Fort Worth, TX",Texas,"Baltimore, MD",Maryland,663,1877,-19,-10,644,1867,29,8,673,1859,2172,272,292,309,0,,0,0.0,0.0,0.0,0.0,0.0
2024,7,22,1,2024-07-22,NK,5234,STL,IAD,"St. Louis, MO",Missouri,"Washington, DC",District of Columbia,2203,1431,-9,-5,2194,1426,5,18,2199,1408,2233,279,299,302,0,,0,0.0,0.0,0.0,0.0,0.0
2024,7,30,2,2024-07-30,HA,6719,MSP,MDW,"Minneapolis, MN",Minnesota,"Chicago, IL",Illinois,881,1218,13,10,894,1228,16,12,910,1216,1785,227,247,255,0,,0,0.0,0.0,0.0,0.0,0.0
2024,4,18,4,2024-04-18,F9,9409,SEA,SAN,"Seattle, WA",Washington,"San Diego, CA",California,1230,1355,11,5,1241,1360,7,9,1248,1351,898,116,136,132,0,,0,0.0,0.0,0.0,0.0,0.0
2024,10,2,3,2024-10-02,MQ,7545,STL,TPA,"St. Louis, MO",Missouri,"Tampa, FL",Florida,1081,1796,6,0,1087,1796,23,4,1110,1792,1709,213,233,240,0,,0,0.0,0.0,0.0,0.0,0.0
2024,3,13,3,2024-03-13,B6,6702,LAX,PHL,"Los Angeles, CA",California,"Philadelphia, PA",Pennsylvania,1945,1559,9,10,1954,1569,13,12,1967,1557,1797,222,242,247,0,,0,0.0,0.0,0.0,0.0,0.0
2024,6,15,6,2024-06-15,WN,137,JFK,TPA,"New York, NY",New York,"Tampa, FL",Florida,1961,2052,-18,-10,1943,2042,23,18,1966,2024,1889,242,262,283,0,,0,0.0,0.0,0.0,0.0,0.0
2024,9,16,1,2024-09-16,NK,9924,IAH,BWI,"Houston, TX",Texas,"Baltimore, MD",Maryland,1271,635,-4,-10,1267,625,23,10,1290,615,2825,362,382,395,0,,0,0.0,0.0,0.0,0.0,0.0
2024,8,30,5,2024-08-30,AA,3875,SEA,SAN,"Seattle, WA",Washington,"San Diego, CA",California,1441,1504,-8,-10,1433,1494,22,11,1455,1483,2089,253,273,286,0,,0,0.0,0.0,0.0,0.0,0.0
2024,10,1,2,2024-10-01,AS,4185,PDX,MDW,"Portland, OR",Oregon,"Chicago, IL",Illinois,1586,1006,10,5,1596,1011,24,15,1620,996,2349,283,303,322,0,,0,0.0,0.0,0.0,0.0,0.0
2024,4,11,4,2024-04-11,HA,8810,MDW,JFK,"Chicago, IL",Illinois,"New York, NY",New York,1494,2039,2,10,1496,2049,15,10,1511,2039,2757,347,367,372,0,,0,0.0,0.0,0.0,0.0,0.0
2024,6,21,5,2024-06-21,F9,5220,PHL,PHX,"Philadelphia, PA",Pennsylvania,"Phoenix, AZ",Arizona,745,2308,4,0,749,2308,28,16,777,2292,2437,300,320,344,0,,0,0.0,0.0,0.0,0.0,0.0
2024,6,19,3,2024-06-19,NK,6844,DFW,DTW,"Dallas/Fort Worth, TX",Texas,"Detroit, MI",Michigan,1497,1011,16,20,1513,1031,26,12,1539,1019,811,109,129,147,0,,0,5.0,4.0,3.0,0.0,8.0
2024,5,20,1,2024-05-20,DL,1141,MSP,DFW,"Minneapolis, MN",Minnesota,"Dallas/Fort Worth, TX",Texas,549,1087,7,5,556,1092,5,11,561,1081,937,125,145,141,0,,0,0.0,0.0,0.0,0.0,0.0
2024,7,6,6,2024-07-06,OH,4815,CLT,SLC,"Charlotte, NC",North Carolina,"Salt Lake City, UT",Utah,1757,2315,-4,0,1753,2315,25,4,1778,2311,1076,124,144,153,0,,0,0.0,0.0,0.0,0.0,0.0
2024,3,26,2,2024-03-26,MQ,1494,DCA,ORD,"Washington, DC",District of Columbia,"Chicago, IL",Illinois,2051,1378,0,0,2051,1378,16,14,2067,1364,523,62,82,92,0,,0,0.0,0.0,0.0,0.0,0.0
2024,2,21,3,2024-02-21,OH,2969,DTW,BOS,"Detroit, MI",Michigan,"Boston, MA",Massachusetts,2039,1431,13,10,2052,1441,15,18,2067,1423,1137,151,171,184,0,,0,0.0,0.0,0.0,0.0,0.0
2024,4,20,6,2024-04-20,NK,3776,CLT,PHL,"Charlotte, NC",North Carolina,"Philadelphia, PA",Pennsylvania,1805,1944,-15,-15,1790,1929,14,3,1804,1926,340,48,68,65,0,,0,0.0,0.0,0.0,0.0,0.0
2024,12,30,1,2024-12-30,MQ,3821,DFW,SEA,"Dallas/Fort Worth, TX",Texas,"Seattle, WA",Washington,1168,1696,-2,-10,1166,1686,15,15,1181,1671,1838,225,245,255,0,,0,0.0,0.0,0.0,0.0,0.0
2024,12,7,6,2024-12-07,AS,5790,MDW,LGA,"Chicago, IL",Illinois,"New York, NY",New York,719,2192,-14,-10,705,2182,12,17,717,2165,1131,133,153,162,0,,0,0.0,0.0,0.0,0.0,0.0
2024,2,12,1,2024-02-12,MQ,5918,ORD,LGA,"Chicago, IL",Illinois,"New York, NY",New York,1406,2201,1,10,1407,2211,21,12,1428,2199,1070,138,158,171,0,,0,0.0,0.0,0.0,0.0,0.0
2024,7,29,1,2024-07-29,B6,334,TPA,SLC,"Tampa, FL",Florida,"Salt Lake City, UT",Utah,1871,1243,7,15,1878,1258,10,17,1888,1241,274,28,48,55,0,,0,0.0,0.0,0.0,0.0,0.0
2024,7,18,4,2024-07-18,WN,3240,SFO,MIA,"San Francisco, CA",California,"Miami, FL",Florida,863,1012,-14,-5,849,1007,11,8,860,999,1506,186,206,205,0,,0,0.0,0.0,0.0,0.0,0.0
2024,10,24,4,2024-10-24,AA,8738,MCO,DFW,"Orlando, FL",Florida,"Dallas/Fort Worth, TX",Texas,1491,723,9,15,1500,738,9,19,1509,719,458,49,69,77,0,,0,0.0,0.0,0.0,0.0,0.0
2024,12,11,3,2024-12-11,MQ,8299,TPA,DEN,"Tampa, FL",Florida,"Denver, CO",Colorado,1419,2008,7,0,1426,2008,8,5,1434,2003,578,73,93,86,0,,0,0.0,0.0,0.0,0.0,0.0
2024,8,27,2,2024-08-27,DL,1099,DTW,PHX,"Detroit, MI",Michigan,"Phoenix, AZ",Arizona,1062,2227,5,0,1067,2227,11,4,1078,2223,628,85,105,100,0,,0,0.0,0.0,0.0,0.0,0.0
2024,4,24,3,2024-04-24,HA,1434,DEN,EWR,"Denver, CO",Colorado,"Newark, NJ",New Jersey,541,1605,2,10,543,1615,20,17,563,1598,2885,361,381,398,0,,0,0.0,0.0,0.0,0.0,0.0
2024,1,26,5,2024-01-26,NK,8425,PDX,HNL,"Portland, OR",Oregon,"Honolulu, HI",Hawaii,922,1252,4,0,926,1252,29,10,955,1242,2211,273,293,312,0,,0,0.0,0.0,0.0,0.0,0.0
2024,10,25,5,2024-10-25,9E,8347,SAN,STL,"San Diego, CA",California,"St. Louis, MO",Missouri,634,831,9,0,643,831,8,18,651,813,2538,308,328,334,0,,0,0.0,0.0,0.0,0.0,0.0
2024,3,17,7,2024-03-17,UA,5188,STL,PHL,"St. Louis, MO",Missouri,"Philadelphia, PA",Pennsylvania,1285,2205,-11,-20,1274,2185,7,14,1281,2171,1109,133,153,154,0,,0,0.0,0.0,0.0,0.0,0.0
2024,5,16,4,2024-05-16,B6,5579,SLC,DEN,"Salt Lake City, UT",Utah,"Denver, CO",Colorado,1782,1032,-18,-20,1764,1012,18,14,1782,998,955,123,143,155,0,,0,0.0,0.0,0.0,0.0,0.0
2024,1,20,6,2024-01-20,F9,6190,BOS,HNL,"Boston, MA",Massachusetts,"Honolulu, HI",Hawaii,1714,1090,-5,0,1709,1090,8,15,1717,1075,1068,124,144,147,0,,0,0.0,0.0,0.0,0.0,0.0
2024,7,29,1,2024-07-29,MQ,1211,EWR,SEA,"Newark, NJ",New Jersey,"Seattle, WA",Washington,1779,2310,-10,-15,1769,2295,25,3,1794,2292,773,96,116,124,0,,0,0.0,0.0,0.0,0.0,0.0
2024,8,27,2,2024-08-27,MQ,9815,DCA,DEN,"Washington, DC",District of Columbia,"Denver, CO",Colorado,1247,685,5,5,1252,690,13,15,1265,675,920,105,125,133,0,,0,0.0,0.0,0.0,0.0,0.0
2024,2,8,4,2024-02-08,F9,8435,LGA,ORD,"New York, NY",New York,"Chicago, IL",Illinois,2017,1653,3,0,2020,1653,15,6,2035,1647,2645,332,352,353,0,,0,0.0,0.0,0.0,0.0,0.0
2024,9,24,2,2024-09-24,AS,3016,MCO,EWR,"Orlando, FL",Florida,"Newark, NJ",New Jersey,572,2290,4,0,576,2290,5,15,581,2275,1723,215,235,235,0,,0,0.0,0.0,0.0,0.0,0.0
2024,7,25,4,2024-07-25,B6,6899,DEN,SFO,"Denver, CO",Colorado,"San Francisco, CA",California,1597,1823,-1,5,1596,1828,13,18,1609,1810,2942,371,391,402,0,,0,0.0,0.0,0.0,0.0,0.0
2024,9,23,1,2024-09-23,MQ,2203,PHL,TPA,"Philadelphia, PA",Pennsylvania,"Tampa, FL",Florida,1134,1474,40,45,1174,1519,29,10,1203,1509,2751,344,364,383,0,,0,2.0,4.0,8.0,1.0,30.0
2024,6,2,7,2024-06-02,DL,8911,IAH,HNL,"Houston, TX",Texas,"Honolulu, HI",Hawaii,2105,755,-6,-10,2099,745,12,10,2111,735,1228,160,180,182,0,,0,0.0,0.0,0.0,0.0,0.0
2024,2,11,7,2024-02-11,G4,5225,PDX,MSP,"Portland, OR",Oregon,"Minneapolis, MN",Minnesota,900,1356,8,0,908,1356,19,10,927,1346,1878,235,255,264,0,,0,0.0,0.0,0.0,0.0,0.0
2024,1,11,4,2024-01-11,AA,6690,BOS,DEN,"Boston, MA",Massachusetts,"Denver, CO",Colorado,1602,1497,10,10,1612,1507,28,11,1640,1496,2682,341,361,380,0,,0,0.0,0.0,0.0,0.0,0.0
2024,10,20,7,2024-10-20,OO,9700,SFO,STL,"San Francisco, CA",California,"St. Louis, MO",Missouri,1492,1131,-11,-20,1481,1111,12,19,1493,1092,1965,254,274,285,0,,0,0.0,0.0,0.0,0.0,0.0
2024,4,7,7,2024-04-07,DL,3021,DFW,MCO,"Dallas/Fort Worth, TX",Texas,"Orlando, FL",Florida,1771,2338,-15,-10,1756,2328,24,3,1780,2325,2684,343,363,370,0,,0,0.0,0.0,0.0,0.0,0.0
2024,10,1,2,2024-10-01,MQ,4834,IAD,LAX,"Washington, DC",District of Columbia,"Los Angeles, CA",California,1710,751,0,0,1710,751,11,14,1721,737,1488,181,201,206,0,,0,0.0,0.0,0.0,0.0,0.0
2024,8,17,6,2024-08-17,AA,3473,HNL,SFO,"Honolulu, HI",Hawaii,"San Francisco, CA",California,2176,1700,-3,0,2173,1700,18,3,2191,1697,1603,193,213,214,0,,0,0.0,0.0,0.0,0.0,0.0
2024,8,7,3,2024-08-07,YX,6854,HNL,BOS,"Honolulu, HI",Hawaii,"Boston, MA",Massachusetts,2079,1951,-14,-15,2065,1936,22,11,2087,1925,1435,184,204,217,0,,0,0.0,0.0,0.0,0.0,0.0
2024,3,5,2,2024-03-05,WN,936,TPA,MIA,"Tampa, FL",Florida,"Miami, FL",Florida,2282,771,1,-5,2283,766,7,12,2290,754,2837,357,377,376,0,,0,0.0,0.0,0.0,0.0,0.0
2024,12,20,5,2024-12-20,WN,9877,DTW,CLT,"Detroit, MI",Michigan,"Charlotte, NC",North Carolina,969,2028,-10,0,959,2028,19,14,978,2014,2178,263,283,296,0,,0,0.0,0.0,0.0,0.0,0.0
2024,8,19,1,2024-08-19,B6,9128,IAH,MIA,"Houston, TX",Texas,"Miami, FL",Florida,2261,2029,-6,-5,2255,2024,28,7,2283,2017,1103,136,156,171,0,,0,0.0,0.0,0.0,0.0,0.0
2024,11,23,6,2024-11-23,B6,6807,SFO,MDW,"San Francisco, CA",California,"Chicago, IL",Illinois,1078,1361,8,5,1086,1366,24,9,1110,1357,656,82,102,115,0,,0,0.0,0.0,0.0,0.0,0.0
2024,2,21,3,2024-02-21,F9,5412,EWR,PHX,"Newark, NJ",New Jersey,"Phoenix, AZ",Arizona,955,2321,1,5,956,2326,10,19,966,2307,476,58,78,87,0,,0,0.0,0.0,0.0,0.0,0.0
2024,9,19,4,2024-09-19,OO,9689,BOS,DTW,"Boston, MA",Massachusetts,"Detroit, MI",Michigan,1799,1985,7,0,1806,1985,19,3,1825,1982,297,42,62,64,0,,0,0.0,0.0,0.0,0.0,0.0
2024,9,23,1,2024-09-23,HA,3922,MIA,STL,"Miami, FL",Florida,"St. Louis, MO",Missouri,2288,1751,-7,-5,2281,1746,18,19,2299,1727,1215,152,172,189,0,,0,0.0,0.0,0.0,0.0,0.0
2024,12,24,2,2024-12-24,OO,6253,TPA,SAN,"Tampa, FL",Florida,"San Diego, CA",California,1702,2146,10,5,1712,2151,15,3,1727,2148,1135,138,158,156,0,,0,0.0,0.0,0.0,0.0,0.0
2024,11,12,2,2024-11-12,UA,904,BOS,SLC,"Boston, MA",Massachusetts,"Salt Lake City, UT",Utah,1413,1959,-1,0,1412,1959,12,18,1424,1941,512,55,75,85,0,,0,0.0,0.0,0.0,0.0,0.0
2024,11,19,2,2024-11-19,AS,1175,SEA,DEN,"Seattle, WA",Washington,"Denver, CO",Colorado,628,1292,11,10,639,1302,12,11,651,1291,445,55,75,78,0,,0,0.0,0.0,0.0,0.0,0.0
2024,6,2,7,2024-06-02,YX,9705,SAN,TPA,"San Diego, CA",California,"Tampa, FL",Florida,878,1888,-2,0,876,1888,9,6,885,1882,2306,283,303,298,0,,0,0.0,0.0,0.0,0.0,0.0
2024,12,23,1,2024-12-23,MQ,4552,IAD,MCO,"Washington, DC",District of Columbia,"Orlando, FL",Florida,1638,794,3,0,1641,794,20,9,1661,785,560,64,84,93,0,,0,0.0,0.0,0.0,0.0,0.0
2024,5,19,7,2024-05-19,YX,1763,SLC,CLT,"Salt Lake City, UT",Utah,"Charlotte, NC",North Carolina,1845,699,-24,-15,1821,684,11,4,1832,680,1428,170,190,185,0,,0,0.0,0.0,0.0,0.0,0.0
2024,2,20,2,2024-02-20,UA,7528,PHL,LAX,"Philadelphia, PA",Pennsylvania,"Los Angeles, CA",California,888,2187,9,10,897,2197,5,16,902,2181,881,111,131,132,0,,0,0.0,0.0,0.0,0.0,0.0
2024,4,26,5,2024-04-26,MQ,2153,MCO,MIA,"Orlando, FL",Florida,"Miami, FL",Florida,1285,1994,-6,-5,1279,1989,9,3,1288,1986,2111,264,284,276,0,,0,0.0,0.0,0.0,0.0,0.0
2024,2,15,4,2024-02-15,DL,2520,SLC,MSP,"Salt Lake City, UT",Utah,"Minneapolis, MN",Minnesota,963,1601,-4,5,959,1606,7,6,966,1600,1452,172,192,185,0,,0,0.0,0.0,0.0,0.0,0.0
2024,11,4,1,2024-11-04,F9,2628,BOS,MIA,"Boston, MA",Massachusetts,"Miami, FL",Florida,1725,1508,-10,-5,1715,1503,17,15,1732,1488,2405,299,319,331,0,,0,0.0,0.0,0.0,0.0,0.0
2024,3,28,4,2024-03-28,AA,4417,ATL,LAS,"Atlanta, GA",Georgia,"Las Vegas, NV",Nevada,2152,1027,-20,-20,2132,1007,24,5,2156,1002,1910,236,256,265,0,,0,0.0,0.0,0.0,0.0,0.0
2024,7,26,5,2024-07-26,G4,8077,SEA,LAS,"Seattle, WA",Washington,"Las Vegas, NV",Nevada,1488,1186,-7,-5,1481,1181,21,12,1502,1169,411,48,68,81,0,,0,0.0,0.0,0.0,0.0,0.0
2024,9,25,3,2024-09-25,OO,8806,PHX,PDX,"Phoenix, AZ",Arizona,"Portland, OR",Oregon,1046,1519,-23,-15,1023,1504,5,10,1028,1494,1533,195,215,210,0,,0,0.0,0.0,0.0,0.0,0.0
2024,3,29,5,2024-03-29,NK,7327,ATL,EWR,"Atlanta, GA",Georgia,"Newark, NJ",New Jersey,908,1756,3,-5,911,1751,23,19,934,1732,947,116,136,158,0,,0,0.0,0.0,0.0,0.0,0.0
2024,4,27,6,2024-04-27,YX,8512,SLC,PDX,"Salt Lake City, UT",Utah,"Portland, OR",Oregon,1117,855,-5,-5,1112,850,8,7,1120,843,1243,150,170,165,0,,0,0.0,0.0,0.0,0.0,0.0
2024,2,23,5,2024-02-23,9E,327,LGA,EWR,"New York, NY",New York,"Newark, NJ",New Jersey,1260,2073,-17,-10,1243,2063,17,9,1260,2054,1495,187,207,213,0,,0,0.0,0.0,0.0,0.0,0.0
2024,4,25,4,2024-04-25,MQ,2437,SLC,DTW,"Salt Lake City, UT",Utah,"Detroit, MI",Michigan,1675,1320,-11,-15,1664,1305,23,19,1687,1286,1737,218,238,260,0,,0,0.0,0.0,0.0,0.0,0.0
2024,4,27,6,2024-04-27,HA,1055,EWR,MCO,"Newark, NJ",New Jersey,"Orlando, FL",Florida,1152,1003,6,5,1158,1008,22,4,1180,1004,1456,185,205,211,0,,0,0.0,0.0,0.0,0.0,0.0
2024,9,16,1,2024-09-16,YX,1597,PHX,STL,"Phoenix, AZ",Arizona,"St. Louis, MO",Missouri,1928,1559,-2,5,1926,1564,15,13,1941,1551,955,126,146,154,0,,0,0.0,0.0,0.0,0.0,0.0
2024,3,15,5,2024-03-15,OO,9572,DTW,IAH,"Detroit, MI",Michigan,"Houston, TX",Texas,1501,2278,-6,-10,1495,2268,27,5,1522,2263,355,50,70,82,0,,0,0.0,0.0,0.0,0.0,0.0
2024,10,31,4,2024-10-31,WN,2078,EWR,STL,"Newark, NJ",New Jersey,"St. Louis, MO",Missouri,990,1179,6,0,996,1179,13,17,1009,1162,1940,239,259,269,0,,0,0.0,0.0,0.0,0.0,0.0
2024,1,7,7,2024-01-07,UA,1629,MCO,PDX,"Orlando, FL",Florida,"Portland, OR",Oregon,1306,1677,7,0,1313,1677,7,13,1320,1664,1367,164,184,184,0,,0,0.0,0.0,0.0,0.0,0.0
2024,5,1,3,2024-05-01,AS,2762,IAH,DTW,"Houston, TX",Texas,"Detroit, MI",Michigan,1685,1006,-11,-5,1674,1001,20,4,1694,997,271,31,51,55,0,,0,0.0,0.0,0.0,0.0,0.0
2024,1,11,4,2024-01-11,G4,6533,BOS,SLC,"Boston, MA",Massachusetts,"Salt Lake City, UT",Utah,646,2008,-11,-10,635,1998,29,10,664,1988,1790,219,239,258,0,,0,0.0,0.0,0.0,0.0,0.0
2024,12,13,5,2024-12-13,HA,7545,JFK,DFW,"New York, NY",New York,"Dallas/Fort Worth, TX",Texas,1935,841,-1,-10,1934,831,28,17,1962,814,1671,217,237,262,0,,0,0.0,0.0,0.0,0.0,0.0
2024,8,2,5,2024-08-02,G4,4384,ORD,PHX,"Chicago, IL",Illinois,"Phoenix, AZ",Arizona,755,646,8,10,763,656,25,6,788,650,568,65,85,96,0,,0,0.0,0.0,0.0,0.0,0.0
2024,10,5,6,2024-10-05,WN,9209,PHL,SLC,"Philadelphia, PA",Pennsylvania,"Salt Lake City, UT",Utah,2126,714,17,10,2143,724,26,7,2169,717,2619,335,355,368,0,,0,0.0,0.0,0.0,0.0,0.0
2024,1,28,7,2024-01-28,9E,1301,SAN,MDW,"San Diego, CA",California,"Chicago, IL",Illinois,869,1616,-4,-5,865,1611,21,9,886,1602,613,75,95,105,0,,0,0.0,0.0,0.0,0.0,0.0
2024,8,22,4,2024-08-22,B6,7231,ORD,IAD,"Chicago, IL",Illinois,"Washington, DC",District of Columbia,2253,2331,2,5,2255,2336,17,4,2272,2332,1027,121,141,142,0,,0,0.0,0.0,0.0,0.0,0.0
2024,11,8,5,2024-11-08,OO,9913,MIA,SFO,"Miami, FL",Florida,"San Francisco, CA",California,1150,1405,0,0,1150,1405,10,13,1160,1392,2883,352,372,375,0,,0,0.0,0.0,0.0,0.0,0.0
2024,1,26,5,2024-01-26,MQ,859,ATL,LGA,"Atlanta, GA",Georgia,"New York, NY",New York,2212,729,-22,-15,2190,714,29,14,2219,700,2975,364,384,407,0,,0,0.0,0.0,0.0,0.0,0.0
2024,2,23,5,2024-02-23,G4,5673,JFK,SLC,"New York, NY",New York,"Salt Lake City, UT",Utah,1814,2180,8,10,1822,2190,11,10,1833,2180,2025,262,282,283,0,,0,0.0,0.0,0.0,0.0,0.0
2024,1,29,1,2024-01-29,DL,5261,PHL,MSP,"Philadelphia, PA",Pennsylvania,"Minneapolis, MN",Minnesota,1863,1778,-17,-10,1846,1768,13,16,1859,1752,2246,283,303,312,0,,0,0.0,0.0,0.0,0.0,0.0
2024,12,18,3,2024-12-18,DL,4389,TPA,MDW,"Tampa, FL",Florida,"Chicago, IL",Illinois,575,1593,12,5,587,1598,25,10,612,1588,2289,283,303,318,0,,0,0.0,0.0,0.0,0.0,0.0
2024,6,12,3,2024-06-12,B6,5546,SAN,SFO,"San Diego, CA",California,"San Francisco, CA",California,1068,1094,3,0,1071,1094,9,11,1080,1083,988,117,137,137,0,,0,0.0,0.0,0.0,0.0,0.0
2024,9,26,4,2024-09-26,AA,9780,HNL,MIA,"Honolulu, HI",Hawaii,"Miami, FL",Florida,2063,681,8,5,2071,686,9,7,2080,679,487,54,74,70,0,,0,0.0,0.0,0.0,0.0,0.0
2024,11,29,5,2024-11-29,F9,4358,LAS,HNL,"Las Vegas, NV",Nevada,"Honolulu, HI",Hawaii,1004,1564,-10,0,994,1564,26,15,1020,1549,1125,140,160,181,0,,0,0.0,0.0,0.0,0.0,0.0
2024,2,4,7,2024-02-04,B6,4471,PHL,JFK,"Philadelphia, PA",Pennsylvania,"New York, NY",New York,1844,1268,3,5,1847,1273,19,12,1866,1261,519,59,79,90,0,,0,0.0,0.0,0.0,0.0,0.0
2024,10,12,6,2024-10-12,YX,1765,DTW,IAH,"Detroit, MI",Michigan,"Houston, TX",Texas,1161,1648,-25,-20,1136,1628,8,5,1144,1623,2069,252,272,265,0,,0,0.0,0.0,0.0,0.0,0.0
2024,12,13,5,2024-12-13,9E,7018,MSP,SEA,"Minneapolis, MN",Minnesota,"Seattle, WA",Washington,1515,1957,-13,-20,1502,1937,14,13,1516,1924,2433,294,314,321,0,,0,0.0,0.0,0.0,0.0,0.0
2024,9,29,7,2024-09-29,DL,6723,LAS,BWI,"Las Vegas, NV",Nevada,"Baltimore, MD",Maryland,1830,1805,10,10,1840,1815,13,7,1853,1808,624,81,101,101,0,,0,0.0,0.0,0.0,0.0,0.0
2024,7,26,5,2024-07-26,YX,8751,SLC,BWI,"Salt Lake City, UT",Utah,"Baltimore, MD",Maryland,846,2055,1,5,847,2060,11,6,858,2054,2530,322,342,339,0,,0,0.0,0.0,0.0,0.0,0.0
2024,8,25,7,2024-08-25,G4,7532,LAS,ORD,"Las Vegas, NV",Nevada,"Chicago, IL",Illinois,1916,1797,7,10,1923,1807,19,7,1942,1800,471,49,69,75,0,,0,0.0,0.0,0.0,0.0,0.0
2024,4,2,2,2024-04-02,DL,6782,ORD,CLT,"Chicago, IL",Illinois,"Charlotte, NC",North Carolina,1722,1408,-8,0,1714,1408,23,10,1737,1398,2784,340,360,373,0,,0,0.0,0.0,0.0,0.0,0.0
2024,6,21,5,2024-06-21,NK,6328,LAX,DCA,"Los Angeles, CA",California,"Washington, DC",District of Columbia,2199,1664,0,0,2199,1664,14,11,2213,1653,2365,290,310,315,0,,0,0.0,0.0,0.0,0.0,0.0
2024,3,19,2,2024-03-19,F9,5927,SFO,MCO,"San Francisco, CA",California,"Orlando, FL",Florida,681,1044,0,0,681,1044,11,17,692,1027,1312,171,191,199,0,,0,0.0,0.0,0.0,0.0,0.0
2024,4,19,5,2024-04-19,OH,5535,IAH,BOS,"Houston, TX",Texas,"Boston, MA",Massachusetts,739,1468,-19,-10,720,1458,7,3,727,1455,2243,281,301,291,0,,0,0.0,0.0,0.0,0.0,0.0
2024,8,4,7,2024-08-04,AS,7736,STL,BOS,"St. Louis, MO",Missouri,"Boston, MA",Massachusetts,2277,2018,9,5,2286,2023,7,14,2293,2009,1567,190,210,211,0,,0,0.0,0.0,0.0,0.0,0.0
2024,12,23,1,2024-12-23,OH,1465,SEA,MIA,"Seattle, WA",Washington,"Miami, FL",Florida,565,1911,14,10,579,1921,24,15,603,1906,722,81,101,120,0,,0,0.0,0.0,0.0,0.0,0.0
2024,4,15,1,2024-04-15,OO,7444,LAS,HNL,"Las Vegas, NV",Nevada,"Honolulu, HI",Hawaii,670,1160,9,15,679,1175,22,6,701,1169,1895,243,263,271,0,,0,0.0,0.0,0.0,0.0,0.0
2024,2,16,5,2024-02-16,NK,3301,PHX,SFO,"Phoenix, AZ",Arizona,"San Francisco, CA",California,2168,1885,9,0,2177,1885,28,18,2205,1867,1566,197,217,243,0,,0,0.0,0.0,0.0,0.0,0.0
2024,6,29,6,2024-06-29,OO,4852,EWR,MDW,"Newark, NJ",New Jersey,"Chicago, IL",Illinois,2116,656,-8,-5,2108,651,17,14,2125,637,704,93,113,124,0,,0,0.0,0.0,0.0,0.0,0.0
2024,3,4,1,2024-03-04,AA,9675,SLC,STL,"Salt Lake City, UT",Utah,"St. Louis, MO",Missouri,664,605,15,10,679,615,16,17,695,598,302,39,59,72,0,,0,0.0,0.0,0.0,0.0,0.0
2024,9,2,1,2024-09-02,WN,6191,SEA,SAN,"Seattle, WA",Washington,"San Diego, CA",California,1453,2182,6,5,1459,2187,21,3,1480,2184,2412,307,327,331,0,,0,0.0,0.0,0.0,0.0,0.0
2024,8,31,6,2024-08-31,MQ,6714,DTW,LAX,"Detroit, MI",Michigan,"Los Angeles, CA",California,562,2198,13,10,575,2208,21,16,596,2192,2409,294,314,331,0,,0,0.0,0.0,0.0,0.0,0.0
2024,11,15,5,2024-11-15,NK,1621,MSP,PHX,"Minneapolis, MN",Minnesota,"Phoenix, AZ",Arizona,854,1544,7,5,861,1549,15,17,876,1532,1308,158,178,190,0,,0,0.0,0.0,0.0,0.0,0.0
2024,3,27,3,2024-03-27,AA,7621,ATL,IAD,"Atlanta, GA",Georgia,"Washington, DC",District of Columbia,550,1178,8,10,558,1188,21,10,579,1178,1441,183,203,214,0,,0,0.0,0.0,0.0,0.0,0.0
2024,8,4,7,2024-08-04,MQ,6659,LAS,LAX,"Las Vegas, NV",Nevada,"Los Angeles, CA",California,1083,1514,-19,-15,1064,1499,24,4,1088,1495,555,77,97,105,0,,0,0.0,0.0,0.0,0.0,0.0
2024,1,7,7,2024-01-07,AA,1723,DFW,ATL,"Dallas/Fort Worth, TX",Texas,"Atlanta, GA",Georgia,542,2318,11,5,553,2323,21,18,574,2305,2488,313,333,352,0,,1,0.0,0.0,0.0,0.0,0.0
2024,10,4,5,2024-10-04,OO,8973,PHX,SAN,"Phoenix, AZ",Arizona,"San Diego, CA",California,1462,761,-24,-15,1438,746,23,19,1461,727,633,79,99,121,0,,0,0.0,0.0,0.0,0.0,0.0
2024,12,2,1,2024-12-02,AS,3234,PDX,JFK,"Portland, OR",Oregon,"New York, NY",New York,1844,1920,2,5,1846,1925,11,13,1857,1912,706,92,112,116,0,,0,0.0,0.0,0.0,0.0,0.0
2024,7,28,7,2024-07-28,WN,5920,PHL,IAD,"Philadelphia, PA",Pennsylvania,"Washington, DC",District of Columbia,1841,2240,2,0,1843,2240,23,4,1866,2236,2153,274,294,301,0,,0,0.0,0.0,0.0,0.0,0.0
2024,6,17,1,2024-06-17,UA,5094,DFW,STL,"Dallas/Fort Worth, TX",Texas,"St. Louis, MO",Missouri,1739,1374,-23,-20,1716,1354,6,12,1722,1342,2227,268,288,286,0,,0,0.0,0.0,0.0,0.0,0.0
2024,11,25,1,2024-11-25,YX,4796,SLC,MDW,"Salt Lake City, UT",Utah,"Chicago, IL",Illinois,1714,656,7,0,1721,656,14,6,1735,650,2542,323,343,343,0,,0,0.0,0.0,0.0,0.0,0.0
2024,5,17,5,2024-05-17,HA,1967,DFW,MCO,"Dallas/Fort Worth, TX",Texas,"Orlando, FL",Florida,1169,1127,-13,-15,1156,1112,10,14,1166,1098,1253,161,181,185,0,,0,0.0,0.0,0.0,0.0,0.0
2024,11,1,5,2024-11-01,B6,9491,IAH,JFK,"Houston, TX",Texas,"New York, NY",New York,2013,1682,-18,-15,1995,1667,20,9,2015,1658,2634,323,343,352,0,,0,0.0,0.0,0.0,0.0,0.0
2024,8,17,6,2024-08-17,G4,2923,SFO,TPA,"San Francisco, CA",California,"Tampa, FL",Florida,589,1789,-5,-10,584,1779,12,9,596,1770,825,108,128,129,0,,0,0.0,0.0,0.0,0.0,0.0
2024,11,3,7,2024-11-03,9E,6206,DCA,IAD,"Washington, DC",District of Columbia,"Washington, DC",District of Columbia,1945,1145,9,0,1954,1145,8,4,1962,1141,2367,298,318,310,0,,0,0.0,0.0,0.0,0.0,0.0
2024,6,9,7,2024-06-09,9E,268,MCO,SAN,"Orlando, FL",Florida,"San Diego, CA",California,2014,645,-23,-15,1991,630,24,16,2015,614,1603,193,213,233,0,,0,0.0,0.0,0.0,0.0,0.0
2024,1,1,1,2024-01-01,YX,7887,LAX,SEA,"Los Angeles, CA",California,"Seattle, WA",Washington,1115,1532,-11,-15,1104,1517,15,6,1119,1511,1865,233,253,254,0,,0,0.0,0.0,0.0,0.0,0.0
2024,8,23,5,2024-08-23,OH,8730,PDX,MIA,"Portland, OR",Oregon,"Miami, FL",Florida,1062,1410,-11,-10,1051,1400,22,13,1073,1387,2624,320,340,355,0,,0,0.0,0.0,0.0,0.0,0.0
2024,7,6,6,2024-07-06,OH,5009,BOS,DFW,"Boston, MA",Massachusetts,"Dallas/Fort Worth, TX",Texas,1777,646,-13,-20,1764,626,25,16,1789,610,906,121,141,162,0,,0,0.0,0.0,0.0,0.0,0.0
2024,1,4,4,2024-01-04,YX,8127,DTW,IAH,"Detroit, MI",Michigan,"Houston, TX",Texas,1630,2013,-2,-10,1628,2003,19,8,1647,1995,790,89,109,116,0,,0,0.0,0.0,0.0,0.0,0.0
2024,5,11,6,2024-05-11,OO,4781,TPA,IAH,"Tampa, FL",Florida,"Houston, TX",Texas,1817,851,-9,0,1808,851,20,5,1828,846,1712,216,236,241,0,,0,0.0,0.0,0.0,0.0,0.0
2024,8,5,1,2024-08-05,9E,9155,CLT,SAN,"Charlotte, NC",North Carolina,"San Diego, CA",California,2034,765,-1,0,2033,765,12,18,2045,747,1926,242,262,272,0,,0,0.0,0.0,0.0,0.0,0.0
2024,9,16,1,2024-09-16,UA,5237,TPA,IAD,"Tampa, FL",Florida,"Washington, DC",District of Columbia,1759,967,25,20,1784,987,21,18,1805,969,2890,359,379,398,0,,0,6.0,4.0,1.0,0.0,9.0
2024,1,1,1,2024-01-01,B6,8431,IAH,SLC,"Houston, TX",Texas,"Salt Lake City, UT",Utah,2021,2002,-18,-15,2003,1987,6,5,2009,1982,1318,160,180,171,0,,0,0.0,0.0,0.0,0.0,0.0
2024,3,11,1,2024-03-11,9E,5334,JFK,SLC,"New York, NY",New York,"Salt Lake City, UT",Utah,1334,1940,6,10,1340,1950,21,18,1361,1932,2001,251,271,290,0,,0,0.0,0.0,0.0,0.0,0.0
2024,6,26,3,2024-06-26,B6,324,PHX,DFW,"Phoenix, AZ",Arizona,"Dallas/Fort Worth, TX",Texas,855,1755,-12,-5,843,1750,19,10,862,1740,1982,252,272,281,0,,0,0.0,0.0,0.0,0.0,0.0
2024,7,7,7,2024-07-07,G4,8849,DTW,STL,"Detroit, MI",Michigan,"St. Louis, MO",Missouri,1116,2012,-7,-5,1109,2007,24,12,1133,1995,753,101,121,137,0,,0,0.0,0.0,0.0,0.0,0.0
2024,10,17,4,2024-10-17,OO,6682,SLC,DCA,"Salt Lake City, UT",Utah,"Washington, DC",District of Columbia,1266,1181,-14,-5,1252,1176,11,5,1263,1171,207,30,50,46,0,,0,0.0,0.0,0.0,0.0,0.0
2024,1,8,1,2024-01-08,YX,1673,DEN,MIA,"Denver, CO",Colorado,"Miami, FL",Florida,803,1171,-10,-15,793,1156,15,16,808,1140,2527,309,329,340,0,,0,0.0,0.0,0.0,0.0,0.0
2024,9,9,1,2024-09-09,9E,8677,PHL,LGA,"Philadelphia, PA",Pennsylvania,"New York, NY",New York,2055,2340,-4,0,2051,2340,23,17,2074,2323,674,85,105,125,0,,0,0.0,0.0,0.0,0.0,0.0
2024,10,18,5,2024-10-18,OO,8812,BOS,SFO,"Boston, MA",Massachusetts,"San Francisco, CA",California,2015,947,9,5,2024,952,28,4,2052,948,2051,246,266,278,0,,0,0.0,0.0,0.0,0.0,0.0
2024,8,31,6,2024-08-31,WN,6863,CLT,LGA,"Charlotte, NC",North Carolina,"New York, NY",New York,1083,1444,4,10,1087,1454,10,18,1097,1436,2785,347,367,375,0,,0,0.0,0.0,0.0,0.0,0.0
2024,5,2,4,2024-05-02,AA,5317,DCA,IAD,"Washington, DC",District of Columbia,"Washington, DC",District of Columbia,1640,1217,10,20,1650,1237,22,15,1672,1222,371,44,64,81,1,,0,5.0,5.0,0.0,0.0,10.0
2024,10,25,5,2024-10-25,9E,3242,EWR,TPA,"Newark, NJ",New Jersey,"Tampa, FL",Florida,866,1096,14,5,880,1101,13,17,893,1084,1283,167,187,197,0,,0,0.0,0.0,0.0,0.0,0.0
2024,10,9,3,2024-10-09,B6,3601,SLC,DFW,"Salt Lake City, UT",Utah,"Dallas/Fort Worth, TX",Texas,2165,1295,-6,0,2159,1295,29,16,2188,1279,2213,269,289,314,0,,0,0.0,0.0,0.0,0.0,0.0
2024,2,1,4,2024-02-01,AA,1599,ATL,HNL,"Atlanta, GA",Georgia,"Honolulu, HI",Hawaii,958,1110,2,0,960,1110,20,18,980,1092,1219,142,162,180,0,,0,0.0,0.0,0.0,0.0,0.0
2024,11,29,5,2024-11-29,AS,9769,MDW,BWI,"Chicago, IL",Illinois,"Baltimore, MD",Maryland,619,2142,19,10,638,2152,17,14,655,2138,301,46,66,77,0,,0,0.0,0.0,0.0,0.0,0.0
2024,5,25,6,2024-05-25,YX,9195,SLC,SFO,"Salt Lake City, UT",Utah,"San Francisco, CA",California,1736,1051,7,5,1743,1056,27,16,1770,1040,849,108,128,151,0,,0,0.0,0.0,0.0,0.0,0.0
2024,6,4,2,2024-06-04,9E,9923,SLC,MIA,"Salt Lake City, UT",Utah,"Miami, FL",Florida,2264,1142,-3,-10,2261,1132,12,17,2273,1115,472,53,73,82,0,,0,0.0,0.0,0.0,0.0,0.0
2024,1,16,2,2024-01-16,9E,6787,MCO,MIA,"Orlando, FL",Florida,"Miami, FL",Florida,1706,815,-4,5,1702,820,21,4,1723,816,1102,144,164,169,0,,0,0.0,0.0,0.0,0.0,0.0
2024,12,20,5,2024-12-20,HA,5345,PDX,IAD,"Portland, OR",Oregon,"Washington, DC",District of Columbia,2169,1069,2,-5,2171,1064,18,7,2189,1057,1621,197,217,222,0,,0,0.0,0.0,0.0,0.0,0.0
2024,2,16,5,2024-02-16,NK,9462,SAN,SFO,"San Diego, CA",California,"San Francisco, CA",California,1862,1452,-1,0,1861,1452,26,15,1887,1437,2601,334,354,375,0,,0,0.0,0.0,0.0,0.0,0.0
2024,9,7,6,2024-09-07,AA,1844,LAX,ATL,"Los Angeles, CA",California,"Atlanta, GA",Georgia,2001,903,2,10,2003,913,13,15,2016,898,1855,225,245,253,0,,0,0.0,0.0,0.0,0.0,0.0
2024,7,5,5,2024-07-05,9E,2139,MIA,DTW,"Miami, FL",Florida,"Detroit, MI",Michigan,2017,897,4,5,2021,902,10,11,2031,891,949,119,139,140,0,,0,0.0,0.0,0.0,0.0,0.0
2024,1,31,3,2024-01-31,WN,8411,SLC,SAN,"Salt Lake City, UT",Utah,"San Diego, CA",California,1754,1969,13,15,1767,1984,20,12,1787,1972,2189,274,294,306,0,,0,0.0,0.0,0.0,0.0,0.0
2024,9,16,1,2024-09-16,G4,3957,SLC,PHX,"Salt Lake City, UT",Utah,"Phoenix, AZ",Arizona,863,885,2,10,865,895,7,7,872,888,2585,325,345,339,0,,0,0.0,0.0,0.0,0.0,0.0
2024,1,17,3,2024-01-17,MQ,9967,DCA,JFK,"Washington, DC",District of Columbia,"New York, NY",New York,1969,1611,-20,-15,1949,1596,6,8,1955,1588,653,75,95,89,0,,0,0.0,0.0,0.0,0.0,0.0
2024,2,8,4,2024-02-08,AA,9612,MDW,MSP,"Chicago, IL",Illinois,"Minneapolis, MN",Minnesota,983,725,-20,-20,963,705,12,11,975,694,2521,324,344,347,0,,0,0.0,0.0,0.0,0.0,0.0
2024,10,30,3,2024-10-30,G4,5050,PHL,LGA,"Philadelphia, PA",Pennsylvania,"New York, NY",New York,1351,650,-10,-5,1341,645,8,13,1349,632,1573,202,222,223,0,,0,0.0,0.0,0.0,0.0,0.0
2024,2,8,4,2024-02-08,F9,9307,PHL,MSP,"Philadelphia, PA",Pennsylvania,"Minneapolis, MN",Minnesota,1449,2042,4,10,1453,2052,16,17,1469,2035,2187,266,286,299,0,,0,0.0,0.0,0.0,0.0,0.0
2024,5,11,6,2024-05-11,B6,7187,DEN,PHX,"Denver, CO",Colorado,"Phoenix, AZ",Arizona,745,2325,-7,-10,738,2315,5,8,743,2307,2144,264,284,277,0,,0,0.0,0.0,0.0,0.0,0.0
2024,1,30,2,2024-01-30,AS,6131,SAN,PDX,"San Diego, CA",California,"Portland, OR",Oregon,1263,1674,-4,5,1259,1679,28,19,1287,1660,437,47,67,94,0,,0,0.0,0.0,0.0,0.0,0.0
2024,6,6,4,2024-06-06,NK,1843,BWI,SEA,"Baltimore, MD",Maryland,"Seattle, WA",Washington,1748,1070,-10,0,1738,1070,21,3,1759,1067,2485,313,333,337,0,,0,0.0,0.0,0.0,0.0,0.0
2024,10,4,5,2024-10-04,WN,3641,MSP,PHX,"Minneapolis, MN",Minnesota,"Phoenix, AZ",Arizona,1680,1999,-1,5,1679,2004,22,11,1701,1993,1082,139,159,172,0,,0,0.0,0.0,0.0,0.0,0.0
2024,7,21,7,2024-07-21,OH,9738,PDX,MDW,"Portland, OR",Oregon,"Chicago, IL",Illinois,1130,1988,-13,-10,1117,1978,21,8,1138,1970,641,88,108,117,0,,0,0.0,0.0,0.0,0.0,0.0
2024,3,6,3,2024-03-06,OH,3716,IAD,ORD,"Washington, DC",District of Columbia,"Chicago, IL",Illinois,2129,1855,-11,-10,2118,1845,28,16,2146,1829,1809,232,252,276,0,,0,0.0,0.0,0.0,0.0,0.0
2024,4,17,3,2024-04-17,AS,3994,STL,MSP,"St. Louis, MO",Missouri,"Minneapolis, MN",Minnesota,2263,2313,-2,-10,2261,2303,20,4,2281,2299,2173,278,298,302,0,,0,0.0,0.0,0.0,0.0,0.0
2024,9,24,2,2024-09-24,NK,1824,JFK,SLC,"New York, NY",New York,"Salt Lake City, UT",Utah,864,1269,-8,0,856,1269,7,12,863,1257,1799,214,234,233,0,,0,0.0,0.0,0.0,0.0,0.0
2024,8,9,5,2024-08-09,OO,6327,SAN,DCA,"San Diego, CA",California,"Washington, DC",District of Columbia,1401,2282,-3,-10,1398,2272,13,3,1411,2269,2370,294,314,310,0,,0,0.0,0.0,0.0,0.0,0.0
2024,10,18,5,2024-10-18,HA,4162,IAH,SEA,"Houston, TX",Texas,"Seattle, WA",Washington,685,2103,6,10,691,2113,16,4,707,2109,379,52,72,72,0,,0,0.0,0.0,0.0,0.0,0.0
2024,1,18,4,2024-01-18,AS,7947,ORD,EWR,"Chicago, IL",Illinois,"Newark, NJ",New Jersey,2018,1929,-3,-5,2015,1924,11,3,2026,1921,689,95,115,109,0,,0,0.0,0.0,0.0,0.0,0.0
2024,3,30,6,2024-03-30,OO,4381,DTW,MIA,"Detroit, MI",Michigan,"Miami, FL",Florida,1708,1037,8,5,1716,1042,10,17,1726,1025,1736,212,232,239,0,,0,0.0,0.0,0.0,0.0,0.0
2024,6,29,6,2024-06-29,MQ,8363,CLT,IAD,"Charlotte, NC",North Carolina,"Washington, DC",District of Columbia,1910,1874,22,15,1932,1889,15,13,1947,1876,1213,157,177,185,0,,0,0.0,0.0,0.0,0.0,0.0
2024,9,11,3,2024-09-11,HA,2300,EWR,PHL,"Newark, NJ",New Jersey,"Philadelphia, PA",Pennsylvania,779,1450,1,0,780,1450,10,4,790,1446,2981,375,395,389,0,,0,0.0,0.0,0.0,0.0,0.0
2024,9,9,1,2024-09-09,YX,2243,BOS,BWI,"Boston, MA",Massachusetts,"Baltimore, MD",Maryland,1241,941,-13,-10,1228,931,21,17,1249,914,1707,220,240,258,1,,0,0.0,0.0,0.0,0.0,0.0
2024,9,13,5,2024-09-13,AS,3281,MCO,HNL,"Orlando, FL",Florida,"Honolulu, HI",Hawaii,2005,1755,17,10,2022,1765,28,16,2050,1749,372,39,59,83,0,,0,0.0,0.0,0.0,0.0,0.0
2024,12,11,3,2024-12-11,DL,9773,TPA,IAH,"Tampa, FL",Florida,"Houston, TX",Texas,1788,1348,-25,-20,1763,1328,14,7,1777,1321,301,32,52,53,0,,0,0.0,0.0,0.0,0.0,0.0
2024,3,27,3,2024-03-27,B6,2975,IAH,HNL,"Houston, TX",Texas,"Honolulu, HI",Hawaii,2193,1123,-9,-10,2184,1113,7,6,2191,1107,2191,281,301,294,0,,0,0.0,0.0,0.0,0.0,0.0
2024,3,30,6,2024-03-30,UA,6620,PHX,LGA,"Phoenix, AZ",Arizona,"New York, NY",New York,851,1254,-13,-5,838,1249,23,11,861,1238,2832,355,375,389,0,,0,0.0,0.0,0.0,0.0,0.0
2024,8,24,6,2024-08-24,NK,1196,DEN,PHX,"Denver, CO",Colorado,"Phoenix, AZ",Arizona,1088,1105,-18,-10,1070,1095,7,15,1077,1080,2736,346,366,368,0,,0,0.0,0.0,0.0,0.0,0.0
2024,3,10,7,2024-03-10,WN,9015,JFK,SEA,"New York, NY",New York,"Seattle, WA",Washington,581,998,5,0,586,998,29,5,615,993,616,71,91,105,0,,0,0.0,0.0,0.0,0.0,0.0
2024,2,13,2,2024-02-13,AA,7018,IAD,CLT,"Washington, DC",District of Columbia,"Charlotte, NC",North Carolina,1704,1505,6,0,1710,1505,25,13,1735,1492,1132,146,166,184,0,,0,0.0,0.0,0.0,0.0,0.0
2024,7,18,4,2024-07-18,YX,8248,DFW,MSP,"Dallas/Fort Worth, TX",Texas,"Minneapolis, MN",Minnesota,1865,1741,0,-5,1865,1736,6,16,1871,1720,387,47,67,69,0,,0,0.0,0.0,0.0,0.0,0.0
2024,5,31,5,2024-05-31,YX,3314,SAN,LAX,"San Diego, CA",California,"Los Angeles, CA",California,695,660,-8,-10,687,650,24,11,711,639,504,65,85,100,0,,0,0.0,0.0,0.0,0.0,0.0
2024,3,26,2,2024-03-26,AS,7849,DEN,JFK,"Denver, CO",Colorado,"New York, NY",New York,559,1804,-3,-5,556,1799,27,15,583,1784,781,96,116,138,0,,0,0.0,0.0,0.0,0.0,0.0
2024,1,19,5,2024-01-19,AS,5664,PHL,IAD,"Philadelphia, PA",Pennsylvania,"Washington, DC",District of Columbia,650,912,-9,-10,641,902,5,4,646,898,1368,165,185,174,0,,0,0.0,0.0,0.0,0.0,0.0
2024,4,10,3,2024-04-10,NK,2971,EWR,DEN,"Newark, NJ",New Jersey,"Denver, CO",Colorado,1584,864,-19,-10,1565,854,22,9,1587,845,1469,189,209,220,0,,0,0.0,0.0,0.0,0.0,0.0
2024,4,4,4,2024-04-04,HA,4589,BWI,TPA,"Baltimore, MD",Maryland,"Tampa, FL",Florida,2170,1652,-2,-5,2168,1647,12,5,2180,1642,2014,259,279,276,0,,0,0.0,0.0,0.0,0.0,0.0
2024,9,10,2,2024-09-10,OO,4707,MIA,EWR,"Miami, FL",Florida,"Newark, NJ",New Jersey,927,1886,-1,0,926,1886,28,9,954,1877,2924,374,394,411,0,,0,0.0,0.0,0.0,0.0,0.0
2024,12,22,7,2024-12-22,F9,6864,IAH,LGA,"Houston, TX",Texas,"New York, NY",New York,1450,1311,8,0,1458,1311,23,9,1481,1302,2313,295,315,327,0,,0,0.0,0.0,0.0,0.0,0.0
2024,1,30,2,2024-01-30,HA,5934,MDW,IAH,"Chicago, IL",Illinois,"Houston, TX",Texas,830,2240,-16,-10,814,2230,9,4,823,2226,1561,185,205,198,0,,0,0.0,0.0,0.0,0.0,0.0
2024,9,5,4,2024-09-05,UA,3499,SFO,PHL,"San Francisco, CA",California,"Philadelphia, PA",Pennsylvania,1562,1512,20,15,1582,1527,28,10,1610,1517,2733,350,370,388,0,,0,0.0,0.0,0.0,0.0,0.0
2024,2,2,5,2024-02-02,OH,5478,SFO,JFK,"San Francisco, CA",California,"New York, NY",New York,1776,2214,-16,-10,1760,2204,14,13,1774,2191,547,77,97,104,0,,0,0.0,0.0,0.0,0.0,0.0
2024,8,16,5,2024-08-16,AS,1957,MSP,IAH,"Minneapolis, MN",Minnesota,"Houston, TX",Texas,1389,2279,-4,5,1385,2284,13,18,1398,2266,413,47,67,78,0,,0,0.0,0.0,0.0,0.0,0.0
2024,1,12,5,2024-01-12,9E,7704,SFO,EWR,"San Francisco, CA",California,"Newark, NJ",New Jersey,1454,2334,-20,-15,1434,2319,22,10,1456,2309,1096,132,152,164,0,,0,0.0,0.0,0.0,0.0,0.0
2024,4,27,6,2024-04-27,DL,7831,ATL,PDX,"Atlanta, GA",Georgia,"Portland, OR",Oregon,2141,2241,6,5,2147,2246,28,16,2175,2230,1842,220,240,264,0,,0,0.0,0.0,0.0,0.0,0.0
2024,12,15,7,2024-12-15,MQ,2496,ORD,IAD,"Chicago, IL",Illinois,"Washington, DC",District of Columbia,1756,938,2,0,1758,938,23,7,1781,931,566,70,90,100,0,,0,0.0,0.0,0.0,0.0,0.0
2024,6,3,1,2024-06-03,OH,2361,PDX,DFW,"Portland, OR",Oregon,"Dallas/Fort Worth, TX",Texas,853,2045,2,0,855,2045,29,9,884,2036,2160,276,296,314,0,,0,0.0,0.0,0.0,0.0,0.0
2024,9,2,1,2024-09-02,G4,1412,BWI,DFW,"Baltimore, MD",Maryland,"Dallas/Fort Worth, TX",Texas,1400,688,-7,-10,1393,678,9,12,1402,666,2191,276,296,297,0,,0,0.0,0.0,0.0,0.0,0.0
2024,11,27,3,2024-11-27,DL,2405,ATL,IAH,"Atlanta, GA",Georgia,"Houston, TX",Texas,1693,931,3,-5,1696,926,25,8,1721,918,2577,323,343,356,0,,0,0.0,0.0,0.0,0.0,0.0
2024,9,3,2,2024-09-03,UA,5607,MIA,LGA,"Miami, FL",Florida,"New York, NY",New York,716,2054,9,5,725,2059,15,8,740,2051,2665,340,360,363,0,,0,0.0,0.0,0.0,0.0,0.0
2024,1,29,1,2024-01-29,YX,2841,PHX,SLC,"Phoenix, AZ",Arizona,"Salt Lake City, UT",Utah,847,751,-3,5,844,756,24,12,868,744,1397,182,202,218,0,,0,0.0,0.0,0.0,0.0,0.0
2024,6,9,7,2024-06-09,HA,3436,BOS,LAS,"Boston, MA",Massachusetts,"Las Vegas, NV",Nevada,2049,1307,-12,-10,2037,1297,28,11,2065,1286,1512,196,216,235,0,,0,0.0,0.0,0.0,0.0,0.0
2024,8,22,4,2024-08-22,HA,7580,SEA,DCA,"Seattle, WA",Washington,"Washington, DC",District of Columbia,910,725,-6,-5,904,720,5,5,909,715,951,124,144,134,0,,0,0.0,0.0,0.0,0.0,0.0
2024,7,8,1,2024-07-08,MQ,5259,LAX,TPA,"Los Angeles, CA",California,"Tampa, FL",Florida,2051,1666,-24,-20,2027,1646,16,7,2043,1639,770,87,107,110,0,,0,0.0,0.0,0.0,0.0,0.0
2024,4,26,5,2024-04-26,9E,1097,STL,DCA,"St. Louis, MO",Missouri,"Washington, DC",District of Columbia,1230,1020,-12,-15,1218,1005,10,19,1228,986,364,50,70,79,0,,0,0.0,0.0,0.0,0.0,0.0
2024,9,27,5,2024-09-27,YX,6453,DCA,ORD,"Washington, DC",District of Columbia,"Chicago, IL",Illinois,1397,2308,-9,-15,1388,2293,27,3,1415,2290,719,95,115,125,0,,0,0.0,0.0,0.0,0.0,0.0
2024,9,14,6,2024-09-14,YX,2419,SEA,LAS,"Seattle, WA",Washington,"Las Vegas, NV",Nevada,1414,2113,-7,-10,1407,2103,28,12,1435,2091,219,26,46,66,0,,0,0.0,0.0,0.0,0.0,0.0
2024,6,28,5,2024-06-28,DL,3307,SLC,ORD,"Salt Lake City, UT",Utah,"Chicago, IL",Illinois,2204,2189,4,5,2208,2194,24,7,2232,2187,2952,365,385,396,0,,0,0.0,0.0,0.0,0.0,0.0
2024,6,20,4,2024-06-20,G4,8890,SFO,LAS,"San Francisco, CA",California,"Las Vegas, NV",Nevada,2049,852,-6,0,2043,852,16,3,2059,849,2878,353,373,372,0,,0,0.0,0.0,0.0,0.0,0.0
2024,9,30,1,2024-09-30,AA,9375,SFO,BOS,"San Francisco, CA",California,"Boston, MA",Massachusetts,742,1598,12,5,754,1603,29,12,783,1591,654,78,98,119,0,,0,0.0,0.0,0.0,0.0,0.0
2024,9,15,7,2024-09-15,B6,3681,LGA,BOS,"New York, NY",New York,"Boston, MA",Massachusetts,507,2331,11,5,518,2336,16,16,534,2320,1478,185,205,217,0,,0,0.0,0.0,0.0,0.0,0.0
2024,5,14,2,2024-05-14,AA,3186,LAX,DTW,"Los Angeles, CA",California,"Detroit, MI",Michigan,1806,2107,7,0,1813,2107,7,18,1820,2089,2049,248,268,273,0,,0,0.0,0.0,0.0,0.0,0.0
2024,6,19,3,2024-06-19,B6,7266,DFW,MDW,"Dallas/Fort Worth, TX",Texas,"Chicago, IL",Illinois,1122,892,-7,0,1115,892,28,16,1143,876,302,27,47,71,0,,0,0.0,0.0,0.0,0.0,0.0
2024,7,28,7,2024-07-28,F9,821,MDW,TPA,"Chicago, IL",Illinois,"Tampa, FL",Florida,2075,1840,24,15,2099,1855,19,12,2118,1843,1157,137,157,168,0,,0,0.0,0.0,0.0,0.0,0.0
2024,8,23,5,2024-08-23,F9,1254,JFK,IAH,"New York, NY",New York,"Houston, TX",Texas,1423,768,-10,0,1413,768,15,10,1428,758,2382,297,317,322,0,,0,0.0,0.0,0.0,0.0,0.0
2024,7,4,4,2024-07-04,OO,7267,PHX,DTW,"Phoenix, AZ",Arizona,"Detroit, MI",Michigan,1079,1333,2,0,1081,1333,14,18,1095,1315,296,31,51,63,0,,0,0.0,0.0,0.0,0.0,0.0
2024,12,29,7,2024-12-29,F9,116,MCO,SLC,"Orlando, FL",Florida,"Salt Lake City, UT",Utah,2158,2263,9,10,2167,2273,25,13,2192,2260,2998,371,391,409,0,,0,0.0,0.0,0.0,0.0,0.0
2024,4,4,4,2024-04-04,DL,7197,SAN,LAS,"San Diego, CA",California,"Las Vegas, NV",Nevada,665,2008,-11,-15,654,1993,25,19,679,1974,1987,239,259,283,0,,0,0.0,0.0,0.0,0.0,0.0
2024,1,11,4,2024-01-11,F9,9283,LAS,SEA,"Las Vegas, NV",Nevada,"Seattle, WA",Washington,1726,615,-1,5,1725,620,27,15,1752,605,2718,334,354,376,0,,0,0.0,0.0,0.0,0.0,0.0
2024,3,8,5,2024-03-08,YX,2332,PHL,MDW,"Philadelphia, PA",Pennsylvania,"Chicago, IL",Illinois,2163,636,-8,-15,2155,621,25,7,2180,614,774,89,109,121,0,,0,0.0,0.0,0.0,0.0,0.0
2024,7,28,7,2024-07-28,B6,1546,JFK,DEN,"New York, NY",New York,"Denver, CO",Colorado,863,2044,3,10,866,2054,27,17,893,2037,388,56,76,100,0,,0,0.0,0.0,0.0,0.0,0.0
2024,7,14,7,2024-07-14,HA,9757,ORD,LGA,"Chicago, IL",Illinois,"New York, NY",New York,1675,895,-5,5,1670,900,20,18,1690,882,592,74,94,112,0,,0,0.0,0.0,0.0,0.0,0.0
2024,4,7,7,2024-04-07,AA,5874,BWI,IAD,"Baltimore, MD",Maryland,"Washington, DC",District of Columbia,1948,1034,-1,0,1947,1034,29,12,1976,1022,1118,137,157,178,0,,0,0.0,0.0,0.0,0.0,0.0
2024,4,2,2,2024-04-02,NK,3183,CLT,SFO,"Charlotte, NC",North Carolina,"San Francisco, CA",California,1157,919,11,5,1168,924,16,19,1184,905,2869,352,372,387,0,,0,0.0,0.0,0.0,0.0,0.0
2024,1,22,1,2024-01-22,MQ,9835,SEA,JFK,"Seattle, WA",Washington,"New York, NY",New York,2084,2249,-3,5,2081,2254,20,17,2101,2237,2295,293,313,330,0,,0,0.0,0.0,0.0,0.0,0.0
2024,6,20,4,2024-06-20,AS,8371,ORD,EWR,"Chicago, IL",Illinois,"Newark, NJ",New Jersey,1992,1133,-7,0,1985,1133,9,10,1994,1123,255,23,43,42,0,,0,0.0,0.0,0.0,0.0,0.0
2024,5,13,1,2024-05-13,B6,7052,PDX,JFK,"Portland, OR",Oregon,"New York, NY",New York,1933,1922,16,15,1949,1937,22,11,1971,1926,1774,218,238,251,0,,0,0.0,0.0,0.0,0.0,0.0
2024,1,25,4,2024-01-25,AA,7941,EWR,CLT,"Newark, NJ",New Jersey,"Charlotte, NC",North Carolina,1014,1173,-5,-5,1009,1168,14,11,1023,1157,1613,196,216,221,0,,0,0.0,0.0,0.0,0.0,0.0
2024,7,3,3,2024-07-03,OH,9563,STL,LAS,"St. Louis, MO",Missouri,"Las Vegas, NV",Nevada,1774,2317,2,10,1776,2327,10,13,1786,2314,2890,358,378,381,0,,0,0.0,0.0,0.0,0.0,0.0
2024,3,25,1,2024-03-25,OH,9856,IAH,EWR,"Houston, TX",Texas,"Newark, NJ",New Jersey,1600,1522,0,0,1600,1522,29,11,1629,1511,828,109,129,149,0,,0,0.0,0.0,0.0,0.0,0.0
2024,2,24,6,2024-02-24,AA,5491,SAN,SEA,"San Diego, CA",California,"Seattle, WA",Washington,1945,1639,-13,-5,1932,1634,18,13,1950,1621,2541,308,328,339,0,,0,0.0,0.0,0.0,0.0,0.0
2024,9,7,6,2024-09-07,AS,9301,DCA,TPA,"Washington, DC",District of Columbia,"Tampa, FL",Florida,1231,1580,-27,-20,1204,1560,18,9,1222,1551,965,114,134,141,0,,0,0.0,0.0,0.0,0.0,0.0
2024,5,23,4,2024-05-23,9E,9064,LAS,SFO,"Las Vegas, NV",Nevada,"San Francisco, CA",California,1409,994,-18,-10,1391,984,13,6,1404,978,335,44,64,63,0,,0,0.0,0.0,0.0,0.0,0.0
2024,12,16,1,2024-12-16,YX,8014,DFW,ATL,"Dallas/Fort Worth, TX",Texas,"Atlanta, GA",Georgia,1908,876,11,10,1919,886,20,11,1939,875,2799,339,359,370,0,,0,0.0,0.0,0.0,0.0,0.0
2024,6,15,6,2024-06-15,NK,582,DCA,LAS,"Washington, DC",District of Columbia,"Las Vegas, NV",Nevada,1902,1248,-4,-5,1898,1243,17,5,1915,1238,1616,211,231,233,0,,0,0.0,0.0,0.0,0.0,0.0
2024,8,11,7,2024-08-11,9E,5781,IAH,DTW,"Houston, TX",Texas,"Detroit, MI",Michigan,1751,882,1,-5,1752,877,18,15,1770,862,2567,317,337,350,0,,0,0.0,0.0,0.0,0.0,0.0
2024,8,7,3,2024-08-07,9E,7537,PHL,MSP,"Philadelphia, PA",Pennsylvania,"Minneapolis, MN",Minnesota,617,2262,-3,0,614,2262,25,18,639,2244,376,48,68,91,0,,0,0.0,0.0,0.0,0.0,0.0
2024,6,27,4,2024-06-27,AA,9873,ATL,SLC,"Atlanta, GA",Georgia,"Salt Lake City, UT",Utah,1509,1598,-11,-10,1498,1588,15,6,1513,1582,676,90,110,111,0,,0,0.0,0.0,0.0,0.0,0.0
2024,4,28,7,2024-04-28,G4,9397,BOS,DTW,"Boston, MA",Massachusetts,"Detroit, MI",Michigan,1790,685,5,0,1795,685,6,12,1801,673,360,36,56,54,0,,0,0.0,0.0,0.0,0.0,0.0
2024,9,21,6,2024-09-21,HA,5303,ATL,DTW,"Atlanta, GA",Georgia,"Detroit, MI",Michigan,1758,806,3,-5,1761,801,26,5,1787,796,1508,180,200,211,0,,0,0.0,0.0,0.0,0.0,0.0
2024,5,29,3,2024-05-29,WN,3461,SEA,BOS,"Seattle, WA",Washington,"Boston, MA",Massachusetts,1691,2286,19,15,1710,2301,24,13,1734,2288,2778,343,363,380,0,,0,0.0,0.0,0.0,0.0,0.0
2024,8,2,5,2024-08-02,B6,6047,MIA,SEA,"Miami, FL",Florida,"Seattle, WA",Washington,1271,1162,0,0,1271,1162,24,19,1295,1143,2988,364,384,407,0,,0,0.0,0.0,0.0,0.0,0.0
2024,7,15,1,2024-07-15,DL,9133,MSP,BWI,"Minneapolis, MN",Minnesota,"Baltimore, MD",Maryland,1429,1076,6,10,1435,1086,23,19,1458,1067,2658,340,360,382,0,,0,0.0,0.0,0.0,0.0,0.0
2024,2,11,7,2024-02-11,OH,3634,HNL,MIA,"Honolulu, HI",Hawaii,"Miami, FL",Florida,2228,1191,1,5,2229,1196,16,14,2245,1182,208,35,55,65,0,,0,0.0,0.0,0.0,0.0,0.0
2024,2,22,4,2024-02-22,YX,1972,DEN,ORD,"Denver, CO",Colorado,"Chicago, IL",Illinois,1195,730,-3,-10,1192,720,21,6,1213,714,1850,231,251,258,0,,0,0.0,0.0,0.0,0.0,0.0
2024,11,25,1,2024-11-25,9E,7358,ORD,IAH,"Chicago, IL",Illinois,"Houston, TX",Texas,1021,999,18,10,1039,1009,13,10,1052,999,1881,235,255,258,0,,0,0.0,0.0,0.0,0.0,0.0
2024,9,7,6,2024-09-07,MQ,6082,DCA,MCO,"Washington, DC",District of Columbia,"Orlando, FL",Florida,836,735,-10,-15,826,720,26,3,852,717,959,124,144,153,0,,0,0.0,0.0,0.0,0.0,0.0
2024,10,21,1,2024-10-21,F9,3605,STL,MCO,"St. Louis, MO",Missouri,"Orlando, FL",Florida,1850,1969,-13,-5,1837,1964,15,13,1852,1951,1620,205,225,233,0,,0,0.0,0.0,0.0,0.0,0.0
2024,9,27,5,2024-09-27,OH,3420,DFW,BOS,"Dallas/Fort Worth, TX",Texas,"Boston, MA",Massachusetts,1882,769,-15,-10,1867,759,16,8,1883,751,270,28,48,52,0,,0,0.0,0.0,0.0,0.0,0.0
2024,5,2,4,2024-05-02,DL,2828,PDX,SAN,"Portland, OR",Oregon,"San Diego, CA",California,947,1568,-10,0,937,1568,7,7,944,1561,2840,346,366,360,0,,0,0.0,0.0,0.0,0.0,0.0
2024,12,4,3,2024-12-04,UA,1054,DEN,MIA,"Denver, CO",Colorado,"Miami, FL",Florida,1152,1786,-15,-5,1137,1781,21,17,1158,1764,1168,145,165,183,0,,0,0.0,0.0,0.0,0.0,0.0
2024,9,22,7,2024-09-22,HA,1695,MDW,MSP,"Chicago, IL",Illinois,"Minneapolis, MN",Minnesota,2057,798,9,5,2066,803,10,17,2076,786,1767,216,236,243,0,,0,0.0,0.0,0.0,0.0,0.0
2024,12,13,5,2024-12-13,YX,2388,JFK,MDW,"New York, NY",New York,"Chicago, IL",Illinois,1389,1338,24,15,1413,1353,8,9,1421,1344,2397,308,328,325,0,,0,0.0,0.0,0.0,0.0,0.0
2024,1,29,1,2024-01-29,HA,6945,SEA,LGA,"Seattle, WA",Washington,"New York, NY",New York,2228,1671,5,5,2233,1676,17,19,2250,1657,2659,327,347,363,0,,0,0.0,0.0,0.0,0.0,0.0
2024,2,4,7,2024-02-04,G4,7763,IAD,ATL,"Washington, DC",District of Columbia,"Atlanta, GA",Georgia,1103,1364,-6,-5,1097,1359,21,3,1118,1356,2174,269,289,293,0,,0,0.0,0.0,0.0,0.0,0.0
2024,1,6,6,2024-01-06,DL,7036,ATL,MDW,"Atlanta, GA",Georgia,"Chicago, IL",Illinois,1620,2117,-8,0,1612,2117,14,16,1626,2101,2239,269,289,299,0,,0,0.0,0.0,0.0,0.0,0.0
2024,4,20,6,2024-04-20,OH,843,DFW,ORD,"Dallas/Fort Worth, TX",Texas,"Chicago, IL",Illinois,1152,702,3,10,1155,712,24,18,1179,694,791,91,111,133,0,,0,0.0,0.0,0.0,0.0,0.0
2024,10,20,7,2024-10-20,AS,1594,DEN,PHL,"Denver, CO",Colorado,"Philadelphia, PA",Pennsylvania,2292,1147,-9,-10,2283,1137,22,4,2305,1133,1696,202,222,228,0,,0,0.0,0.0,0.0,0.0,0.0
2024,3,17,7,2024-03-17,YX,6706,HNL,PDX,"Honolulu, HI",Hawaii,"Portland, OR",Oregon,2073,605,-20,-15,2053,590,18,9,2071,581,995,121,141,148,0,,0,0.0,0.0,0.0,0.0,0.0
2024,12,14,6,2024-12-14,WN,7044,PHX,DEN,"Phoenix, AZ",Arizona,"Denver, CO",Colorado,1258,1310,-6,-15,1252,1295,20,14,1272,1281,740,89,109,123,0,,0,0.0,0.0,0.0,0.0,0.0
2024,5,26,7,2024-05-26,NK,7308,DTW,ORD,"Detroit, MI",Michigan,"Chicago, IL",Illinois,1779,611,8,0,1787,611,23,11,1810,600,1585,196,216,230,0,,0,0.0,0.0,0.0,0.0,0.0
2024,3,7,4,2024-03-07,OH,307,HNL,DEN,"Honolulu, HI",Hawaii,"Denver, CO",Colorado,941,702,10,5,951,707,19,19,970,688,870,109,129,147,0,,0,0.0,0.0,0.0,0.0,0.0
2024,1,8,1,2024-01-08,OH,1183,IAH,IAD,"Houston, TX",Texas,"Washington, DC",District of Columbia,908,1298,4,5,912,1303,27,9,939,1294,2853,362,382,398,0,,0,0.0,0.0,0.0,0.0,0.0
2024,5,1,3,2024-05-01,AS,2512,JFK,PHX,"New York, NY",New York,"Phoenix, AZ",Arizona,1309,2313,-5,0,1304,2313,27,16,1331,2297,2863,358,378,401,0,,0,0.0,0.0,0.0,0.0,0.0
2024,12,5,4,2024-12-05,9E,3411,MSP,TPA,"Minneapolis, MN",Minnesota,"Tampa, FL",Florida,584,1026,14,5,598,1031,25,4,623,1027,2272,284,304,313,0,,0,0.0,0.0,0.0,0.0,0.0
2024,6,23,7,2024-06-23,OH,6851,PHL,DCA,"Philadelphia, PA",Pennsylvania,"Washington, DC",District of Columbia,1940,770,-6,0,1934,770,17,10,1951,760,1979,252,272,279,0,,0,0.0,0.0,0.0,0.0,0.0
2024,6,27,4,2024-06-27,G4,8057,PHX,DEN,"Phoenix, AZ",Arizona,"Denver, CO",Colorado,1452,2312,-1,0,1451,2312,6,3,1457,2309,2564,311,331,320,0,,0,0.0,0.0,0.0,0.0,0.0
2024,3,25,1,2024-03-25,OH,8688,IAD,JFK,"Washington, DC",District of Columbia,"New York, NY",New York,2072,688,-9,-10,2063,678,13,4,2076,674,1552,198,218,215,0,,0,0.0,0.0,0.0,0.0,0.0
2024,2,14,3,2024-02-14,G4,308,LGA,LAX,"New York, NY",New York,"Los Angeles, CA",California,2025,1315,2,-5,2027,1310,17,17,2044,1293,2084,255,275,289,0,,0,0.0,0.0,0.0,0.0,0.0
2024,5,15,3,2024-05-15,9E,7648,PDX,MIA,"Portland, OR",Oregon,"Miami, FL",Florida,1196,2062,-13,-5,1183,2057,29,17,1212,2040,2604,325,345,371,0,,0,0.0,0.0,0.0,0.0,0.0
2024,12,8,7,2024-12-08,WN,8724,MDW,EWR,"Chicago, IL",Illinois,"Newark, NJ",New Jersey,597,1970,4,10,601,1980,29,4,630,1976,1790,217,237,250,0,,0,0.0,0.0,0.0,0.0,0.0
2024,1,16,2,2024-01-16,AA,2756,PDX,DFW,"Portland, OR",Oregon,"Dallas/Fort Worth, TX",Texas,1041,1454,-3,5,1038,1459,26,7,1064,1452,1139,145,165,178,0,,0,0.0,0.0,0.0,0.0,0.0
2024,11,28,4,2024-11-28,DL,5950,PHL,LGA,"Philadelphia, PA",Pennsylvania,"New York, NY",New York,2026,1834,-18,-10,2008,1824,16,14,2024,1810,2860,362,382,392,0,,0,0.0,0.0,0.0,0.0,0.0
2024,7,13,6,2024-07-13,F9,2536,IAH,PHL,"Houston, TX",Texas,"Philadelphia, PA",Pennsylvania,1974,2348,-17,-15,1957,2333,5,15,1962,2318,1233,146,166,166,0,,0,0.0,0.0,0.0,0.0,0.0
2024,1,9,2,2024-01-09,OH,5493,DEN,SEA,"Denver, CO",Colorado,"Seattle, WA",Washington,690,2057,-2,5,688,2062,17,18,705,2044,2016,244,264,279,0,,0,0.0,0.0,0.0,0.0,0.0
2024,11,11,1,2024-11-11,9E,233,PDX,MIA,"Portland, OR",Oregon,"Miami, FL",Florida,1467,2156,4,-5,1471,2151,26,10,1497,2141,2247,284,304,320,0,,0,0.0,0.0,0.0,0.0,0.0
2024,11,29,5,2024-11-29,F9,7333,MCO,SLC,"Orlando, FL",Florida,"Salt Lake City, UT",Utah,1724,1199,-4,-10,1720,1189,12,7,1732,1182,2942,365,385,384,0,,0,0.0,0.0,0.0,0.0,0.0
2024,11,28,4,2024-11-28,OH,738,IAH,PDX,"Houston, TX",Texas,"Portland, OR",Oregon,1845,2148,-19,-15,1826,2133,8,13,1834,2120,2733,347,367,368,0,,0,0.0,0.0,0.0,0.0,0.0
2024,11,22,5,2024-11-22,HA,1328,PHL,ORD,"Philadelphia, PA",Pennsylvania,"Chicago, IL",Illinois,2224,1025,-18,-20,2206,1005,26,13,2232,992,977,115,135,154,0,,0,0.0,0.0,0.0,0.0,0.0
2024,1,15,1,2024-01-15,DL,4119,LGA,DCA,"New York, NY",New York,"Washington, DC",District of Columbia,757,1610,-4,-5,753,1605,15,12,768,1593,1115,135,155,162,0,,0,0.0,0.0,0.0,0.0,0.0
2024,11,22,5,2024-11-22,WN,9582,ATL,MSP,"Atlanta, GA",Georgia,"Minneapolis, MN",Minnesota,654,1595,2,-5,656,1590,28,15,684,1575,1393,175,195,218,0,,0,0.0,0.0,0.0,0.0,0.0
2024,4,11,4,2024-04-11,AA,2296,PHL,DCA,"Philadelphia, PA",Pennsylvania,"Washington, DC",District of Columbia,1443,1743,9,5,1452,1748,10,13,1462,1735,262,37,57,60,0,,0,0.0,0.0,0.0,0.0,0.0
2024,8,13,2,2024-08-13,NK,9995,PHL,IAH,"Philadelphia, PA",Pennsylvania,"Houston, TX",Texas,2010,777,14,20,2024,797,17,3,2041,794,2752,334,354,354,0,,0,0.0,5.0,3.0,0.0,12.0
2024,10,4,5,2024-10-04,WN,1075,DEN,ORD,"Denver, CO",Colorado,"Chicago, IL",Illinois,727,1752,-20,-10,707,1742,24,13,731,1729,1482,179,199,216,0,,1,0.0,0.0,0.0,0.0,0.0
2024,4,22,1,2024-04-22,OO,6221,CLT,IAH,"Charlotte, NC",North Carolina,"Houston, TX",Texas,1016,1162,-12,-10,1004,1152,27,6,1031,1146,1650,201,221,234,0,,0,0.0,0.0,0.0,0.0,0.0
2024,1,1,1,2024-01-01,OH,1128,SAN,IAD,"San Diego, CA",California,"Washington, DC",District of Columbia,1140,1017,-7,-5,1133,1012,9,3,1142,1009,2251,285,305,297,0,,0,0.0,0.0,0.0,0.0,0.0
2024,9,22,7,2024-09-22,F9,625,IAH,PHL,"Houston, TX",Texas,"Philadelphia, PA",Pennsylvania,2034,1153,2,0,2036,1153,17,8,2053,1145,440,61,81,86,1,,0,0.0,0.0,0.0,0.0,0.0
2024,7,26,5,2024-07-26,G4,2427,DFW,IAD,"Dallas/Fort Worth, TX",Texas,"Washington, DC",District of Columbia,573,1941,5,5,578,1946,21,18,599,1928,2544,323,343,362,0,,0,0.0,0.0,0.0,0.0,0.0
2024,4,19,5,2024-04-19,YX,2646,SEA,MSP,"Seattle, WA",Washington,"Minneapolis, MN",Minnesota,864,2230,-7,-5,857,2225,23,12,880,2213,1734,220,240,255,0,,0,0.0,0.0,0.0,0.0,0.0
2024,7,18,4,2024-07-18,G4,935,SAN,MSP,"San Diego, CA",California,"Minneapolis, MN",Minnesota,523,841,-21,-15,502,826,23,13,525,813,1389,182,202,218,0,,0,0.0,0.0,0.0,0.0,0.0
2024,11,1,5,2024-11-01,UA,2583,MCO,SFO,"Orlando, FL",Florida,"San Francisco, CA",California,962,1979,8,5,970,1984,5,18,975,1966,722,91,111,114,0,,0,0.0,0.0,0.0,0.0,0.0
2024,1,12,5,2024-01-12,B6,2834,DFW,IAD,"Dallas/Fort Worth, TX",Texas,"Washington, DC",District of Columbia,980,2196,10,5,990,2201,8,11,998,2190,2663,332,352,351,0,,0,0.0,0.0,0.0,0.0,0.0
2024,12,10,2,2024-12-10,AS,9830,DEN,JFK,"Denver, CO",Colorado,"New York, NY",New York,2241,2061,-19,-10,2222,2051,6,14,2228,2037,1817,220,240,240,0,,0,0.0,0.0,0.0,0.0,0.0
2024,7,6,6,2024-07-06,AS,7404,PHX,BOS,"Phoenix, AZ",Arizona,"Boston, MA",Massachusetts,2181,2081,-11,-15,2170,2066,16,19,2186,2047,2031,255,275,290,0,,0,0.0,0.0,0.0,0.0,0.0
2024,6,2,7,2024-06-02,9E,4149,MCO,HNL,"Orlando, FL",Florida,"Honolulu, HI",Hawaii,1612,2065,6,0,1618,2065,5,13,1623,2052,2132,266,286,284,0,,0,0.0,0.0,0.0,0.0,0.0
2024,11,29,5,2024-11-29,F9,9595,SAN,SFO,"San Diego, CA",California,"San Francisco, CA",California,2057,1851,-16,-10,2041,1841,16,3,2057,1838,1720,223,243,242,0,,0,0.0,0.0,0.0,0.0,0.0
2024,10,5,6,2024-10-05,AS,8423,ORD,ATL,"Chicago, IL",Illinois,"Atlanta, GA",Georgia,1823,1007,-6,-5,1817,1002,17,8,1834,994,964,118,138,143,0,,0,0.0,0.0,0.0,0.0,0.0
2024,6,19,3,2024-06-19,AS,492,ORD,MDW,"Chicago, IL",Illinois,"Chicago, IL",Illinois,543,1900,9,5,552,1905,10,12,562,1893,2924,364,384,386,0,,0,0.0,0.0,0.0,0.0,0.0
2024,5,13,1,2024-05-13,WN,2566,JFK,PDX,"New York, NY",New York,"Portland, OR",Oregon,1560,1641,-1,-10,1559,1631,11,10,1570,1621,956,109,129,130,0,,0,0.0,0.0,0.0,0.0,0.0
2024,1,25,4,2024-01-25,NK,1325,PHL,ATL,"Philadelphia, PA",Pennsylvania,"Atlanta, GA",Georgia,2042,1934,3,10,2045,1944,24,16,2069,1928,823,92,112,132,0,,0,0.0,0.0,0.0,0.0,0.0
2024,1,18,4,2024-01-18,OH,2805,SLC,DFW,"Salt Lake City, UT",Utah,"Dallas/Fort Worth, TX",Texas,1997,1947,-2,5,1995,1952,9,9,2004,1943,1749,221,241,239,0,,0,0.0,0.0,0.0,0.0,0.0
2024,7,8,1,2024-07-08,OH,561,DFW,DCA,"Dallas/Fort Worth, TX",Texas,"Washington, DC",District of Columbia,1803,1670,-14,-10,1789,1660,13,9,1802,1651,2623,332,352,354,0,,0,0.0,0.0,0.0,0.0,0.0
2024,5,20,1,2024-05-20,F9,4085,DFW,MDW,"Dallas/Fort Worth, TX",Texas,"Chicago, IL",Illinois,960,1421,-10,0,950,1421,17,8,967,1413,2621,326,346,351,0,,0,0.0,0.0,0.0,0.0,0.0
2024,2,12,1,2024-02-12,UA,251,JFK,BOS,"New York, NY",New York,"Boston, MA",Massachusetts,1692,1129,9,0,1701,1129,18,13,1719,1116,1595,208,228,239,0,,0,0.0,0.0,0.0,0.0,0.0
2024,11,29,5,2024-11-29,NK,1885,TPA,LAX,"Tampa, FL",Florida,"Los Angeles, CA",California,569,2336,-19,-10,550,2326,12,3,562,2323,2829,343,363,358,0,,0,0.0,0.0,0.0,0.0,0.0
2024,10,10,4,2024-10-10,UA,6342,PHX,LAX,"Phoenix, AZ",Arizona,"Los Angeles, CA",California,712,1099,-7,-15,705,1084,20,8,725,1076,1511,190,210,218,0,,0,0.0,0.0,0.0,0.0,0.0
2024,5,25,6,2024-05-25,F9,8245,ATL,LAX,"Atlanta, GA",Georgia,"Los Angeles, CA",California,2106,791,-7,0,2099,791,18,15,2117,776,1639,200,220,233,0,,0,0.0,0.0,0.0,0.0,0.0
2024,11,10,7,2024-11-10,AA,6456,MDW,SFO,"Chicago, IL",Illinois,"San Francisco, CA",California,1413,648,-5,5,1408,653,22,4,1430,649,1970,255,275,281,0,,0,0.0,0.0,0.0,0.0,0.0
2024,11,14,4,2024-11-14,AA,7410,BOS,PHL,"Boston, MA",Massachusetts,"Philadelphia, PA",Pennsylvania,2242,693,-10,0,2232,693,14,19,2246,674,2720,346,366,379,0,,0,0.0,0.0,0.0,0.0,0.0
2024,4,1,1,2024-04-01,OH,6945,MIA,LAS,"Miami, FL",Florida,"Las Vegas, NV",Nevada,571,1530,-23,-15,548,1515,23,19,571,1496,2080,266,286,308,0,,0,0.0,0.0,0.0,0.0,0.0
2024,6,27,4,2024-06-27,AS,3560,CLT,DCA,"Charlotte, NC",North Carolina,"Washington, DC",District of Columbia,1327,2357,22,15,1349,2372,20,4,1369,2368,1533,193,213,217,0,,0,0.0,0.0,0.0,0.0,0.0
2024,2,25,7,2024-02-25,9E,1936,DEN,MDW,"Denver, CO",Colorado,"Chicago, IL",Illinois,679,766,-3,5,676,771,13,3,689,768,2944,363,383,379,0,,0,0.0,0.0,0.0,0.0,0.0
2024,6,3,1,2024-06-03,G4,9689,SFO,MSP,"San Francisco, CA",California,"Minneapolis, MN",Minnesota,707,2117,-8,0,699,2117,25,14,724,2103,847,100,120,139,0,,0,0.0,0.0,0.0,0.0,0.0
2024,6,8,6,2024-06-08,YX,9367,ORD,SEA,"Chicago, IL",Illinois,"Seattle, WA",Washington,676,853,2,0,678,853,5,14,683,839,881,108,128,127,0,,0,0.0,0.0,0.0,0.0,0.0
2024,4,20,6,2024-04-20,OH,5843,EWR,BOS,"Newark, NJ",New Jersey,"Boston, MA",Massachusetts,1206,656,-15,-5,1191,651,13,7,1204,644,1962,251,271,271,0,,0,0.0,0.0,0.0,0.0,0.0
2024,5,16,4,2024-05-16,WN,6378,MSP,PHX,"Minneapolis, MN",Minnesota,"Phoenix, AZ",Arizona,1824,605,32,30,1856,635,28,18,1884,617,1549,190,210,236,0,,0,1.0,8.0,5.0,0.0,16.0
2024,8,19,1,2024-08-19,AS,1593,SEA,PDX,"Seattle, WA",Washington,"Portland, OR",Oregon,1383,837,-21,-15,1362,822,18,18,1380,804,1970,241,261,277,0,,0,0.0,0.0,0.0,0.0,0.0
2024,8,7,3,2024-08-07,YX,9427,SLC,CLT,"Salt Lake City, UT",Utah,"Charlotte, NC",North Carolina,1250,1332,11,5,1261,1337,11,15,1272,1322,1163,145,165,171,0,,0,0.0,0.0,0.0,0.0,0.0
2024,3,8,5,2024-03-08,B6,1648,LAX,IAH,"Los Angeles, CA",California,"Houston, TX",Texas,1677,1847,-5,-5,1672,1842,27,9,1699,1833,627,80,100,116,0,,0,0.0,0.0,0.0,0.0,0.0
2024,10,28,1,2024-10-28,YX,9076,LGA,CLT,"New York, NY",New York,"Charlotte, NC",North Carolina,653,1189,9,10,662,1199,28,14,690,1185,1706,211,231,253,0,,0,0.0,0.0,0.0,0.0,0.0
2024,9,5,4,2024-09-05,HA,5263,STL,SFO,"St. Louis, MO",Missouri,"San Francisco, CA",California,529,619,9,5,538,624,15,16,553,608,1441,189,209,220,0,,0,0.0,0.0,0.0,0.0,0.0
2024,11,18,1,2024-11-18,AA,9712,DFW,TPA,"Dallas/Fort Worth, TX",Texas,"Tampa, FL",Florida,1550,1376,2,0,1552,1376,24,11,1576,1365,230,30,50,65,0,,0,0.0,0.0,0.0,0.0,0.0
2024,1,6,6,2024-01-06,AS,5804,PHL,LAX,"Philadelphia, PA",Pennsylvania,"Los Angeles, CA",California,1475,1827,14,15,1489,1842,11,13,1500,1829,1564,203,223,227,0,,0,0.0,0.0,0.0,0.0,0.0
2024,10,6,7,2024-10-06,G4,6504,BWI,DCA,"Baltimore, MD",Maryland,"Washington, DC",District of Columbia,1763,741,13,15,1776,756,28,13,1804,743,671,86,106,127,0,,0,0.0,0.0,0.0,0.0,0.0
2024,4,3,3,2024-04-03,HA,6788,PHL,ATL,"Philadelphia, PA",Pennsylvania,"Atlanta, GA",Georgia,2278,975,-19,-15,2259,960,14,4,2273,956,1854,238,258,256,0,,0,0.0,0.0,0.0,0.0,0.0
2024,9,25,3,2024-09-25,HA,3751,ORD,BWI,"Chicago, IL",Illinois,"Baltimore, MD",Maryland,1143,1006,-11,-10,1132,996,23,17,1155,979,590,81,101,121,0,,0,0.0,0.0,0.0,0.0,0.0
2024,7,15,1,2024-07-15,YX,2163,TPA,STL,"Tampa, FL",Florida,"St. Louis, MO",Missouri,1190,1415,3,5,1193,1420,6,14,1199,1406,2657,327,347,347,0,,0,0.0,0.0,0.0,0.0,0.0
2024,1,25,4,2024-01-25,UA,2120,DTW,IAH,"Detroit, MI",Michigan,"Houston, TX",Texas,597,679,17,15,614,694,6,9,620,685,1379,180,200,195,0,,0,0.0,0.0,0.0,0.0,0.0
2024,5,27,1,2024-05-27,OO,4857,PHL,LGA,"Philadelphia, PA",Pennsylvania,"New York, NY",New York,825,809,0,-5,825,804,27,14,852,790,451,49,69,90,0,,0,0.0,0.0,0.0,0.0,0.0
2024,4,27,6,2024-04-27,HA,6023,MIA,JFK,"Miami, FL",Florida,"New York, NY",New York,736,1367,-29,-20,707,1347,29,5,736,1342,1267,164,184,198,0,,0,0.0,0.0,0.0,0.0,0.0
2024,12,3,2,2024-12-03,UA,7453,ATL,BWI,"Atlanta, GA",Georgia,"Baltimore, MD",Maryland,637,1935,-3,0,634,1935,20,12,654,1923,1301,156,176,188,0,,0,0.0,0.0,0.0,0.0,0.0
2024,12,3,2,2024-12-03,OH,9242,LGA,STL,"New York, NY",New York,"St. Louis, MO",Missouri,1129,976,-14,-10,1115,966,16,11,1131,955,2574,311,331,338,0,,0,0.0,0.0,0.0,0.0,0.0
2024,3,6,3,2024-03-06,DL,8316,IAH,DTW,"Houston, TX",Texas,"Detroit, MI",Michigan,1117,639,-9,0,1108,639,12,17,1120,622,344,44,64,73,0,,0,0.0,0.0,0.0,0.0,0.0
2024,10,27,7,2024-10-27,MQ,8309,MIA,DEN,"Miami, FL",Florida,"Denver, CO",Colorado,2071,1976,-15,-5,2056,1971,14,9,2070,1962,854,99,119,122,0,,0,0.0,0.0,0.0,0.0,0.0
2024,6,23,7,2024-06-23,WN,669,IAH,MCO,"Houston, TX",Texas,"Orlando, FL",Florida,1569,1052,-7,0,1562,1052,27,6,1589,1046,669,92,112,125,0,,0,0.0,0.0,0.0,0.0,0.0
2024,11,14,4,2024-11-14,9E,5212,MDW,SAN,"Chicago, IL",Illinois,"San Diego, CA",California,2139,2046,10,15,2149,2061,19,16,2168,2045,1185,151,171,186,0,,0,0.0,0.0,0.0,0.0,0.0
2024,3,16,6,2024-03-16,UA,1455,DTW,DEN,"Detroit, MI",Michigan,"Denver, CO",Colorado,889,1313,-9,0,880,1313,20,14,900,1299,1118,135,155,169,0,,0,0.0,0.0,0.0,0.0,0.0
2024,4,23,2,2024-04-23,YX,8156,BWI,EWR,"Baltimore, MD",Maryland,"Newark, NJ",New Jersey,1887,685,-24,-20,1863,665,29,13,1892,652,1159,144,164,186,0,,0,0.0,0.0,0.0,0.0,0.0
2024,4,20,6,2024-04-20,DL,9884,PHX,STL,"Phoenix, AZ",Arizona,"St. Louis, MO",Missouri,859,2178,-1,0,858,2178,8,5,866,2173,1535,196,216,209,0,,0,0.0,0.0,0.0,0.0,0.0
2024,9,5,4,2024-09-05,AA,930,LAS,IAH,"Las Vegas, NV",Nevada,"Houston, TX",Texas,1081,835,-7,-5,1074,830,27,7,1101,823,1311,162,182,196,0,,0,0.0,0.0,0.0,0.0,0.0
2024,7,21,7,2024-07-21,UA,5231,PHL,ATL,"Philadelphia, PA",Pennsylvania,"Atlanta, GA",Georgia,706,2038,-4,5,702,2043,9,5,711,2038,2333,300,320,314,0,,0,0.0,0.0,0.0,0.0,0.0
2024,5,26,7,2024-05-26,9E,5502,EWR,MCO,"Newark, NJ",New Jersey,"Orlando, FL",Florida,2256,2205,4,0,2260,2205,21,8,2281,2197,2210,280,300,309,0,,0,0.0,0.0,0.0,0.0,0.0
2024,2,4,7,2024-02-04,AS,9163,LAS,PDX,"Las Vegas, NV",Nevada,"Portland, OR",Oregon,1100,1979,9,5,1109,1984,14,3,1123,1981,2652,325,345,342,0,,0,0.0,0.0,0.0,0.0,0.0
2024,11,4,1,2024-11-04,G4,934,MIA,STL,"Miami, FL",Florida,"St. Louis, MO",Missouri,1478,2266,20,15,1498,2281,8,7,1506,2274,1388,176,196,191,0,,0,0.0,0.0,0.0,0.0,0.0
2024,1,26,5,2024-01-26,OO,5052,CLT,DEN,"Charlotte, NC",North Carolina,"Denver, CO",Colorado,1014,1243,-14,-5,1000,1238,5,16,1005,1222,2895,352,372,373,0,,0,0.0,0.0,0.0,0.0,0.0
2024,8,25,7,2024-08-25,B6,1069,IAH,BOS,"Houston, TX",Texas,"Boston, MA",Massachusetts,1309,1871,36,30,1345,1901,5,11,1350,1890,1605,198,218,214,0,,0,4.0,0.0,0.0,0.0,26.0
2024,1,14,7,2024-01-14,HA,692,CLT,MCO,"Charlotte, NC",North Carolina,"Orlando, FL",Florida,1889,1266,-15,-15,1874,1251,11,12,1885,1239,1545,191,211,214,0,,0,0.0,0.0,0.0,0.0,0.0
2024,2,14,3,2024-02-14,UA,354,SLC,DFW,"Salt Lake City, UT",Utah,"Dallas/Fort Worth, TX",Texas,937,2224,7,0,944,2224,7,13,951,2211,2747,339,359,359,0,,0,0.0,0.0,0.0,0.0,0.0
2024,8,3,6,2024-08-03,OH,2761,MIA,MSP,"Miami, FL",Florida,"Minneapolis, MN",Minnesota,1754,1852,-30,-20,1724,1832,20,12,1744,1820,207,22,42,54,0,,0,0.0,0.0,0.0,0.0,0.0
2024,8,20,2,2024-08-20,B6,8894,BWI,PDX,"Baltimore, MD",Maryland,"Portland, OR",Oregon,1946,2162,-9,-10,1937,2152,29,5,1966,2147,1745,212,232,246,0,,0,0.0,0.0,0.0,0.0,0.0
2024,7,11,4,2024-07-11,B6,9357,DTW,HNL,"Detroit, MI",Michigan,"Honolulu, HI",Hawaii,968,960,-5,0,963,960,20,18,983,942,693,76,96,114,0,,0,0.0,0.0,0.0,0.0,0.0
2024,2,20,2,2024-02-20,B6,1939,MIA,LAX,"Miami, FL",Florida,"Los Angeles, CA",California,1129,1467,-13,-20,1116,1447,19,16,1135,1431,1213,156,176,191,0,,0,0.0,0.0,0.0,0.0,0.0
2024,8,1,4,2024-08-01,YX,6005,MSP,ATL,"Minneapolis, MN",Minnesota,"Atlanta, GA",Georgia,1834,1349,-9,-15,1825,1334,27,15,1852,1319,1526,191,211,233,0,,0,0.0,0.0,0.0,0.0,0.0
2024,5,30,4,2024-05-30,YX,2531,LAX,SEA,"Los Angeles, CA",California,"Seattle, WA",Washington,894,774,-4,-10,890,764,15,15,905,749,2385,297,317,327,0,,0,0.0,0.0,0.0,0.0,0.0
2024,10,1,2,2024-10-01,NK,7856,CLT,BWI,"Charlotte, NC",North Carolina,"Baltimore, MD",Maryland,613,1427,-9,0,604,1427,26,5,630,1422,727,89,109,120,0,,0,0.0,0.0,0.0,0.0,0.0
2024,12,3,2,2024-12-03,B6,5453,SAN,LAX,"San Diego, CA",California,"Los Angeles, CA",California,1725,1403,-13,-20,1712,1383,22,19,1734,1364,713,89,109,130,0,,0,0.0,0.0,0.0,0.0,0.0
2024,3,16,6,2024-03-16,NK,1065,SAN,SLC,"San Diego, CA",California,"Salt Lake City, UT",Utah,962,1997,4,0,966,1997,25,11,991,1986,1288,169,189,205,0,,0,0.0,0.0,0.0,0.0,0.0
2024,8,7,3,2024-08-07,G4,1837,BWI,HNL,"Baltimore, MD",Maryland,"Honolulu, HI",Hawaii,1041,660,-10,0,1031,660,28,8,1059,652,1938,250,270,286,0,,0,0.0,0.0,0.0,0.0,0.0
2024,12,13,5,2024-12-13,B6,584,LAX,MDW,"Los Angeles, CA",California,"Chicago, IL",Illinois,1887,1793,4,-5,1891,1788,24,16,1915,1772,1847,222,242,262,0,,0,0.0,0.0,0.0,0.0,0.0
2024,7,5,5,2024-07-05,DL,8041,BWI,DTW,"Baltimore, MD",Maryland,"Detroit, MI",Michigan,746,2130,-12,-15,734,2115,12,19,746,2096,518,68,88,99,0,,0,0.0,0.0,0.0,0.0,0.0
2024,10,15,2,2024-10-15,B6,8302,MCO,BWI,"Orlando, FL",Florida,"Baltimore, MD",Maryland,2116,1374,2,0,2118,1374,29,16,2147,1358,2049,250,270,295,0,,0,0.0,0.0,0.0,0.0,0.0
2024,1,28,7,2024-01-28,F9,6351,DFW,JFK,"Dallas/Fort Worth, TX",Texas,"New York, NY",New York,1769,1013,1,0,1770,1013,28,5,1798,1008,1203,155,175,188,0,,0,0.0,0.0,0.0,0.0,0.0
2024,6,28,5,2024-06-28,YX,2127,DFW,PHX,"Dallas/Fort Worth, TX",Texas,"Phoenix, AZ",Arizona,1707,715,-3,0,1704,715,10,4,1714,711,748,95,115,109,0,,0,0.0,0.0,0.0,0.0,0.0
2024,9,9,1,2024-09-09,WN,5313,CLT,MDW,"Charlotte, NC",North Carolina,"Chicago, IL",Illinois,1936,1798,1,5,1937,1803,22,7,1959,1796,388,50,70,79,0,,0,0.0,0.0,0.0,0.0,0.0
2024,5,5,7,2024-05-05,DL,8090,LAS,PHL,"Las Vegas, NV",Nevada,"Philadelphia, PA",Pennsylvania,772,2356,-13,-10,759,2346,12,7,771,2339,1539,194,214,213,0,,0,0.0,0.0,0.0,0.0,0.0
2024,6,25,2,2024-06-25,9E,6327,ORD,HNL,"Chicago, IL",Illinois,"Honolulu, HI",Hawaii,1044,2047,12,5,1056,2052,24,11,1080,2041,1861,237,257,272,1,,0,0.0,0.0,0.0,0.0,0.0
2024,2,6,2,2024-02-06,UA,7081,MDW,PDX,"Chicago, IL",Illinois,"Portland, OR",Oregon,2137,1751,-6,-10,2131,1741,21,19,2152,1722,549,61,81,101,0,,0,0.0,0.0,0.0,0.0,0.0
2024,4,8,1,2024-04-08,G4,8896,IAH,CLT,"Houston, TX",Texas,"Charlotte, NC",North Carolina,1800,2112,-9,-5,1791,2107,9,13,1800,2094,246,29,49,51,0,,0,0.0,0.0,0.0,0.0,0.0
2024,4,7,7,2024-04-07,G4,1068,SEA,DCA,"Seattle, WA",Washington,"Washington, DC",District of Columbia,1122,1628,-25,-15,1097,1613,7,8,1104,1605,2072,261,281,276,0,,0,0.0,0.0,0.0,0.0,0.0
2024,5,6,1,2024-05-06,F9,536,HNL,PHX,"Honolulu, HI",Hawaii,"Phoenix, AZ",Arizona,2022,1949,5,10,2027,1959,23,5,2050,1954,2682,327,347,355,0,,0,0.0,0.0,0.0,0.0,0.0
2024,6,16,7,2024-06-16,F9,1909,SLC,PDX,"Salt Lake City, UT",Utah,"Portland, OR",Oregon,1217,1297,5,0,1222,1297,11,17,1233,1280,1566,194,214,222,0,,0,0.0,0.0,0.0,0.0,0.0
2024,3,20,3,2024-03-20,F9,6646,HNL,PHL,"Honolulu, HI",Hawaii,"Philadelphia, PA",Pennsylvania,1277,1795,23,20,1300,1815,16,6,1316,1809,1178,141,161,163,0,,0,3.0,2.0,3.0,0.0,12.0
2024,10,20,7,2024-10-20,F9,8207,STL,EWR,"St. Louis, MO",Missouri,"Newark, NJ",New Jersey,1520,1822,12,15,1532,1837,5,16,1537,1821,462,54,74,75,0,,0,0.0,0.0,0.0,0.0,0.0
2024,11,28,4,2024-11-28,F9,5605,MCO,TPA,"Orlando, FL",Florida,"Tampa, FL",Florida,989,1854,89,90,1078,1944,7,10,1085,1934,905,103,123,120,0,,0,23.0,21.0,14.0,2.0,30.0
2024,5,5,7,2024-05-05,AA,5357,MIA,SLC,"Miami, FL",Florida,"Salt Lake City, UT",Utah,714,1399,-9,-15,705,1384,14,16,719,1368,451,64,84,94,0,,0,0.0,0.0,0.0,0.0,0.0
2024,12,8,7,2024-12-08,AS,5009,LGA,MIA,"New York, NY",New York,"Miami, FL",Florida,1626,1226,4,0,1630,1226,10,5,1640,1221,2397,296,316,311,0,,0,0.0,0.0,0.0,0.0,0.0
2024,11,5,2,2024-11-05,YX,8584,BWI,IAD,"Baltimore, MD",Maryland,"Washington, DC",District of Columbia,1089,1956,-2,-5,1087,1951,20,15,1107,1936,1657,197,217,232,0,,0,0.0,0.0,0.0,0.0,0.0
2024,5,29,3,2024-05-29,G4,561,DCA,MDW,"Washington, DC",District of Columbia,"Chicago, IL",Illinois,674,2089,9,0,683,2089,18,6,701,2083,1474,185,205,209,0,,0,0.0,0.0,0.0,0.0,0.0
2024,1,16,2,2024-01-16,F9,3333,DTW,IAD,"Detroit, MI",Michigan,"Washington, DC",District of Columbia,551,1023,-5,-5,546,1018,12,3,558,1015,2551,311,331,326,0,,0,0.0,0.0,0.0,0.0,0.0
2024,1,28,7,2024-01-28,UA,5302,EWR,ATL,"Newark, NJ",New Jersey,"Atlanta, GA",Georgia,796,1936,-25,-20,771,1916,10,19,781,1897,252,25,45,54,0,,0,0.0,0.0,0.0,0.0,0.0
2024,6,21,5,2024-06-21,OO,3039,ATL,JFK,"Atlanta, GA",Georgia,"New York, NY",New York,674,1122,-2,5,672,1127,15,9,687,1118,2256,291,311,315,0,,0,0.0,0.0,0.0,0.0,0.0
2024,2,15,4,2024-02-15,AA,188,ATL,TPA,"Atlanta, GA",Georgia,"Tampa, FL",Florida,1468,2047,14,20,1482,2067,8,11,1490,2056,1993,239,259,258,0,,0,6.0,5.0,0.0,0.0,9.0
2024,11,23,6,2024-11-23,DL,1763,PDX,PHX,"Portland, OR",Oregon,"Phoenix, AZ",Arizona,842,2239,0,0,842,2239,12,4,854,2235,1030,132,152,148,0,,0,0.0,0.0,0.0,0.0,0.0
2024,8,23,5,2024-08-23,OO,3401,IAH,DFW,"Houston, TX",Texas,"Dallas/Fort Worth, TX",Texas,2234,774,-4,-5,2230,769,9,14,2239,755,407,40,60,63,0,,0,0.0,0.0,0.0,0.0,0.0
2024,8,1,4,2024-08-01,HA,5237,EWR,DTW,"Newark, NJ",New Jersey,"Detroit, MI",Michigan,1099,1497,15,15,1114,1512,14,3,1128,1509,955,111,131,128,0,,0,0.0,0.0,0.0,0.0,0.0
2024,3,25,1,2024-03-25,DL,6129,PHX,SFO,"Phoenix, AZ",Arizona,"San Francisco, CA",California,670,1586,2,-5,672,1581,26,13,698,1568,2837,359,379,398,0,,0,0.0,0.0,0.0,0.0,0.0
2024,10,8,2,2024-10-08,NK,521,DFW,EWR,"Dallas/Fort Worth, TX",Texas,"Newark, NJ",New Jersey,1560,973,11,15,1571,988,16,18,1587,970,1054,131,151,165,0,,0,0.0,0.0,0.0,0.0,0.0
2024,8,19,1,2024-08-19,YX,3849,MSP,SAN,"Minneapolis, MN",Minnesota,"San Diego, CA",California,2158,1231,0,10,2158,1241,21,17,2179,1224,1299,166,186,204,0,,0,0.0,0.0,0.0,0.0,0.0
2024,3,25,1,2024-03-25,AS,5071,CLT,SEA,"Charlotte, NC",North Carolina,"Seattle, WA",Washington,1724,836,5,0,1729,836,24,18,1753,818,1739,214,234,256,0,,0,0.0,0.0,0.0,0.0,0.0
2024,3,5,2,2024-03-05,OO,6945,LAS,IAD,"Las Vegas, NV",Nevada,"Washington, DC",District of Columbia,1587,1609,12,5,1599,1614,15,16,1614,1598,1176,147,167,178,0,,0,0.0,0.0,0.0,0.0,0.0
2024,5,13,1,2024-05-13,DL,4533,SLC,ORD,"Salt Lake City, UT",Utah,"Chicago, IL",Illinois,2009,1567,6,5,2015,1572,24,3,2039,1569,1059,128,148,155,0,,0,0.0,0.0,0.0,0.0,0.0
2024,5,30,4,2024-05-30,F9,365,PHL,STL,"Philadelphia, PA",Pennsylvania,"St. Louis, MO",Missouri,954,1042,0,0,954,1042,16,9,970,1033,1020,123,143,148,0,,0,0.0,0.0,0.0,0.0,0.0
2024,4,24,3,2024-04-24,HA,2950,DFW,BWI,"Dallas/Fort Worth, TX",Texas,"Baltimore, MD",Maryland,2223,1661,-13,-10,2210,1651,25,10,2235,1641,2557,318,338,353,0,,0,0.0,0.0,0.0,0.0,0.0
2024,3,4,1,2024-03-04,G4,1478,SFO,IAH,"San Francisco, CA",California,"Houston, TX",Texas,1226,1383,-5,5,1221,1388,16,18,1237,1370,2630,336,356,370,0,,0,0.0,0.0,0.0,0.0,0.0
2024,12,8,7,2024-12-08,HA,6603,MSP,EWR,"Minneapolis, MN",Minnesota,"Newark, NJ",New Jersey,1932,1619,-15,-20,1917,1599,21,3,1938,1596,2325,299,319,323,0,,0,0.0,0.0,0.0,0.0,0.0
2024,12,28,6,2024-12-28,NK,7257,DEN,BOS,"Denver, CO",Colorado,"Boston, MA",Massachusetts,1386,1486,-4,5,1382,1491,24,7,1406,1484,1595,192,212,223,1,,0,0.0,0.0,0.0,0.0,0.0
2024,12,17,2,2024-12-17,WN,4516,STL,BOS,"St. Louis, MO",Missouri,"Boston, MA",Massachusetts,1505,1445,-5,0,1500,1445,27,17,1527,1428,733,94,114,138,0,,0,0.0,0.0,0.0,0.0,0.0
2024,6,6,4,2024-06-06,MQ,949,EWR,JFK,"Newark, NJ",New Jersey,"New York, NY",New York,1254,2162,-4,-10,1250,2152,26,5,1276,2147,619,68,88,99,0,,0,0.0,0.0,0.0,0.0,0.0
2024,3,17,7,2024-03-17,MQ,4914,TPA,BOS,"Tampa, FL",Florida,"Boston, MA",Massachusetts,649,1441,16,10,665,1451,9,3,674,1448,720,88,108,100,0,,0,0.0,0.0,0.0,0.0,0.0
2024,5,25,6,2024-05-25,AA,9283,TPA,PHL,"Tampa, FL",Florida,"Philadelphia, PA",Pennsylvania,2025,1234,-14,-5,2011,1229,21,9,2032,1220,1040,121,141,151,0,,0,0.0,0.0,0.0,0.0,0.0
2024,12,8,7,2024-12-08,WN,3864,ATL,MIA,"Atlanta, GA",Georgia,"Miami, FL",Florida,1135,755,8,0,1143,755,28,11,1171,744,1213,157,177,196,0,,0,0.0,0.0,0.0,0.0,0.0
2024,8,12,1,2024-08-12,WN,7479,MDW,ATL,"Chicago, IL",Illinois,"Atlanta, GA",Georgia,1466,1328,-22,-20,1444,1308,9,3,1453,1305,2467,307,327,319,0,,0,0.0,0.0,0.0,0.0,0.0
2024,11,8,5,2024-11-08,F9,3374,LAX,EWR,"Los Angeles, CA",California,"Newark, NJ",New Jersey,1209,1817,-13,-5,1196,1812,17,4,1213,1808,1367,164,184,185,0,,0,0.0,0.0,0.0,0.0,0.0
2024,4,12,5,2024-04-12,WN,816,JFK,MCO,"New York, NY",New York,"Orlando, FL",Florida,2071,1412,-11,-10,2060,1402,18,19,2078,1383,1580,190,210,227,0,,0,0.0,0.0,0.0,0.0,0.0
2024,12,12,4,2024-12-12,WN,5180,SEA,IAD,"Seattle, WA",Washington,"Washington, DC",District of Columbia,777,1784,-16,-10,761,1774,12,19,773,1755,704,96,116,127,0,,0,0.0,0.0,0.0,0.0,0.0
2024,10,27,7,2024-10-27,MQ,995,MIA,LAX,"Miami, FL",Florida,"Los Angeles, CA",California,534,1239,-12,-10,522,1229,18,5,540,1224,1165,141,161,164,0,,0,0.0,0.0,0.0,0.0,0.0
2024,3,28,4,2024-03-28,DL,9468,MCO,DCA,"Orlando, FL",Florida,"Washington, DC",District of Columbia,2148,2313,-17,-20,2131,2293,10,19,2141,2274,2226,276,296,305,0,,0,0.0,0.0,0.0,0.0,0.0
2024,10,29,2,2024-10-29,YX,9751,PDX,TPA,"Portland, OR",Oregon,"Tampa, FL",Florida,674,1749,0,0,674,1749,11,12,685,1737,550,77,97,100,0,,0,0.0,0.0,0.0,0.0,0.0
2024,6,16,7,2024-06-16,9E,2643,LAS,MSP,"Las Vegas, NV",Nevada,"Minneapolis, MN",Minnesota,1556,2309,8,0,1564,2309,14,4,1578,2305,447,47,67,65,0,,0,0.0,0.0,0.0,0.0,0.0
2024,6,18,2,2024-06-18,NK,7871,SFO,DFW,"San Francisco, CA",California,"Dallas/Fort Worth, TX",Texas,2248,2170,5,0,2253,2170,21,9,2274,2161,2254,276,296,306,0,,0,0.0,0.0,0.0,0.0,0.0
2024,5,14,2,2024-05-14,HA,4737,HNL,LGA,"Honolulu, HI",Hawaii,"New York, NY",New York,1214,1862,3,0,1217,1862,10,5,1227,1857,359,38,58,53,0,,0,0.0,0.0,0.0,0.0,0.0
2024,2,19,1,2024-02-19,WN,8166,IAD,LAS,"Washington, DC",District of Columbia,"Las Vegas, NV",Nevada,1920,1664,13,10,1933,1674,7,14,1940,1660,2168,273,293,294,0,,0,0.0,0.0,0.0,0.0,0.0
2024,12,5,4,2024-12-05,OO,3653,STL,LAS,"St. Louis, MO",Missouri,"Las Vegas, NV",Nevada,753,785,-27,-20,726,765,23,9,749,756,1533,193,213,225,0,,0,0.0,0.0,0.0,0.0,0.0
2024,12,12,4,2024-12-12,AS,1449,DFW,IAH,"Dallas/Fort Worth, TX",Texas,"Houston, TX",Texas,1067,1060,-3,0,1064,1060,23,12,1087,1048,1311,154,174,189,0,,0,0.0,0.0,0.0,0.0,0.0
2024,5,13,1,2024-05-13,UA,3086,MSP,ORD,"Minneapolis, MN",Minnesota,"Chicago, IL",Illinois,822,2318,6,10,828,2328,26,6,854,2322,2849,363,383,395,0,,0,0.0,0.0,0.0,0.0,0.0
2024,12,12,4,2024-12-12,NK,7296,HNL,ORD,"Honolulu, HI",Hawaii,"Chicago, IL",Illinois,512,2012,-28,-20,484,1992,28,3,512,1989,936,111,131,142,0,,0,0.0,0.0,0.0,0.0,0.0
2024,5,16,4,2024-05-16,AS,2222,LAS,PDX,"Las Vegas, NV",Nevada,"Portland, OR",Oregon,549,1884,3,0,552,1884,7,16,559,1868,545,71,91,94,0,,0,0.0,0.0,0.0,0.0,0.0
2024,9,1,7,2024-09-01,UA,8789,TPA,SEA,"Tampa, FL",Florida,"Seattle, WA",Washington,2283,2029,0,0,2283,2029,7,6,2290,2023,2202,283,303,296,0,,0,0.0,0.0,0.0,0.0,0.0
2024,4,18,4,2024-04-18,WN,8146,ATL,PHX,"Atlanta, GA",Georgia,"Phoenix, AZ",Arizona,1756,1145,-2,-10,1754,1135,9,14,1763,1121,955,127,147,150,0,,0,0.0,0.0,0.0,0.0,0.0
2024,11,8,5,2024-11-08,9E,9013,PHX,DEN,"Phoenix, AZ",Arizona,"Denver, CO",Colorado,1452,2072,-17,-10,1435,2062,10,3,1445,2059,987,125,145,138,0,,0,0.0,0.0,0.0,0.0,0.0
2024,10,13,7,2024-10-13,OH,1463,SAN,LAS,"San Diego, CA",California,"Las Vegas, NV",Nevada,1493,1298,-2,5,1491,1303,10,16,1501,1287,2669,332,352,358,0,,0,0.0,0.0,0.0,0.0,0.0
2024,1,21,7,2024-01-21,B6,407,PHX,DTW,"Phoenix, AZ",Arizona,"Detroit, MI",Michigan,2063,2024,-3,0,2060,2024,27,6,2087,2018,2615,332,352,365,0,,0,0.0,0.0,0.0,0.0,0.0
2024,3,30,6,2024-03-30,G4,2851,TPA,DFW,"Tampa, FL",Florida,"Dallas/Fort Worth, TX",Texas,1115,906,-1,-5,1114,901,27,9,1141,892,1235,157,177,193,0,,0,0.0,0.0,0.0,0.0,0.0
2024,10,22,2,2024-10-22,OH,9175,CLT,SLC,"Charlotte, NC",North Carolina,"Salt Lake City, UT",Utah,1365,1544,10,5,1375,1549,17,11,1392,1538,669,73,93,101,0,,0,0.0,0.0,0.0,0.0,0.0
2024,4,21,7,2024-04-21,AS,7882,SEA,ORD,"Seattle, WA",Washington,"Chicago, IL",Illinois,595,736,-2,5,593,741,23,16,616,725,830,93,113,132,0,,0,0.0,0.0,0.0,0.0,0.0
2024,10,27,7,2024-10-27,MQ,1364,SLC,DTW,"Salt Lake City, UT",Utah,"Detroit, MI",Michigan,842,1825,-6,-5,836,1820,9,7,845,1813,974,113,133,129,0,,0,0.0,0.0,0.0,0.0,0.0
2024,3,17,7,2024-03-17,WN,5439,LGA,MCO,"New York, NY",New York,"Orlando, FL",Florida,1355,1492,-6,0,1349,1492,5,19,1354,1473,1949,239,259,263,0,,0,0.0,0.0,0.0,0.0,0.0
2024,6,25,2,2024-06-25,OO,7603,PHX,HNL,"Phoenix, AZ",Arizona,"Honolulu, HI",Hawaii,692,1254,-2,5,690,1259,21,8,711,1251,1813,225,245,254,0,,0,0.0,0.0,0.0,0.0,0.0
2024,12,8,7,2024-12-08,OO,5948,SFO,PHL,"San Francisco, CA",California,"Philadelphia, PA",Pennsylvania,1010,1220,-14,-5,996,1215,6,7,1002,1208,468,49,69,62,0,,0,0.0,0.0,0.0,0.0,0.0
2024,5,27,1,2024-05-27,NK,9344,DFW,MCO,"Dallas/Fort Worth, TX",Texas,"Orlando, FL",Florida,1974,756,7,0,1981,756,16,12,1997,744,1115,133,153,161,0,,0,0.0,0.0,0.0,0.0,0.0
2024,4,10,3,2024-04-10,DL,593,CLT,HNL,"Charlotte, NC",North Carolina,"Honolulu, HI",Hawaii,1648,1878,-13,-10,1635,1868,22,19,1657,1849,1551,197,217,238,0,,0,0.0,0.0,0.0,0.0,0.0
2024,9,2,1,2024-09-02,WN,2121,MCO,EWR,"Orlando, FL",Florida,"Newark, NJ",New Jersey,1604,780,-6,-10,1598,770,11,6,1609,764,2613,316,336,333,0,,0,0.0,0.0,0.0,0.0,0.0
2024,4,26,5,2024-04-26,B6,1847,DCA,LAS,"Washington, DC",District of Columbia,"Las Vegas, NV",Nevada,506,1008,-12,-5,494,1003,9,16,503,987,385,56,76,81,0,,0,0.0,0.0,0.0,0.0,0.0
2024,4,1,1,2024-04-01,WN,5187,HNL,SFO,"Honolulu, HI",Hawaii,"San Francisco, CA",California,829,1452,17,15,846,1467,23,16,869,1451,1035,119,139,158,0,,0,0.0,0.0,0.0,0.0,0.0
2024,1,28,7,2024-01-28,WN,3402,STL,PDX,"St. Louis, MO",Missouri,"Portland, OR",Oregon,582,1576,13,10,595,1586,20,6,615,1580,1291,164,184,190,0,,0,0.0,0.0,0.0,0.0,0.0
2024,1,25,4,2024-01-25,OO,7227,BWI,MSP,"Baltimore, MD",Maryland,"Minneapolis, MN",Minnesota,2059,2354,-2,0,2057,2354,27,5,2084,2349,2992,369,389,401,0,,0,0.0,0.0,0.0,0.0,0.0
2024,2,27,2,2024-02-27,MQ,5122,LGA,ATL,"New York, NY",New York,"Atlanta, GA",Georgia,1404,1651,-5,0,1399,1651,16,4,1415,1647,2121,267,287,287,0,,0,0.0,0.0,0.0,0.0,0.0
2024,10,23,3,2024-10-23,G4,6255,SLC,CLT,"Salt Lake City, UT",Utah,"Charlotte, NC",North Carolina,1125,2286,-14,-15,1111,2271,23,19,1134,2252,285,35,55,77,0,,0,0.0,0.0,0.0,0.0,0.0
2024,5,13,1,2024-05-13,OH,9223,BOS,MIA,"Boston, MA",Massachusetts,"Miami, FL",Florida,1026,1470,2,0,1028,1470,23,18,1051,1452,698,85,105,126,0,,0,0.0,0.0,0.0,0.0,0.0
2024,11,26,2,2024-11-26,OO,6509,MCO,LAS,"Orlando, FL",Florida,"Las Vegas, NV",Nevada,1636,1211,-10,-5,1626,1206,24,16,1650,1190,1913,235,255,275,0,,0,0.0,0.0,0.0,0.0,0.0
2024,9,5,4,2024-09-05,MQ,5354,LGA,JFK,"New York, NY",New York,"New York, NY",New York,939,2138,9,0,948,2138,25,18,973,2120,264,29,49,72,0,,0,0.0,0.0,0.0,0.0,0.0
2024,2,7,3,2024-02-07,DL,9048,IAH,BWI,"Houston, TX",Texas,"Baltimore, MD",Maryland,1389,2168,18,10,1407,2178,19,18,1426,2160,1169,146,166,183,0,,0,0.0,0.0,0.0,0.0,0.0
2024,3,15,5,2024-03-15,AS,9346,SLC,SFO,"Salt Lake City, UT",Utah,"San Francisco, CA",California,1261,1822,-11,-20,1250,1802,28,8,1278,1794,614,70,90,106,0,,0,0.0,0.0,0.0,0.0,0.0
2024,5,21,2,2024-05-21,OH,4454,DEN,JFK,"Denver, CO",Colorado,"New York, NY",New York,1523,668,9,0,1532,668,13,8,1545,660,853,106,126,127,0,,0,0.0,0.0,0.0,0.0,0.0
2024,11,17,7,2024-11-17,F9,3553,LAX,IAD,"Los Angeles, CA",California,"Washington, DC",District of Columbia,2180,1201,-3,0,2177,1201,25,8,2202,1193,2555,320,340,353,0,,0,0.0,0.0,0.0,0.0,0.0
2024,6,16,7,2024-06-16,F9,2616,LGA,BWI,"New York, NY",New York,"Baltimore, MD",Maryland,518,616,-16,-10,502,606,12,16,514,590,2906,372,392,400,0,,0,0.0,0.0,0.0,0.0,0.0
2024,9,15,7,2024-09-15,OO,6169,SFO,DCA,"San Francisco, CA",California,"Washington, DC",District of Columbia,508,1448,-3,0,505,1448,23,3,528,1445,565,60,80,86,0,,0,0.0,0.0,0.0,0.0,0.0
2024,12,20,5,2024-12-20,NK,7474,JFK,STL,"New York, NY",New York,"St. Louis, MO",Missouri,1708,1478,2,0,1710,1478,11,3,1721,1475,447,52,72,66,0,,0,0.0,0.0,0.0,0.0,0.0
2024,8,12,1,2024-08-12,9E,8938,MDW,EWR,"Chicago, IL",Illinois,"Newark, NJ",New Jersey,1561,1434,7,5,1568,1439,23,10,1591,1429,2987,363,383,396,0,,0,0.0,0.0,0.0,0.0,0.0
2024,5,31,5,2024-05-31,OO,5308,STL,DCA,"St. Louis, MO",Missouri,"Washington, DC",District of Columbia,1222,1145,-21,-15,1201,1130,16,10,1217,1120,1509,182,202,208,0,,0,0.0,0.0,0.0,0.0,0.0
2024,1,19,5,2024-01-19,WN,294,LGA,DFW,"New York, NY",New York,"Dallas/Fort Worth, TX",Texas,1403,659,-2,-5,1401,654,7,19,1408,635,1701,211,231,237,0,,0,0.0,0.0,0.0,0.0,0.0
2024,5,25,6,2024-05-25,NK,9437,PHX,ORD,"Phoenix, AZ",Arizona,"Chicago, IL",Illinois,633,783,67,60,700,843,8,3,708,840,2333,282,302,293,0,,0,7.0,8.0,5.0,1.0,39.0
2024,8,28,3,2024-08-28,MQ,4391,LAX,SAN,"Los Angeles, CA",California,"San Diego, CA",California,1625,1437,9,5,1634,1442,6,16,1640,1426,2812,341,361,363,0,,0,0.0,0.0,0.0,0.0,0.0
2024,12,9,1,2024-12-09,9E,6310,SAN,MCO,"San Diego, CA",California,"Orlando, FL",Florida,1672,1988,-5,5,1667,1993,11,13,1678,1980,521,58,78,82,0,,0,0.0,0.0,0.0,0.0,0.0
2024,8,24,6,2024-08-24,AS,5230,MIA,LAS,"Miami, FL",Florida,"Las Vegas, NV",Nevada,592,1621,-9,-5,583,1616,26,14,609,1602,494,53,73,93,0,,0,0.0,0.0,0.0,0.0,0.0
2024,2,4,7,2024-02-04,OO,421,IAD,SFO,"Washington, DC",District of Columbia,"San Francisco, CA",California,1301,2057,-16,-15,1285,2042,7,15,1292,2027,736,88,108,110,0,,0,0.0,0.0,0.0,0.0,0.0
2024,7,8,1,2024-07-08,AS,6805,LAX,PHX,"Los Angeles, CA",California,"Phoenix, AZ",Arizona,1663,1822,6,15,1669,1837,5,15,1674,1822,1012,120,140,140,0,,0,0.0,0.0,0.0,0.0,0.0
2024,1,1,1,2024-01-01,DL,1802,TPA,BWI,"Tampa, FL",Florida,"Baltimore, MD",Maryland,1818,1352,-13,-15,1805,1337,16,5,1821,1332,1743,214,234,235,0,,0,0.0,0.0,0.0,0.0,0.0
2024,6,1,6,2024-06-01,F9,930,IAH,MSP,"Houston, TX",Texas,"Minneapolis, MN",Minnesota,1363,1855,37,45,1400,1900,23,5,1423,1895,398,41,61,69,0,,0,3.0,9.0,3.0,1.0,29.0
2024,5,5,7,2024-05-05,F9,8480,TPA,BWI,"Tampa, FL",Florida,"Baltimore, MD",Maryland,1273,1322,-18,-15,1255,1307,24,16,1279,1291,797,107,127,147,0,,0,0.0,0.0,0.0,0.0,0.0
2024,12,10,2,2024-12-10,OH,5706,LAX,ATL,"Los Angeles, CA",California,"Atlanta, GA",Georgia,2116,1991,-9,-10,2107,1981,21,10,2128,1971,932,107,127,138,0,,0,0.0,0.0,0.0,0.0,0.0
2024,8,13,2,2024-08-13,OO,191,MIA,PHL,"Miami, FL",Florida,"Philadelphia, PA",Pennsylvania,1043,2053,-12,-5,1031,2048,28,15,1059,2033,2093,259,279,302,0,,0,0.0,0.0,0.0,0.0,0.0
2024,8,8,4,2024-08-08,NK,3977,SAN,LAS,"San Diego, CA",California,"Las Vegas, NV",Nevada,687,2187,-3,0,684,2187,22,3,706,2184,2494,320,340,345,0,,0,0.0,0.0,0.0,0.0,0.0
2024,7,29,1,2024-07-29,OO,2436,EWR,LAX,"Newark, NJ",New Jersey,"Los Angeles, CA",California,635,1742,-5,5,630,1747,7,14,637,1733,859,114,134,135,0,,0,0.0,0.0,0.0,0.0,0.0
2024,1,25,4,2024-01-25,G4,7776,PHX,SAN,"Phoenix, AZ",Arizona,"San Diego, CA",California,665,929,12,20,677,949,17,7,694,942,1362,166,186,190,0,,0,7.0,4.0,2.0,0.0,7.0
2024,1,16,2,2024-01-16,F9,1680,LAX,DEN,"Los Angeles, CA",California,"Denver, CO",Colorado,2000,1838,-1,-5,1999,1833,9,11,2008,1822,2462,315,335,335,0,,0,0.0,0.0,0.0,0.0,0.0
2024,6,30,7,2024-06-30,OH,9700,JFK,MIA,"New York, NY",New York,"Miami, FL",Florida,1490,1945,-16,-20,1474,1925,29,4,1503,1921,1995,247,267,280,0,,0,0.0,0.0,0.0,0.0,0.0
2024,11,24,7,2024-11-24,G4,8466,SAN,LGA,"San Diego, CA",California,"New York, NY",New York,1670,1772,1,0,1671,1772,26,16,1697,1756,2551,327,347,369,0,,0,0.0,0.0,0.0,0.0,0.0
2024,5,8,3,2024-05-08,HA,5892,CLT,PHX,"Charlotte, NC",North Carolina,"Phoenix, AZ",Arizona,744,2031,-5,5,739,2036,23,6,762,2030,1439,175,195,204,0,,0,0.0,0.0,0.0,0.0,0.0
2024,2,11,7,2024-02-11,G4,7846,MSP,PHL,"Minneapolis, MN",Minnesota,"Philadelphia, PA",Pennsylvania,1706,2311,-5,-5,1701,2306,23,11,1724,2295,516,69,89,103,0,,0,0.0,0.0,0.0,0.0,0.0
2024,12,1,7,2024-12-01,AS,573,SLC,PDX,"Salt Lake City, UT",Utah,"Portland, OR",Oregon,1532,2000,-2,-10,1530,1990,12,19,1542,1971,2402,303,323,334,0,,0,0.0,0.0,0.0,0.0,0.0
2024,8,23,5,2024-08-23,DL,369,SFO,HNL,"San Francisco, CA",California,"Honolulu, HI",Hawaii,1959,1380,-11,-5,1948,1375,24,14,1972,1361,782,95,115,133,0,,0,0.0,0.0,0.0,0.0,0.0
2024,12,25,3,2024-12-25,YX,6650,DCA,JFK,"Washington, DC",District of Columbia,"New York, NY",New York,1679,1943,11,5,1690,1948,20,9,1710,1939,2281,281,301,310,0,,0,0.0,0.0,0.0,0.0,0.0
2024,2,3,6,2024-02-03,NK,793,BOS,LAX,"Boston, MA",Massachusetts,"Los Angeles, CA",California,1329,1628,-9,0,1320,1628,9,10,1329,1618,1737,219,239,238,0,,0,0.0,0.0,0.0,0.0,0.0
2024,12,10,2,2024-12-10,UA,1515,DFW,HNL,"Dallas/Fort Worth, TX",Texas,"Honolulu, HI",Hawaii,1187,1001,7,5,1194,1006,8,3,1202,1003,1118,142,162,153,0,,0,0.0,0.0,0.0,0.0,0.0
2024,2,14,3,2024-02-14,MQ,2183,DFW,PHL,"Dallas/Fort Worth, TX",Texas,"Philadelphia, PA",Pennsylvania,613,1227,-18,-10,595,1217,29,18,624,1199,2103,252,272,299,0,,0,0.0,0.0,0.0,0.0,0.0
2024,5,13,1,2024-05-13,NK,1335,SEA,MSP,"Seattle, WA",Washington,"Minneapolis, MN",Minnesota,2278,802,12,10,2290,812,20,10,2310,802,2027,255,275,285,0,,1,0.0,0.0,0.0,0.0,0.0
2024,1,21,7,2024-01-21,G4,4067,DCA,PHL,"Washington, DC",District of Columbia,"Philadelphia, PA",Pennsylvania,666,1660,-13,-10,653,1650,28,15,681,1635,1470,174,194,217,0,,0,0.0,0.0,0.0,0.0,0.0
2024,5,1,3,2024-05-01,9E,8425,BOS,STL,"Boston, MA",Massachusetts,"St. Louis, MO",Missouri,987,653,-3,-5,984,648,18,15,1002,633,2717,335,355,368,0,,0,0.0,0.0,0.0,0.0,0.0
2024,3,10,7,2024-03-10,OH,4885,MIA,SAN,"Miami, FL",Florida,"San Diego, CA",California,936,887,-8,0,928,887,17,12,945,875,1617,204,224,233,0,,0,0.0,0.0,0.0,0.0,0.0
2024,12,17,2,2024-12-17,9E,6225,CLT,PHL,"Charlotte, NC",North Carolina,"Philadelphia, PA",Pennsylvania,722,1907,3,5,725,1912,27,14,752,1898,689,90,110,131,0,,0,0.0,0.0,0.0,0.0,0.0
2024,12,26,4,2024-12-26,DL,6734,BWI,PHX,"Baltimore, MD",Maryland,"Phoenix, AZ",Arizona,690,2221,-19,-10,671,2211,24,9,695,2202,2474,311,331,344,0,,0,0.0,0.0,0.0,0.0,0.0
2024,2,17,6,2024-02-17,OH,6068,BOS,DEN,"Boston, MA",Massachusetts,"Denver, CO",Colorado,1075,1668,12,15,1087,1683,29,15,1116,1668,2992,382,402,426,0,,0,0.0,0.0,0.0,0.0,0.0
2024,2,8,4,2024-02-08,MQ,940,JFK,DTW,"New York, NY",New York,"Detroit, MI",Michigan,1293,883,-5,5,1288,888,12,10,1300,878,2978,370,390,392,0,,0,0.0,0.0,0.0,0.0,0.0
2024,10,13,7,2024-10-13,AS,5183,MDW,BOS,"Chicago, IL",Illinois,"Boston, MA",Massachusetts,672,1432,-6,-10,666,1422,28,8,694,1414,2694,335,355,371,0,,0,0.0,0.0,0.0,0.0,0.0
2024,1,10,3,2024-01-10,MQ,1561,SFO,LGA,"San Francisco, CA",California,"New York, NY",New York,1780,1181,2,5,1782,1186,22,11,1804,1175,654,84,104,117,0,,0,0.0,0.0,0.0,0.0,0.0
2024,1,30,2,2024-01-30,AS,5034,STL,PHX,"St. Louis, MO",Missouri,"Phoenix, AZ",Arizona,2238,641,2,5,2240,646,9,15,2249,631,2042,254,274,278,0,,0,0.0,0.0,0.0,0.0,0.0
2024,8,31,6,2024-08-31,G4,3572,MDW,IAD,"Chicago, IL",Illinois,"Washington, DC",District of Columbia,949,2040,1,5,950,2045,10,11,960,2034,604,67,87,88,0,,0,0.0,0.0,0.0,0.0,0.0
2024,9,30,1,2024-09-30,MQ,7263,PHX,SAN,"Phoenix, AZ",Arizona,"San Diego, CA",California,2024,871,24,15,2048,886,10,13,2058,873,2114,270,290,293,0,,0,0.0,0.0,0.0,0.0,0.0
2024,3,28,4,2024-03-28,G4,6675,SFO,PHL,"San Francisco, CA",California,"Philadelphia, PA",Pennsylvania,576,1764,7,5,583,1769,29,10,612,1759,911,112,132,151,1,,0,0.0,0.0,0.0,0.0,0.0
2024,8,31,6,2024-08-31,HA,4943,MSP,DCA,"Minneapolis, MN",Minnesota,"Washington, DC",District of Columbia,1114,1516,-9,-5,1105,1511,24,4,1129,1507,697,87,107,115,0,,0,0.0,0.0,0.0,0.0,0.0
2024,11,24,7,2024-11-24,MQ,7839,ORD,BWI,"Chicago, IL",Illinois,"Baltimore, MD",Maryland,725,1170,1,5,726,1175,27,19,753,1156,1195,157,177,203,0,,0,0.0,0.0,0.0,0.0,0.0
2024,1,15,1,2024-01-15,B6,2609,LGA,SEA,"New York, NY",New York,"Seattle, WA",Washington,1749,1351,5,5,1754,1356,29,12,1783,1344,791,105,125,146,0,,0,0.0,0.0,0.0,0.0,0.0
2024,1,4,4,2024-01-04,OH,9257,LAX,CLT,"Los Angeles, CA",California,"Charlotte, NC",North Carolina,1238,646,-9,0,1229,646,25,17,1254,629,601,65,85,107,0,,0,0.0,0.0,0.0,0.0,0.0
2024,7,9,2,2024-07-09,B6,6122,MIA,IAH,"Miami, FL",Florida,"Houston, TX",Texas,2131,1790,-5,-5,2126,1785,26,3,2152,1782,2477,318,338,347,0,,0,0.0,0.0,0.0,0.0,0.0
2024,6,16,7,2024-06-16,G4,2138,MIA,STL,"Miami, FL",Florida,"St. Louis, MO",Missouri,1440,2245,23,15,1463,2260,21,4,1484,2256,478,67,87,92,0,,0,0.0,0.0,0.0,0.0,0.0
2024,1,9,2,2024-01-09,F9,1950,PHL,BOS,"Philadelphia, PA",Pennsylvania,"Boston, MA",Massachusetts,575,725,-10,0,565,725,27,9,592,716,1068,138,158,174,0,,0,0.0,0.0,0.0,0.0,0.0
2024,4,18,4,2024-04-18,NK,7532,STL,ATL,"St. Louis, MO",Missouri,"Atlanta, GA",Georgia,1556,1071,6,0,1562,1071,20,7,1582,1064,1338,166,186,193,0,,0,0.0,0.0,0.0,0.0,0.0
2024,5,16,4,2024-05-16,F9,9026,MDW,HNL,"Chicago, IL",Illinois,"Honolulu, HI",Hawaii,2117,1410,-15,-5,2102,1405,9,15,2111,1390,2652,323,343,347,0,,0,0.0,0.0,0.0,0.0,0.0
2024,6,2,7,2024-06-02,AS,2553,SAN,ORD,"San Diego, CA",California,"Chicago, IL",Illinois,568,1220,7,5,575,1225,24,7,599,1218,948,121,141,152,0,,0,0.0,0.0,0.0,0.0,0.0
2024,7,27,6,2024-07-27,UA,3116,LGA,TPA,"New York, NY",New York,"Tampa, FL",Florida,914,1276,-10,-5,904,1271,7,13,911,1258,1757,222,242,242,0,,0,0.0,0.0,0.0,0.0,0.0
2024,9,28,6,2024-09-28,NK,6725,JFK,SAN,"New York, NY",New York,"San Diego, CA",California,1230,969,4,10,1234,979,5,12,1239,967,1364,171,191,188,0,,0,0.0,0.0,0.0,0.0,0.0
2024,5,22,3,2024-05-22,F9,7504,SAN,TPA,"San Diego, CA",California,"Tampa, FL",Florida,1971,1370,-24,-15,1947,1355,9,14,1956,1341,1963,238,258,261,0,,0,0.0,0.0,0.0,0.0,0.0
2024,4,8,1,2024-04-08,HA,4103,IAH,DFW,"Houston, TX",Texas,"Dallas/Fort Worth, TX",Texas,861,1187,4,5,865,1192,7,4,872,1188,1554,187,207,198,0,,0,0.0,0.0,0.0,0.0,0.0
2024,11,3,7,2024-11-03,F9,2413,DCA,LGA,"Washington, DC",District of Columbia,"New York, NY",New York,1369,606,8,0,1377,606,28,14,1405,592,269,26,46,68,0,,0,0.0,0.0,0.0,0.0,0.0
2024,3,9,6,2024-03-09,AA,4723,SEA,CLT,"Seattle, WA",Washington,"Charlotte, NC",North Carolina,1893,1297,1,5,1894,1302,20,9,1914,1293,272,24,44,53,0,,0,0.0,0.0,0.0,0.0,0.0
2024,9,3,2,2024-09-03,NK,3263,MCO,SAN,"Orlando, FL",Florida,"San Diego, CA",California,1922,1899,4,0,1926,1899,20,4,1946,1895,1627,208,228,232,0,,0,0.0,0.0,0.0,0.0,0.0
2024,9,17,2,2024-09-17,UA,7286,DFW,BOS,"Dallas/Fort Worth, TX",Texas,"Boston, MA",Massachusetts,1643,2214,-15,-15,1628,2199,8,15,1636,2184,2692,339,359,362,0,,0,0.0,0.0,0.0,0.0,0.0
2024,10,2,3,2024-10-02,DL,7115,PHX,BWI,"Phoenix, AZ",Arizona,"Baltimore, MD",Maryland,1571,664,-5,0,1566,664,7,7,1573,657,1989,246,266,260,0,,0,0.0,0.0,0.0,0.0,0.0
2024,3,19,2,2024-03-19,OH,7882,PHL,TPA,"Philadelphia, PA",Pennsylvania,"Tampa, FL",Florida,567,2250,14,20,581,2270,16,18,597,2252,2399,301,321,335,0,,0,2.0,1.0,3.0,0.0,14.0
2024,5,25,6,2024-05-25,DL,5314,PHL,STL,"Philadelphia, PA",Pennsylvania,"St. Louis, MO",Missouri,1862,801,-2,5,1860,806,21,4,1881,802,659,73,93,98,0,,0,0.0,0.0,0.0,0.0,0.0
2024,4,20,6,2024-04-20,OH,8721,SAN,MIA,"San Diego, CA",California,"Miami, FL",Florida,1608,741,-10,-5,1598,736,16,14,1614,722,1137,144,164,174,0,,0,0.0,0.0,0.0,0.0,0.0
2024,9,14,6,2024-09-14,HA,7038,IAD,PHL,"Washington, DC",District of Columbia,"Philadelphia, PA",Pennsylvania,1435,1721,11,15,1446,1736,14,3,1460,1733,2538,313,333,330,0,,0,0.0,0.0,0.0,0.0,0.0
2024,4,2,2,2024-04-02,OH,3088,ATL,LAS,"Atlanta, GA",Georgia,"Las Vegas, NV",Nevada,876,1416,6,5,882,1421,6,11,888,1410,2926,368,388,385,0,,0,0.0,0.0,0.0,0.0,0.0
2024,1,13,6,2024-01-13,F9,5256,DTW,BWI,"Detroit, MI",Michigan,"Baltimore, MD",Maryland,1908,816,-2,-5,1906,811,14,4,1920,807,800,108,128,126,0,,0,0.0,0.0,0.0,0.0,0.0
2024,9,16,1,2024-09-16,G4,5612,DFW,BOS,"Dallas/Fort Worth, TX",Texas,"Boston, MA",Massachusetts,775,1590,-9,0,766,1590,6,4,772,1586,418,47,67,57,0,,0,0.0,0.0,0.0,0.0,0.0
2024,4,18,4,2024-04-18,UA,9888,TPA,SAN,"Tampa, FL",Florida,"San Diego, CA",California,1267,2209,4,-5,1271,2204,21,16,1292,2188,1905,241,261,278,0,,0,0.0,0.0,0.0,0.0,0.0
2024,11,25,1,2024-11-25,OH,2450,JFK,IAH,"New York, NY",New York,"Houston, TX",Texas,1449,1916,-23,-15,1426,1901,28,19,1454,1882,979,123,143,170,0,,0,0.0,0.0,0.0,0.0,0.0
2024,7,7,7,2024-07-07,UA,4088,JFK,ORD,"New York, NY",New York,"Chicago, IL",Illinois,704,2131,4,10,708,2141,9,7,717,2134,456,60,80,76,0,,0,0.0,0.0,0.0,0.0,0.0
2024,4,4,4,2024-04-04,AS,2970,ORD,DCA,"Chicago, IL",Illinois,"Washington, DC",District of Columbia,1244,1757,-11,-10,1233,1747,6,10,1239,1737,1428,177,197,193,0,,0,0.0,0.0,0.0,0.0,0.0
2024,4,14,7,2024-04-14,OO,6587,DEN,LGA,"Denver, CO",Colorado,"New York, NY",New York,1588,861,-4,0,1584,861,28,15,1612,846,1902,242,262,285,0,,0,0.0,0.0,0.0,0.0,0.0
2024,1,8,1,2024-01-08,9E,3010,ATL,SAN,"Atlanta, GA",Georgia,"San Diego, CA",California,1410,883,3,5,1413,888,18,3,1431,885,2543,321,341,342,0,,0,0.0,0.0,0.0,0.0,0.0
2024,3,7,4,2024-03-07,AA,4713,CLT,DCA,"Charlotte, NC",North Carolina,"Washington, DC",District of Columbia,1602,701,22,15,1624,716,14,5,1638,711,845,98,118,117,0,,0,0.0,0.0,0.0,0.0,0.0
2024,7,9,2,2024-07-09,AS,2964,MDW,SAN,"Chicago, IL",Illinois,"San Diego, CA",California,2049,976,-20,-15,2029,961,19,16,2048,945,2404,297,317,332,0,,0,0.0,0.0,0.0,0.0,0.0
2024,9,12,4,2024-09-12,YX,1117,HNL,DEN,"Honolulu, HI",Hawaii,"Denver, CO",Colorado,824,805,-6,-5,818,800,9,7,827,793,630,73,93,89,0,,0,0.0,0.0,0.0,0.0,0.0
2024,1,9,2,2024-01-09,UA,4790,LAX,STL,"Los Angeles, CA",California,"St. Louis, MO",Missouri,877,2276,1,0,878,2276,18,12,896,2264,1913,239,259,269,0,,0,0.0,0.0,0.0,0.0,0.0
2024,4,26,5,2024-04-26,OO,9624,LAX,DFW,"Los Angeles, CA",California,"Dallas/Fort Worth, TX",Texas,1316,1636,-4,5,1312,1641,25,6,1337,1635,2827,350,370,381,0,,0,0.0,0.0,0.0,0.0,0.0
2024,9,23,1,2024-09-23,WN,8473,MCO,ORD,"Orlando, FL",Florida,"Chicago, IL",Illinois,1180,1360,5,15,1185,1375,22,14,1207,1361,1758,220,240,256,0,,0,0.0,0.0,0.0,0.0,0.0
2024,4,8,1,2024-04-08,G4,6859,SFO,MDW,"San Francisco, CA",California,"Chicago, IL",Illinois,1170,1746,-27,-20,1143,1726,28,6,1171,1720,812,106,126,140,0,,0,0.0,0.0,0.0,0.0,0.0
2024,10,24,4,2024-10-24,UA,2551,PHL,DEN,"Philadelphia, PA",Pennsylvania,"Denver, CO",Colorado,1127,609,4,0,1131,609,17,13,1148,596,2761,338,358,368,0,,0,0.0,0.0,0.0,0.0,0.0
2024,6,12,3,2024-06-12,AA,2052,EWR,LGA,"Newark, NJ",New Jersey,"New York, NY",New York,1869,2215,-29,-20,1840,2195,17,9,1857,2186,459,56,76,82,0,,0,0.0,0.0,0.0,0.0,0.0
2024,5,20,1,2024-05-20,UA,4800,EWR,MIA,"Newark, NJ",New Jersey,"Miami, FL",Florida,1517,1790,-3,5,1514,1795,7,7,1521,1788,1884,226,246,240,0,,0,0.0,0.0,0.0,0.0,0.0
2024,9,24,2,2024-09-24,NK,8554,TPA,MCO,"Tampa, FL",Florida,"Orlando, FL",Florida,2227,2234,-9,-15,2218,2219,8,6,2226,2213,1761,225,245,239,0,,0,0.0,0.0,0.0,0.0,0.0
2024,2,6,2,2024-02-06,MQ,6313,HNL,PDX,"Honolulu, HI",Hawaii,"Portland, OR",Oregon,934,2342,1,10,935,2352,9,17,944,2335,2920,358,378,384,0,,0,0.0,0.0,0.0,0.0,0.0
2024,3,14,4,2024-03-14,NK,760,IAD,IAH,"Washington, DC",District of Columbia,"Houston, TX",Texas,2218,750,-8,-10,2210,740,14,19,2224,721,2195,281,301,314,0,,0,0.0,0.0,0.0,0.0,0.0
2024,3,13,3,2024-03-13,OO,1415,TPA,PHL,"Tampa, FL",Florida,"Philadelphia, PA",Pennsylvania,1384,1660,2,5,1386,1665,29,18,1415,1647,2765,347,367,394,0,,0,0.0,0.0,0.0,0.0,0.0
2024,11,3,7,2024-11-03,B6,7481,ATL,MCO,"Atlanta, GA",Georgia,"Orlando, FL",Florida,1901,1375,-1,-10,1900,1365,6,18,1906,1347,795,107,127,131,0,,0,0.0,0.0,0.0,0.0,0.0
2024,7,17,3,2024-07-17,OH,3019,DTW,LAX,"Detroit, MI",Michigan,"Los Angeles, CA",California,2266,2097,8,0,2274,2097,28,12,2302,2085,2702,339,359,379,0,,0,0.0,0.0,0.0,0.0,0.0
2024,5,9,4,2024-05-09,AA,2172,BWI,EWR,"Baltimore, MD",Maryland,"Newark, NJ",New Jersey,2203,2067,-1,0,2202,2067,25,18,2227,2049,485,68,88,111,0,,0,0.0,0.0,0.0,0.0,0.0
2024,9,2,1,2024-09-02,OO,5542,IAH,LAS,"Houston, TX",Texas,"Las Vegas, NV",Nevada,1538,1965,-14,-10,1524,1955,13,16,1537,1939,306,36,56,65,0,,0,0.0,0.0,0.0,0.0,0.0
2024,11,7,4,2024-11-07,F9,2119,DFW,SLC,"Dallas/Fort Worth, TX",Texas,"Salt Lake City, UT",Utah,1977,1628,-17,-10,1960,1618,13,17,1973,1601,944,111,131,141,0,,0,0.0,0.0,0.0,0.0,0.0
2024,2,29,4,2024-02-29,9E,6725,DTW,HNL,"Detroit, MI",Michigan,"Honolulu, HI",Hawaii,1716,1489,-8,-15,1708,1474,14,12,1722,1462,2136,260,280,286,0,,0,0.0,0.0,0.0,0.0,0.0
2024,10,5,6,2024-10-05,F9,915,TPA,LAX,"Tampa, FL",Florida,"Los Angeles, CA",California,1756,1849,-28,-20,1728,1829,16,4,1744,1825,1586,188,208,208,0,,0,0.0,0.0,0.0,0.0,0.0
2024,4,12,5,2024-04-12,9E,4877,SEA,SFO,"Seattle, WA",Washington,"San Francisco, CA",California,1786,2162,-6,-10,1780,2152,19,3,1799,2149,1895,226,246,248,0,,0,0.0,0.0,0.0,0.0,0.0
2024,10,22,2,2024-10-22,YX,4834,MDW,BWI,"Chicago, IL",Illinois,"Baltimore, MD",Maryland,945,1747,9,0,954,1747,7,11,961,1736,1527,194,214,212,0,,0,0.0,0.0,0.0,0.0,0.0
2024,11,15,5,2024-11-15,9E,3729,MDW,HNL,"Chicago, IL",Illinois,"Honolulu, HI",Hawaii,553,1002,11,5,564,1007,13,4,577,1003,1482,186,206,203,0,,0,0.0,0.0,0.0,0.0,0.0
2024,12,6,5,2024-12-06,MQ,2853,MDW,MSP,"Chicago, IL",Illinois,"Minneapolis, MN",Minnesota,1191,1538,2,5,1193,1543,11,9,1204,1534,1011,126,146,146,0,,0,0.0,0.0,0.0,0.0,0.0
2024,5,30,4,2024-05-30,9E,6605,MDW,SFO,"Chicago, IL",Illinois,"San Francisco, CA",California,503,1410,-11,-15,492,1395,29,11,521,1384,1017,125,145,165,0,,0,0.0,0.0,0.0,0.0,0.0
2024,6,5,3,2024-06-05,DL,4785,JFK,LAX,"New York, NY",New York,"Los Angeles, CA",California,756,1658,-8,-10,748,1648,27,15,775,1633,2475,311,331,353,0,,0,0.0,0.0,0.0,0.0,0.0
2024,7,24,3,2024-07-24,9E,301,SFO,IAD,"San Francisco, CA",California,"Washington, DC",District of Columbia,1884,1860,8,5,1892,1865,20,14,1912,1851,503,68,88,102,0,,0,0.0,0.0,0.0,0.0,0.0
2024,6,27,4,2024-06-27,UA,1104,HNL,LGA,"Honolulu, HI",Hawaii,"New York, NY",New York,1333,2091,-7,0,1326,2091,28,8,1354,2083,1557,201,221,237,1,,0,0.0,0.0,0.0,0.0,0.0
2024,7,15,1,2024-07-15,WN,1412,MIA,DEN,"Miami, FL",Florida,"Denver, CO",Colorado,1763,1098,-10,-10,1753,1088,8,9,1761,1079,455,58,78,75,0,,0,0.0,0.0,0.0,0.0,0.0
2024,8,10,6,2024-08-10,AA,2125,TPA,IAD,"Tampa, FL",Florida,"Washington, DC",District of Columbia,981,1111,-13,-5,968,1106,18,17,986,1089,1369,162,182,197,0,,0,0.0,0.0,0.0,0.0,0.0
2024,3,29,5,2024-03-29,WN,3233,MSP,DCA,"Minneapolis, MN",Minnesota,"Washington, DC",District of Columbia,2198,916,-2,-10,2196,906,9,8,2205,898,232,22,42,39,0,,0,0.0,0.0,0.0,0.0,0.0
2024,10,13,7,2024-10-13,B6,4321,TPA,IAD,"Tampa, FL",Florida,"Washington, DC",District of Columbia,960,902,-13,-15,947,887,20,19,967,868,519,63,83,102,0,,0,0.0,0.0,0.0,0.0,0.0
2024,10,2,3,2024-10-02,UA,6292,DEN,SEA,"Denver, CO",Colorado,"Seattle, WA",Washington,1348,1725,-2,5,1346,1730,26,7,1372,1723,711,95,115,128,0,,0,0.0,0.0,0.0,0.0,0.0
2024,8,23,5,2024-08-23,OH,3771,JFK,ORD,"New York, NY",New York,"Chicago, IL",Illinois,1661,2212,-8,-10,1653,2202,24,12,1677,2190,2431,306,326,342,0,,0,0.0,0.0,0.0,0.0,0.0
2024,7,1,1,2024-07-01,OO,5041,LAS,SFO,"Las Vegas, NV",Nevada,"San Francisco, CA",California,1974,1935,19,15,1993,1950,18,17,2011,1933,2681,340,360,375,0,,0,0.0,0.0,0.0,0.0,0.0
2024,7,27,6,2024-07-27,HA,1704,MIA,DTW,"Miami, FL",Florida,"Detroit, MI",Michigan,1847,681,5,10,1852,691,17,7,1869,684,2840,363,383,387,0,,0,0.0,0.0,0.0,0.0,0.0
2024,5,9,4,2024-05-09,9E,2002,MSP,MCO,"Minneapolis, MN",Minnesota,"Orlando, FL",Florida,972,1257,12,5,984,1262,28,8,1012,1254,2866,349,369,385,0,,0,0.0,0.0,0.0,0.0,0.0
2024,6,1,6,2024-06-01,DL,4688,MSP,DTW,"Minneapolis, MN",Minnesota,"Detroit, MI",Michigan,2264,792,-8,-5,2256,787,18,13,2274,774,611,74,94,105,0,,0,0.0,0.0,0.0,0.0,0.0
2024,1,13,6,2024-01-13,MQ,8260,DFW,IAH,"Dallas/Fort Worth, TX",Texas,"Houston, TX",Texas,2137,823,-12,-10,2125,813,9,5,2134,808,2313,280,300,294,0,,0,0.0,0.0,0.0,0.0,0.0
2024,5,1,3,2024-05-01,AS,2449,MDW,MSP,"Chicago, IL",Illinois,"Minneapolis, MN",Minnesota,2000,652,9,0,2009,652,23,6,2032,646,1324,174,194,203,0,,0,0.0,0.0,0.0,0.0,0.0
2024,12,24,2,2024-12-24,F9,5159,DCA,EWR,"Washington, DC",District of Columbia,"Newark, NJ",New Jersey,692,1614,-14,-5,678,1609,21,5,699,1604,295,33,53,59,0,,0,0.0,0.0,0.0,0.0,0.0
2024,8,7,3,2024-08-07,NK,8028,IAD,LAX,"Washington, DC",District of Columbia,"Los Angeles, CA",California,806,944,14,15,820,959,5,3,825,956,1638,213,233,221,0,,0,0.0,0.0,0.0,0.0,0.0
2024,4,15,1,2024-04-15,OO,7220,MCO,PDX,"Orlando, FL",Florida,"Portland, OR",Oregon,2065,1708,-24,-15,2041,1693,28,19,2069,1674,2621,333,353,380,0,,0,0.0,0.0,0.0,0.0,0.0
2024,3,10,7,2024-03-10,OH,4464,IAH,MSP,"Houston, TX",Texas,"Minneapolis, MN",Minnesota,1258,1586,3,5,1261,1591,23,16,1284,1575,1578,198,218,237,0,,0,0.0,0.0,0.0,0.0,0.0
2024,7,13,6,2024-07-13,AA,4819,LAS,IAH,"Las Vegas, NV",Nevada,"Houston, TX",Texas,1405,1240,-2,0,1403,1240,15,7,1418,1233,551,64,84,86,0,,0,0.0,0.0,0.0,0.0,0.0
2024,7,4,4,2024-07-04,WN,6343,MDW,JFK,"Chicago, IL",Illinois,"New York, NY",New York,720,810,12,10,732,820,14,16,746,804,978,120,140,150,0,,0,0.0,0.0,0.0,0.0,0.0
2024,4,8,1,2024-04-08,UA,8181,TPA,PDX,"Tampa, FL",Florida,"Portland, OR",Oregon,671,1463,-1,0,670,1463,8,6,678,1457,2620,329,349,343,0,,0,0.0,0.0,0.0,0.0,0.0
2024,3,22,5,2024-03-22,AS,9110,DTW,PHL,"Detroit, MI",Michigan,"Philadelphia, PA",Pennsylvania,1683,1375,-4,0,1679,1375,27,8,1706,1367,734,96,116,131,0,,0,0.0,0.0,0.0,0.0,0.0
2024,3,15,5,2024-03-15,G4,2777,MIA,IAD,"Miami, FL",Florida,"Washington, DC",District of Columbia,671,1514,22,20,693,1534,21,11,714,1523,886,114,134,146,0,,0,3.0,1.0,3.0,0.0,13.0
2024,12,5,4,2024-12-05,G4,647,DEN,ORD,"Denver, CO",Colorado,"Chicago, IL",Illinois,1586,782,-21,-15,1565,767,26,16,1591,751,259,23,43,65,1,,0,0.0,0.0,0.0,0.0,0.0
2024,7,10,3,2024-07-10,NK,8650,DEN,MCO,"Denver, CO",Colorado,"Orlando, FL",Florida,2096,1895,-14,-15,2082,1880,21,12,2103,1868,2654,335,355,368,0,,0,0.0,0.0,0.0,0.0,0.0
2024,11,20,3,2024-11-20,HA,3461,LAX,MIA,"Los Angeles, CA",California,"Miami, FL",Florida,1588,1105,-7,-5,1581,1100,20,15,1601,1085,1070,134,154,169,0,,0,0.0,0.0,0.0,0.0,0.0
2024,8,1,4,2024-08-01,YX,2024,IAH,MIA,"Houston, TX",Texas,"Miami, FL",Florida,1692,1850,-2,0,1690,1850,23,16,1713,1834,2367,296,316,335,0,,0,0.0,0.0,0.0,0.0,0.0
2024,11,10,7,2024-11-10,G4,5343,CLT,SEA,"Charlotte, NC",North Carolina,"Seattle, WA",Washington,580,611,-3,-10,577,601,24,6,601,595,2154,269,289,299,0,,0,0.0,0.0,0.0,0.0,0.0
2024,11,13,3,2024-11-13,F9,4747,DTW,SLC,"Detroit, MI",Michigan,"Salt Lake City, UT",Utah,1258,692,-18,-15,1240,677,18,9,1258,668,664,81,101,108,0,,0,0.0,0.0,0.0,0.0,0.0
2024,5,23,4,2024-05-23,B6,6781,PHX,HNL,"Phoenix, AZ",Arizona,"Honolulu, HI",Hawaii,1791,929,-13,-20,1778,909,27,12,1805,897,1787,215,235,254,0,,0,0.0,0.0,0.0,0.0,0.0
2024,8,3,6,2024-08-03,G4,2801,MCO,SLC,"Orlando, FL",Florida,"Salt Lake City, UT",Utah,1903,789,4,5,1907,794,20,13,1927,781,1016,118,138,151,0,,0,0.0,0.0,0.0,0.0,0.0
2024,12,26,4,2024-12-26,OH,521,CLT,IAH,"Charlotte, NC",North Carolina,"Houston, TX",Texas,2293,2221,-10,0,2283,2221,6,9,2289,2212,2715,348,368,363,0,,0,0.0,0.0,0.0,0.0,0.0
2024,11,19,2,2024-11-19,NK,435,IAH,DTW,"Houston, TX",Texas,"Detroit, MI",Michigan,572,1465,9,10,581,1475,12,14,593,1461,1586,191,211,217,0,,0,0.0,0.0,0.0,0.0,0.0
2024,1,15,1,2024-01-15,B6,9818,BOS,DTW,"Boston, MA",Massachusetts,"Detroit, MI",Michigan,831,1553,-11,-5,820,1548,10,10,830,1538,1255,161,181,181,0,,0,0.0,0.0,0.0,0.0,0.0
2024,8,4,7,2024-08-04,HA,156,JFK,HNL,"New York, NY",New York,"Honolulu, HI",Hawaii,1711,1621,12,5,1723,1626,14,18,1737,1608,1983,251,271,283,0,,0,0.0,0.0,0.0,0.0,0.0
2024,2,4,7,2024-02-04,F9,4050,DCA,HNL,"Washington, DC",District of Columbia,"Honolulu, HI",Hawaii,1548,892,8,0,1556,892,6,17,1562,875,365,49,69,72,0,,0,0.0,0.0,0.0,0.0,0.0
2024,7,1,1,2024-07-01,HA,7155,LAX,STL,"Los Angeles, CA",California,"St. Louis, MO",Missouri,727,860,2,0,729,860,23,3,752,857,2293,286,306,312,0,,0,0.0,0.0,0.0,0.0,0.0
2024,9,26,4,2024-09-26,NK,3247,JFK,DTW,"New York, NY",New York,"Detroit, MI",Michigan,1641,1309,-10,-5,1631,1304,8,17,1639,1287,652,80,100,105,0,,0,0.0,0.0,0.0,0.0,0.0
2024,12,23,1,2024-12-23,G4,3637,TPA,PHX,"Tampa, FL",Florida,"Phoenix, AZ",Arizona,1968,922,-9,-15,1959,907,10,12,1969,895,2070,252,272,274,0,,0,0.0,0.0,0.0,0.0,0.0
2024,4,9,2,2024-04-09,9E,6528,ATL,LGA,"Atlanta, GA",Georgia,"New York, NY",New York,1631,609,18,15,1649,624,17,11,1666,613,1797,230,250,258,0,,0,0.0,0.0,0.0,0.0,0.0
2024,1,7,7,2024-01-07,AA,821,ORD,JFK,"Chicago, IL",Illinois,"New York, NY",New York,741,1564,5,10,746,1574,5,17,751,1557,871,112,132,134,0,,0,0.0,0.0,0.0,0.0,0.0
2024,1,30,2,2024-01-30,HA,485,TPA,SEA,"Tampa, FL",Florida,"Seattle, WA",Washington,2134,687,0,-5,2134,682,9,19,2143,663,297,36,56,64,0,,0,0.0,0.0,0.0,0.0,0.0
2024,10,31,4,2024-10-31,MQ,2917,CLT,MSP,"Charlotte, NC",North Carolina,"Minneapolis, MN",Minnesota,2057,939,18,20,2075,959,28,18,2103,941,225,32,52,78,0,,0,2.0,2.0,0.0,0.0,16.0
2024,5,23,4,2024-05-23,G4,7526,PHX,HNL,"Phoenix, AZ",Arizona,"Honolulu, HI",Hawaii,2004,1941,-12,-5,1992,1936,11,12,2003,1924,2646,330,350,353,0,,0,0.0,0.0,0.0,0.0,0.0
2024,4,20,6,2024-04-20,HA,7215,TPA,LAS,"Tampa, FL",Florida,"Las Vegas, NV",Nevada,1002,2172,2,-5,1004,2167,18,18,1022,2149,1040,136,156,172,0,,0,0.0,0.0,0.0,0.0,0.0
2024,8,19,1,2024-08-19,NK,359,PDX,STL,"Portland, OR",Oregon,"St. Louis, MO",Missouri,2021,1846,-1,5,2020,1851,23,7,2043,1844,1065,134,154,164,0,,0,0.0,0.0,0.0,0.0,0.0
2024,6,27,4,2024-06-27,AA,4588,IAD,SFO,"Washington, DC",District of Columbia,"San Francisco, CA",California,1579,1286,-15,-5,1564,1281,15,3,1579,1278,906,112,132,130,0,,0,0.0,0.0,0.0,0.0,0.0
2024,3,12,2,2024-03-12,AA,8891,LGA,DEN,"New York, NY",New York,"Denver, CO",Colorado,1672,808,-1,-5,1671,803,22,6,1693,797,2405,305,325,333,0,,0,0.0,0.0,0.0,0.0,0.0
2024,7,28,7,2024-07-28,B6,7636,PHL,DTW,"Philadelphia, PA",Pennsylvania,"Detroit, MI",Michigan,1834,1672,-4,-5,1830,1667,22,10,1852,1657,1356,169,189,201,0,,0,0.0,0.0,0.0,0.0,0.0
2024,8,7,3,2024-08-07,F9,3355,MIA,TPA,"Miami, FL",Florida,"Tampa, FL",Florida,1051,2159,3,0,1054,2159,25,4,1079,2155,927,109,129,138,0,,0,0.0,0.0,0.0,0.0,0.0
2024,3,20,3,2024-03-20,G4,9331,JFK,MIA,"New York, NY",New York,"Miami, FL",Florida,2185,1521,-14,-15,2171,1506,28,4,2199,1502,379,50,70,82,0,,0,0.0,0.0,0.0,0.0,0.0
2024,3,23,6,2024-03-23,YX,4148,PDX,TPA,"Portland, OR",Oregon,"Tampa, FL",Florida,1423,2241,-18,-20,1405,2221,10,10,1415,2211,2263,281,301,301,0,,0,0.0,0.0,0.0,0.0,0.0
2024,2,11,7,2024-02-11,AS,9047,MSP,PHX,"Minneapolis, MN",Minnesota,"Phoenix, AZ",Arizona,620,862,7,15,627,877,10,14,637,863,2893,367,387,391,0,,0,0.0,0.0,0.0,0.0,0.0
2024,9,29,7,2024-09-29,YX,3257,IAH,MIA,"Houston, TX",Texas,"Miami, FL",Florida,2295,1829,-2,-5,2293,1824,11,15,2304,1809,1715,216,236,242,0,,0,0.0,0.0,0.0,0.0,0.0
2024,7,9,2,2024-07-09,MQ,576,DEN,HNL,"Denver, CO",Colorado,"Honolulu, HI",Hawaii,525,2304,-19,-15,506,2289,21,7,527,2282,511,71,91,99,0,,0,0.0,0.0,0.0,0.0,0.0
2024,6,21,5,2024-06-21,9E,5383,MIA,STL,"Miami, FL",Florida,"St. Louis, MO",Missouri,1635,2120,-3,5,1632,2125,23,5,1655,2120,2945,375,395,403,0,,0,0.0,0.0,0.0,0.0,0.0
2024,1,7,7,2024-01-07,YX,9891,CLT,MSP,"Charlotte, NC",North Carolina,"Minneapolis, MN",Minnesota,1010,1269,-12,-10,998,1259,9,9,1007,1250,381,54,74,72,0,,0,0.0,0.0,0.0,0.0,0.0
2024,6,3,1,2024-06-03,F9,2459,MSP,HNL,"Minneapolis, MN",Minnesota,"Honolulu, HI",Hawaii,1380,2088,-17,-10,1363,2078,11,7,1374,2071,949,111,131,129,0,,0,0.0,0.0,0.0,0.0,0.0
2024,1,10,3,2024-01-10,HA,7505,SEA,PHX,"Seattle, WA",Washington,"Phoenix, AZ",Arizona,522,2258,11,20,533,2278,10,3,543,2275,530,62,82,75,0,,0,4.0,1.0,2.0,0.0,13.0
2024,2,3,6,2024-02-03,AS,8124,SLC,MSP,"Salt Lake City, UT",Utah,"Minneapolis, MN",Minnesota,2204,619,7,15,2211,634,21,9,2232,625,1115,146,166,176,0,,0,0.0,0.0,0.0,0.0,0.0
2024,2,5,1,2024-02-05,OO,1361,DFW,EWR,"Dallas/Fort Worth, TX",Texas,"Newark, NJ",New Jersey,1787,1167,-25,-15,1762,1152,29,5,1791,1147,1006,127,147,161,0,,0,0.0,0.0,0.0,0.0,0.0
2024,1,6,6,2024-01-06,AS,6423,MIA,BWI,"Miami, FL",Florida,"Baltimore, MD",Maryland,615,1569,4,10,619,1579,23,11,642,1568,2507,309,329,343,0,,0,0.0,0.0,0.0,0.0,0.0
2024,8,2,5,2024-08-02,WN,6037,IAD,MSP,"Washington, DC",District of Columbia,"Minneapolis, MN",Minnesota,979,1731,8,10,987,1741,16,5,1003,1736,2421,303,323,324,0,,0,0.0,0.0,0.0,0.0,0.0
2024,5,13,1,2024-05-13,OO,1682,MSP,SFO,"Minneapolis, MN",Minnesota,"San Francisco, CA",California,806,739,7,0,813,739,11,5,824,734,2545,324,344,340,0,,0,0.0,0.0,0.0,0.0,0.0
2024,10,11,5,2024-10-11,B6,1598,IAD,PHX,"Washington, DC",District of Columbia,"Phoenix, AZ",Arizona,730,1714,2,0,732,1714,16,15,748,1699,1509,185,205,216,0,,0,0.0,0.0,0.0,0.0,0.0
2024,5,5,7,2024-05-05,OH,9040,DFW,TPA,"Dallas/Fort Worth, TX",Texas,"Tampa, FL",Florida,1200,870,-2,-10,1198,860,21,15,1219,845,1076,126,146,162,0,,0,0.0,0.0,0.0,0.0,0.0
2024,12,2,1,2024-12-02,DL,8822,PDX,MCO,"Portland, OR",Oregon,"Orlando, FL",Florida,991,1952,-7,-15,984,1937,19,9,1003,1928,1113,141,161,169,0,,0,0.0,0.0,0.0,0.0,0.0
2024,6,22,6,2024-06-22,UA,2309,MDW,SLC,"Chicago, IL",Illinois,"Salt Lake City, UT",Utah,1268,1833,-4,0,1264,1833,20,5,1284,1828,2124,261,281,286,0,,0,0.0,0.0,0.0,0.0,0.0
2024,5,31,5,2024-05-31,UA,4163,CLT,ATL,"Charlotte, NC",North Carolina,"Atlanta, GA",Georgia,1643,2311,6,10,1649,2321,5,13,1654,2308,677,79,99,97,0,,0,0.0,0.0,0.0,0.0,0.0
2024,11,26,2,2024-11-26,OH,7328,STL,SAN,"St. Louis, MO",Missouri,"San Diego, CA",California,785,2196,9,5,794,2201,15,3,809,2198,1470,175,195,193,0,,0,0.0,0.0,0.0,0.0,0.0
2024,1,26,5,2024-01-26,YX,9400,PHL,DCA,"Philadelphia, PA",Pennsylvania,"Washington, DC",District of Columbia,1487,2078,-4,-10,1483,2068,5,4,1488,2064,2380,304,324,313,0,,0,0.0,0.0,0.0,0.0,0.0
2024,4,24,3,2024-04-24,OO,5766,MSP,IAH,"Minneapolis, MN",Minnesota,"Houston, TX",Texas,1930,883,-18,-10,1912,873,17,11,1929,862,1557,187,207,215,0,,0,0.0,0.0,0.0,0.0,0.0
2024,10,10,4,2024-10-10,B6,8781,SAN,LAS,"San Diego, CA",California,"Las Vegas, NV",Nevada,1881,965,6,0,1887,965,24,5,1911,960,1723,220,240,249,0,,0,0.0,0.0,0.0,0.0,0.0
2024,3,15,5,2024-03-15,OH,8296,MDW,SFO,"Chicago, IL",Illinois,"San Francisco, CA",California,1389,1083,3,0,1392,1083,21,7,1413,1076,1682,216,236,244,0,,0,0.0,0.0,0.0,0.0,0.0
2024,6,14,5,2024-06-14,B6,8367,LAS,MCO,"Las Vegas, NV",Nevada,"Orlando, FL",Florida,1675,602,-21,-15,1654,587,20,6,1674,581,1572,195,215,221,0,,0,0.0,0.0,0.0,0.0,0.0
2024,7,7,7,2024-07-07,AS,5472,BOS,MIA,"Boston, MA",Massachusetts,"Miami, FL",Florida,1097,1603,-4,0,1093,1603,21,10,1114,1593,1546,195,215,226,0,,0,0.0,0.0,0.0,0.0,0.0
2024,3,18,1,2024-03-18,B6,6250,BOS,STL,"Boston, MA",Massachusetts,"St. Louis, MO",Missouri,1848,1383,13,5,1861,1388,29,19,1890,1369,1869,225,245,273,0,,0,0.0,0.0,0.0,0.0,0.0
2024,3,30,6,2024-03-30,YX,572,CLT,MDW,"Charlotte, NC",North Carolina,"Chicago, IL",Illinois,1356,763,-2,-10,1354,753,18,8,1372,745,675,86,106,112,0,,0,0.0,0.0,0.0,0.0,0.0
2024,6,24,1,2024-06-24,AS,9673,DFW,CLT,"Dallas/Fort Worth, TX",Texas,"Charlotte, NC",North Carolina,1338,987,-20,-10,1318,977,28,19,1346,958,1446,171,191,218,0,,0,0.0,0.0,0.0,0.0,0.0
2024,1,21,7,2024-01-21,F9,937,PHX,BWI,"Phoenix, AZ",Arizona,"Baltimore, MD",Maryland,1769,1594,-2,-10,1767,1584,9,19,1776,1565,2093,267,287,295,0,,0,0.0,0.0,0.0,0.0,0.0
2024,2,23,5,2024-02-23,HA,8894,SAN,LAS,"San Diego, CA",California,"Las Vegas, NV",Nevada,1417,1632,21,15,1438,1647,17,16,1455,1631,1805,231,251,264,0,,0,0.0,0.0,0.0,0.0,0.0
2024,7,2,2,2024-07-02,DL,1286,JFK,PHX,"New York, NY",New York,"Phoenix, AZ",Arizona,1838,1615,-1,-5,1837,1610,22,8,1859,1602,349,40,60,70,0,,0,0.0,0.0,0.0,0.0,0.0
2024,12,24,2,2024-12-24,WN,6561,SLC,JFK,"Salt Lake City, UT",Utah,"New York, NY",New York,1439,1989,-3,0,1436,1989,11,19,1447,1970,2305,288,308,318,0,,0,0.0,0.0,0.0,0.0,0.0
2024,8,9,5,2024-08-09,MQ,1581,PDX,LAX,"Portland, OR",Oregon,"Los Angeles, CA",California,1304,611,2,5,1306,616,21,6,1327,610,1263,149,169,176,1,,0,0.0,0.0,0.0,0.0,0.0
2024,11,10,7,2024-11-10,AS,7799,LAX,BWI,"Los Angeles, CA",California,"Baltimore, MD",Maryland,661,673,-15,-5,646,668,15,16,661,652,504,70,90,101,0,,0,0.0,0.0,0.0,0.0,0.0
2024,11,23,6,2024-11-23,YX,7432,MSP,MIA,"Minneapolis, MN",Minnesota,"Miami, FL",Florida,1111,837,-6,-15,1105,822,29,19,1134,803,745,89,109,137,0,,0,0.0,0.0,0.0,0.0,0.0
2024,6,27,4,2024-06-27,B6,331,EWR,LAX,"Newark, NJ",New Jersey,"Los Angeles, CA",California,1892,1731,3,5,1895,1736,21,16,1916,1720,2756,339,359,376,0,,0,0.0,0.0,0.0,0.0,0.0
2024,10,2,3,2024-10-02,AA,427,DFW,PDX,"Dallas/Fort Worth, TX",Texas,"Portland, OR",Oregon,1708,1514,-4,5,1704,1519,23,5,1727,1514,2733,334,354,362,0,,0,0.0,0.0,0.0,0.0,0.0
2024,4,21,7,2024-04-21,G4,6481,HNL,MDW,"Honolulu, HI",Hawaii,"Chicago, IL",Illinois,1452,2148,-20,-10,1432,2138,10,10,1442,2128,2446,303,323,323,0,,0,0.0,0.0,0.0,0.0,0.0
2024,8,11,7,2024-08-11,UA,5339,BOS,MDW,"Boston, MA",Massachusetts,"Chicago, IL",Illinois,775,833,-15,-20,760,813,24,15,784,798,712,87,107,126,0,,0,0.0,0.0,0.0,0.0,0.0
2024,8,1,4,2024-08-01,DL,1049,DCA,SAN,"Washington, DC",District of Columbia,"San Diego, CA",California,1496,2062,7,5,1503,2067,22,16,1525,2051,2269,275,295,313,0,,0,0.0,0.0,0.0,0.0,0.0
2024,2,28,3,2024-02-28,G4,7138,TPA,MCO,"Tampa, FL",Florida,"Orlando, FL",Florida,1028,2104,5,5,1033,2109,25,14,1058,2095,1455,187,207,226,0,,0,0.0,0.0,0.0,0.0,0.0
2024,11,22,5,2024-11-22,NK,8148,BWI,PDX,"Baltimore, MD",Maryland,"Portland, OR",Oregon,1959,1715,-30,-20,1929,1695,14,10,1943,1685,394,42,62,66,0,,0,0.0,0.0,0.0,0.0,0.0
2024,4,18,4,2024-04-18,B6,2397,TPA,IAD,"Tampa, FL",Florida,"Washington, DC",District of Columbia,1783,1471,0,5,1783,1476,5,13,1788,1463,395,48,68,66,0,,0,0.0,0.0,0.0,0.0,0.0
2024,6,5,3,2024-06-05,YX,1407,HNL,IAH,"Honolulu, HI",Hawaii,"Houston, TX",Texas,1458,1821,5,15,1463,1836,5,14,1468,1822,838,106,126,125,0,,0,0.0,0.0,0.0,0.0,0.0
2024,7,9,2,2024-07-09,AS,8489,PHX,SEA,"Phoenix, AZ",Arizona,"Seattle, WA",Washington,1768,1739,-15,-10,1753,1729,19,3,1772,1726,1944,249,269,271,0,,0,0.0,0.0,0.0,0.0,0.0
2024,7,18,4,2024-07-18,YX,2879,MDW,PDX,"Chicago, IL",Illinois,"Portland, OR",Oregon,1861,2266,-2,0,1859,2266,10,4,1869,2262,1962,252,272,266,0,,0,0.0,0.0,0.0,0.0,0.0
2024,11,7,4,2024-11-07,OO,7418,PDX,SLC,"Portland, OR",Oregon,"Salt Lake City, UT",Utah,549,1988,7,5,556,1993,29,6,585,1987,1950,237,257,272,0,,0,0.0,0.0,0.0,0.0,0.0
2024,7,14,7,2024-07-14,WN,3436,HNL,PHX,"Honolulu, HI",Hawaii,"Phoenix, AZ",Arizona,1795,752,-5,-10,1790,742,11,14,1801,728,932,121,141,146,0,,0,0.0,0.0,0.0,0.0,0.0
2024,2,4,7,2024-02-04,AA,5435,SLC,BOS,"Salt Lake City, UT",Utah,"Boston, MA",Massachusetts,1758,2256,14,5,1772,2261,14,3,1786,2258,640,86,106,103,0,,0,0.0,0.0,0.0,0.0,0.0
2024,9,2,1,2024-09-02,WN,9630,DEN,LAS,"Denver, CO",Colorado,"Las Vegas, NV",Nevada,1083,1731,3,10,1086,1741,8,12,1094,1729,1673,216,236,236,0,,0,0.0,0.0,0.0,0.0,0.0
2024,8,24,6,2024-08-24,G4,9983,BOS,TPA,"Boston, MA",Massachusetts,"Tampa, FL",Florida,2079,1127,19,10,2098,1137,18,3,2116,1134,958,124,144,145,0,,0,0.0,0.0,0.0,0.0,0.0
2024,4,13,6,2024-04-13,AA,8507,SAN,SLC,"San Diego, CA",California,"Salt Lake City, UT",Utah,1413,1410,-10,-10,1403,1400,12,7,1415,1393,761,88,108,107,0,,0,0.0,0.0,0.0,0.0,0.0
2024,1,7,7,2024-01-07,9E,7602,JFK,HNL,"New York, NY",New York,"Honolulu, HI",Hawaii,1829,655,12,10,1841,665,5,13,1846,652,735,99,119,117,0,,0,0.0,0.0,0.0,0.0,0.0
2024,10,9,3,2024-10-09,UA,7626,MCO,SEA,"Orlando, FL",Florida,"Seattle, WA",Washington,976,2075,-15,-5,961,2070,25,4,986,2066,265,38,58,67,0,,0,0.0,0.0,0.0,0.0,0.0
2024,1,1,1,2024-01-01,HA,1749,HNL,STL,"Honolulu, HI",Hawaii,"St. Louis, MO",Missouri,987,2015,-18,-10,969,2005,6,11,975,1994,1619,204,224,221,0,,0,0.0,0.0,0.0,0.0,0.0
2024,8,6,2,2024-08-06,HA,2962,BWI,BOS,"Baltimore, MD",Maryland,"Boston, MA",Massachusetts,579,1214,-10,-10,569,1204,23,14,592,1190,2881,353,373,390,1,,0,0.0,0.0,0.0,0.0,0.0
2024,8,17,6,2024-08-17,B6,8901,DEN,EWR,"Denver, CO",Colorado,"Newark, NJ",New Jersey,1809,1831,24,15,1833,1846,14,9,1847,1837,2838,345,365,368,0,,0,0.0,0.0,0.0,0.0,0.0
2024,6,20,4,2024-06-20,NK,1017,MSP,MCO,"Minneapolis, MN",Minnesota,"Orlando, FL",Florida,1060,2133,-8,-5,1052,2128,8,18,1060,2110,1940,242,262,268,0,,0,0.0,0.0,0.0,0.0,0.0
2024,3,27,3,2024-03-27,G4,8453,JFK,CLT,"New York, NY",New York,"Charlotte, NC",North Carolina,1621,1533,0,10,1621,1543,21,9,1642,1534,721,91,111,121,0,,0,0.0,0.0,0.0,0.0,0.0
2024,2,10,6,2024-02-10,AS,4237,LAX,HNL,"Los Angeles, CA",California,"Honolulu, HI",Hawaii,2001,1262,-2,-10,1999,1252,20,11,2019,1241,2781,350,370,381,0,,0,0.0,0.0,0.0,0.0,0.0
2024,5,2,4,2024-05-02,UA,7447,EWR,MSP,"Newark, NJ",New Jersey,"Minneapolis, MN",Minnesota,905,2178,8,5,913,2183,9,10,922,2173,952,120,140,139,0,,0,0.0,0.0,0.0,0.0,0.0
2024,11,26,2,2024-11-26,MQ,5549,PHX,JFK,"Phoenix, AZ",Arizona,"New York, NY",New York,1036,899,-8,-15,1028,884,14,11,1042,873,2612,326,346,351,0,,0,0.0,0.0,0.0,0.0,0.0
2024,10,24,4,2024-10-24,NK,5782,SAN,MSP,"San Diego, CA",California,"Minneapolis, MN",Minnesota,2249,1575,-25,-20,2224,1555,26,19,2250,1536,285,28,48,73,0,,0,0.0,0.0,0.0,0.0,0.0
2024,6,26,3,2024-06-26,HA,2911,SLC,TPA,"Salt Lake City, UT",Utah,"Tampa, FL",Florida,2091,1229,58,60,2149,1289,15,14,2164,1275,2251,280,300,309,0,,0,21.0,12.0,9.0,2.0,16.0
2024,3,3,7,2024-03-03,OH,3521,LGA,DCA,"New York, NY",New York,"Washington, DC",District of Columbia,754,1902,-17,-15,737,1887,5,14,742,1873,777,99,119,118,0,,0,0.0,0.0,0.0,0.0,0.0
2024,6,13,4,2024-06-13,WN,4315,SEA,IAH,"Seattle, WA",Washington,"Houston, TX",Texas,1459,743,4,0,1463,743,17,6,1480,737,2589,314,334,337,0,,0,0.0,0.0,0.0,0.0,0.0
2024,7,5,5,2024-07-05,UA,9390,BOS,JFK,"Boston, MA",Massachusetts,"New York, NY",New York,2191,1827,4,10,2195,1837,24,11,2219,1826,2432,301,321,336,0,,0,0.0,0.0,0.0,0.0,0.0
2024,7,27,6,2024-07-27,OH,2821,HNL,MIA,"Honolulu, HI",Hawaii,"Miami, FL",Florida,986,828,18,10,1004,838,6,12,1010,826,993,115,135,133,0,,0,0.0,0.0,0.0,0.0,0.0
2024,8,14,3,2024-08-14,NK,8414,MCO,SEA,"Orlando, FL",Florida,"Seattle, WA",Washington,2196,1888,-2,0,2194,1888,5,19,2199,1869,733,88,108,112,0,,0,0.0,0.0,0.0,0.0,0.0
2024,2,17,6,2024-02-17,OO,3353,LAS,PHX,"Las Vegas, NV",Nevada,"Phoenix, AZ",Arizona,1717,1065,-2,0,1715,1065,18,12,1733,1053,2188,282,302,312,0,,0,0.0,0.0,0.0,0.0,0.0
2024,8,11,7,2024-08-11,OO,888,STL,MDW,"St. Louis, MO",Missouri,"Chicago, IL",Illinois,1015,736,6,0,1021,736,25,14,1046,722,401,46,66,85,0,,0,0.0,0.0,0.0,0.0,0.0
2024,1,3,3,2024-01-03,NK,356,SFO,DCA,"San Francisco, CA",California,"Washington, DC",District of Columbia,963,839,-11,-15,952,824,16,19,968,805,1797,230,250,265,0,,0,0.0,0.0,0.0,0.0,0.0
2024,6,23,7,2024-06-23,WN,4125,LGA,ORD,"New York, NY",New York,"Chicago, IL",Illinois,1279,2321,-11,-10,1268,2311,15,8,1283,2303,1904,234,254,257,0,,0,0.0,0.0,0.0,0.0,0.0
2024,4,8,1,2024-04-08,YX,6056,BWI,ATL,"Baltimore, MD",Maryland,"Atlanta, GA",Georgia,2027,1048,-7,-5,2020,1043,5,6,2025,1037,221,26,46,37,0,,1,0.0,0.0,0.0,0.0,0.0
2024,4,25,4,2024-04-25,NK,6841,MSP,PHL,"Minneapolis, MN",Minnesota,"Philadelphia, PA",Pennsylvania,535,1938,3,-5,538,1933,18,18,556,1915,1865,228,248,264,0,,0,0.0,0.0,0.0,0.0,0.0
2024,9,26,4,2024-09-26,OO,3754,DCA,PHX,"Washington, DC",District of Columbia,"Phoenix, AZ",Arizona,515,750,-14,-10,501,740,12,19,513,721,1312,158,178,189,0,,0,0.0,0.0,0.0,0.0,0.0
2024,9,9,1,2024-09-09,OH,7760,TPA,SAN,"Tampa, FL",Florida,"San Diego, CA",California,1418,1948,-8,-10,1410,1938,22,18,1432,1920,221,23,43,63,0,,0,0.0,0.0,0.0,0.0,0.0
2024,11,12,2,2024-11-12,DL,3351,IAD,TPA,"Washington, DC",District of Columbia,"Tampa, FL",Florida,1148,2026,-14,-5,1134,2021,9,6,1143,2015,2128,268,288,283,0,,0,0.0,0.0,0.0,0.0,0.0
2024,4,4,4,2024-04-04,AA,5368,SLC,SAN,"Salt Lake City, UT",Utah,"San Diego, CA",California,2113,1402,2,-5,2115,1397,7,8,2122,1389,1736,207,227,222,0,,0,0.0,0.0,0.0,0.0,0.0
2024,9,29,7,2024-09-29,YX,7276,DEN,PHX,"Denver, CO",Colorado,"Phoenix, AZ",Arizona,1322,952,-3,0,1319,952,26,10,1345,942,2774,337,357,373,0,,0,0.0,0.0,0.0,0.0,0.0
2024,1,24,3,2024-01-24,HA,7662,SEA,IAD,"Seattle, WA",Washington,"Washington, DC",District of Columbia,572,1733,-13,-10,559,1723,10,11,569,1712,2405,303,323,324,0,,0,0.0,0.0,0.0,0.0,0.0
2024,4,25,4,2024-04-25,DL,8899,JFK,DCA,"New York, NY",New York,"Washington, DC",District of Columbia,1843,1065,14,5,1857,1070,28,8,1885,1062,690,88,108,124,0,,0,0.0,0.0,0.0,0.0,0.0
2024,5,30,4,2024-05-30,WN,4526,SAN,SLC,"San Diego, CA",California,"Salt Lake City, UT",Utah,1768,1663,8,10,1776,1673,25,16,1801,1657,1769,230,250,271,0,,0,0.0,0.0,0.0,0.0,0.0
2024,12,3,2,2024-12-03,F9,4027,IAH,CLT,"Houston, TX",Texas,"Charlotte, NC",North Carolina,1239,1253,-8,-10,1231,1243,9,15,1240,1228,2912,364,384,388,0,,0,0.0,0.0,0.0,0.0,0.0
2024,2,19,1,2024-02-19,UA,5426,DTW,LAX,"Detroit, MI",Michigan,"Los Angeles, CA",California,1718,1963,-6,-15,1712,1948,25,19,1737,1929,2688,328,348,372,0,,0,0.0,0.0,0.0,0.0,0.0
2024,7,24,3,2024-07-24,HA,2252,MDW,JFK,"Chicago, IL",Illinois,"New York, NY",New York,1257,1995,6,5,1263,2000,29,19,1292,1981,1308,161,181,209,0,,0,0.0,0.0,0.0,0.0,0.0
2024,11,30,6,2024-11-30,9E,8838,IAD,MDW,"Washington, DC",District of Columbia,"Chicago, IL",Illinois,1405,2148,11,15,1416,2163,6,19,1422,2144,1853,222,242,247,0,,0,0.0,0.0,0.0,0.0,0.0
2024,3,19,2,2024-03-19,HA,7988,DFW,PDX,"Dallas/Fort Worth, TX",Texas,"Portland, OR",Oregon,1518,2130,-18,-20,1500,2110,7,17,1507,2093,2471,307,327,331,0,,0,0.0,0.0,0.0,0.0,0.0
2024,3,10,7,2024-03-10,AS,5574,SAN,LGA,"San Diego, CA",California,"New York, NY",New York,1612,652,-18,-20,1594,632,8,17,1602,615,1890,240,260,265,0,,0,0.0,0.0,0.0,0.0,0.0
2024,1,27,6,2024-01-27,AS,9974,DEN,MSP,"Denver, CO",Colorado,"Minneapolis, MN",Minnesota,2295,1703,-17,-10,2278,1693,27,13,2305,1680,1157,150,170,190,0,,0,0.0,0.0,0.0,0.0,0.0
2024,9,27,5,2024-09-27,MQ,588,CLT,MSP,"Charlotte, NC",North Carolina,"Minneapolis, MN",Minnesota,1297,950,-4,5,1293,955,5,9,1298,946,2266,278,298,292,0,,0,0.0,0.0,0.0,0.0,0.0
2024,2,19,1,2024-02-19,G4,1922,MSP,MCO,"Minneapolis, MN",Minnesota,"Orlando, FL",Florida,1662,2174,11,20,1673,2194,20,19,1693,2175,989,123,143,162,0,,0,4.0,4.0,3.0,0.0,9.0
2024,10,18,5,2024-10-18,G4,7860,BWI,SFO,"Baltimore, MD",Maryland,"San Francisco, CA",California,2086,1338,-1,5,2085,1343,23,14,2108,1329,1211,143,163,180,0,,0,0.0,0.0,0.0,0.0,0.0
2024,9,3,2,2024-09-03,WN,5722,ORD,PHX,"Chicago, IL",Illinois,"Phoenix, AZ",Arizona,2182,939,-9,0,2173,939,27,9,2200,930,2710,334,354,370,0,,0,0.0,0.0,0.0,0.0,0.0
2024,9,20,5,2024-09-20,G4,3221,SEA,JFK,"Seattle, WA",Washington,"New York, NY",New York,2277,1744,9,5,2286,1749,12,11,2298,1738,425,54,74,77,0,,0,0.0,0.0,0.0,0.0,0.0
2024,3,19,2,2024-03-19,HA,3874,MSP,BOS,"Minneapolis, MN",Minnesota,"Boston, MA",Massachusetts,1920,664,-19,-10,1901,654,6,6,1907,648,805,104,124,116,0,,0,0.0,0.0,0.0,0.0,0.0
2024,7,8,1,2024-07-08,HA,6546,TPA,BWI,"Tampa, FL",Florida,"Baltimore, MD",Maryland,1452,2063,-4,5,1448,2068,7,15,1455,2053,1365,167,187,189,0,,0,0.0,0.0,0.0,0.0,0.0
2024,2,16,5,2024-02-16,MQ,3552,CLT,SAN,"Charlotte, NC",North Carolina,"San Diego, CA",California,983,895,4,-5,987,890,18,17,1005,873,1054,135,155,170,0,,0,0.0,0.0,0.0,0.0,0.0
2024,12,26,4,2024-12-26,AS,8941,LAX,JFK,"Los Angeles, CA",California,"New York, NY",New York,886,1541,-13,-10,873,1531,11,11,884,1520,568,62,82,84,0,,0,0.0,0.0,0.0,0.0,0.0
2024,12,19,4,2024-12-19,DL,8939,STL,IAD,"St. Louis, MO",Missouri,"Washington, DC",District of Columbia,1891,804,-16,-10,1875,794,17,12,1892,782,1870,235,255,264,0,,0,0.0,0.0,0.0,0.0,0.0
2024,12,17,2,2024-12-17,9E,5581,SEA,MDW,"Seattle, WA",Washington,"Chicago, IL",Illinois,957,1246,10,5,967,1251,11,10,978,1241,1333,167,187,188,0,,0,0.0,0.0,0.0,0.0,0.0
2024,7,7,7,2024-07-07,OH,8672,DFW,SAN,"Dallas/Fort Worth, TX",Texas,"San Diego, CA",California,921,2180,8,5,929,2185,20,9,949,2176,417,46,66,75,0,,0,0.0,0.0,0.0,0.0,0.0
2024,9,12,4,2024-09-12,OO,7933,SEA,MCO,"Seattle, WA",Washington,"Orlando, FL",Florida,731,1901,-3,0,728,1901,7,9,735,1892,1828,227,247,243,0,,0,0.0,0.0,0.0,0.0,0.0
2024,8,9,5,2024-08-09,AS,7217,TPA,EWR,"Tampa, FL",Florida,"Newark, NJ",New Jersey,1038,734,-15,-15,1023,719,9,11,1032,708,977,116,136,136,0,,0,0.0,0.0,0.0,0.0,0.0
2024,8,28,3,2024-08-28,DL,9491,ATL,DCA,"Atlanta, GA",Georgia,"Washington, DC",District of Columbia,1867,977,-20,-20,1847,957,27,15,1874,942,2295,282,302,324,0,,0,0.0,0.0,0.0,0.0,0.0
2024,9,25,3,2024-09-25,F9,4987,ORD,SFO,"Chicago, IL",Illinois,"San Francisco, CA",California,1219,1675,-13,-10,1206,1665,7,18,1213,1647,1573,200,220,225,0,,0,0.0,0.0,0.0,0.0,0.0
2024,1,1,1,2024-01-01,WN,3090,MIA,LAX,"Miami, FL",Florida,"Los Angeles, CA",California,1661,1467,-5,-10,1656,1457,28,7,1684,1450,438,47,67,82,0,,0,0.0,0.0,0.0,0.0,0.0
2024,2,3,6,2024-02-03,B6,9399,SEA,STL,"Seattle, WA",Washington,"St. Louis, MO",Missouri,1897,1179,-8,-5,1889,1174,19,7,1908,1167,2529,321,341,347,0,,0,0.0,0.0,0.0,0.0,0.0
2024,3,19,2,2024-03-19,F9,3547,LAS,STL,"Las Vegas, NV",Nevada,"St. Louis, MO",Missouri,1960,1616,-6,-15,1954,1601,24,10,1978,1591,2184,277,297,311,0,,0,0.0,0.0,0.0,0.0,0.0
2024,8,23,5,2024-08-23,OH,321,ATL,BOS,"Atlanta, GA",Georgia,"Boston, MA",Massachusetts,654,1309,14,5,668,1314,15,17,683,1297,1226,155,175,187,0,,0,0.0,0.0,0.0,0.0,0.0
2024,11,29,5,2024-11-29,OO,7718,PDX,LAS,"Portland, OR",Oregon,"Las Vegas, NV",Nevada,1018,666,6,5,1024,671,27,15,1051,656,785,100,120,142,0,,0,0.0,0.0,0.0,0.0,0.0
2024,12,14,6,2024-12-14,F9,9731,EWR,SAN,"Newark, NJ",New Jersey,"San Diego, CA",California,1638,602,-11,-5,1627,597,22,3,1649,594,1252,147,167,172,0,,0,0.0,0.0,0.0,0.0,0.0
2024,4,7,7,2024-04-07,YX,6688,EWR,LAX,"Newark, NJ",New Jersey,"Los Angeles, CA",California,1615,2193,-8,0,1607,2193,9,14,1616,2179,2390,303,323,326,0,,0,0.0,0.0,0.0,0.0,0.0
2024,3,22,5,2024-03-22,OH,717,ORD,EWR,"Chicago, IL",Illinois,"Newark, NJ",New Jersey,1869,2074,-8,-15,1861,2059,26,17,1887,2042,2849,351,371,394,0,,0,0.0,0.0,0.0,0.0,0.0
2024,7,10,3,2024-07-10,YX,2670,HNL,DFW,"Honolulu, HI",Hawaii,"Dallas/Fort Worth, TX",Texas,2117,1109,-15,-5,2102,1104,17,6,2119,1098,1505,186,206,209,0,,0,0.0,0.0,0.0,0.0,0.0
2024,9,9,1,2024-09-09,AS,6409,CLT,MCO,"Charlotte, NC",North Carolina,"Orlando, FL",Florida,2048,2061,18,10,2066,2071,5,19,2071,2052,2754,346,366,370,0,,0,0.0,0.0,0.0,0.0,0.0
2024,2,7,3,2024-02-07,WN,2855,DCA,CLT,"Washington, DC",District of Columbia,"Charlotte, NC",North Carolina,1083,1376,7,5,1090,1381,18,4,1108,1377,2081,254,274,276,0,,0,0.0,0.0,0.0,0.0,0.0
2024,1,14,7,2024-01-14,HA,2890,ATL,HNL,"Atlanta, GA",Georgia,"Honolulu, HI",Hawaii,1614,2151,-15,-15,1599,2136,13,14,1612,2122,1977,241,261,268,0,,0,0.0,0.0,0.0,0.0,0.0
2024,12,12,4,2024-12-12,AA,7926,LAS,ATL,"Las Vegas, NV",Nevada,"Atlanta, GA",Georgia,1199,701,0,10,1199,711,13,4,1212,707,733,97,117,114,0,,0,0.0,0.0,0.0,0.0,0.0
2024,11,5,2,2024-11-05,YX,3409,EWR,BOS,"Newark, NJ",New Jersey,"Boston, MA",Massachusetts,1921,2060,12,5,1933,2065,8,14,1941,2051,901,120,140,142,0,,0,0.0,0.0,0.0,0.0,0.0
2024,7,27,6,2024-07-27,NK,7252,IAD,ATL,"Washington, DC",District of Columbia,"Atlanta, GA",Georgia,604,1398,8,0,612,1398,25,18,637,1380,2723,347,367,390,0,,0,0.0,0.0,0.0,0.0,0.0
2024,12,22,7,2024-12-22,F9,4154,TPA,CLT,"Tampa, FL",Florida,"Charlotte, NC",North Carolina,1311,1333,7,5,1318,1338,29,7,1347,1331,2606,329,349,365,0,,0,0.0,0.0,0.0,0.0,0.0
2024,3,29,5,2024-03-29,G4,7156,STL,MIA,"St. Louis, MO",Missouri,"Miami, FL",Florida,1465,1644,-13,-10,1452,1634,6,19,1458,1615,410,45,65,70,0,,0,0.0,0.0,0.0,0.0,0.0
2024,2,25,7,2024-02-25,DL,7524,HNL,PDX,"Honolulu, HI",Hawaii,"Portland, OR",Oregon,1095,986,7,0,1102,986,20,13,1122,973,2502,317,337,350,0,,0,0.0,0.0,0.0,0.0,0.0
2024,4,3,3,2024-04-03,AA,7781,ORD,PHL,"Chicago, IL",Illinois,"Philadelphia, PA",Pennsylvania,1513,1132,-9,0,1504,1132,9,9,1513,1123,2864,348,368,366,0,,0,0.0,0.0,0.0,0.0,0.0
2024,4,2,2,2024-04-02,WN,6608,BWI,ORD,"Baltimore, MD",Maryland,"Chicago, IL",Illinois,1039,691,23,15,1062,706,24,4,1086,702,2236,271,291,299,0,,0,0.0,0.0,0.0,0.0,0.0
2024,12,5,4,2024-12-05,MQ,324,LAS,IAD,"Las Vegas, NV",Nevada,"Washington, DC",District of Columbia,1802,1756,-7,-15,1795,1741,22,5,1817,1736,710,94,114,121,0,,0,0.0,0.0,0.0,0.0,0.0
2024,3,25,1,2024-03-25,B6,7239,DTW,ORD,"Detroit, MI",Michigan,"Chicago, IL",Illinois,511,1438,-11,-5,500,1433,6,11,506,1422,2835,354,374,371,0,,0,0.0,0.0,0.0,0.0,0.0
2024,9,1,7,2024-09-01,9E,8236,SLC,IAD,"Salt Lake City, UT",Utah,"Washington, DC",District of Columbia,1830,1104,12,15,1842,1119,18,3,1860,1116,1457,178,198,199,0,,0,0.0,0.0,0.0,0.0,0.0
2024,1,22,1,2024-01-22,YX,3450,LAX,MDW,"Los Angeles, CA",California,"Chicago, IL",Illinois,863,2076,-1,-10,862,2066,19,17,881,2049,682,91,111,127,0,,0,0.0,0.0,0.0,0.0,0.0
2024,10,17,4,2024-10-17,AA,3927,MIA,STL,"Miami, FL",Florida,"St. Louis, MO",Missouri,1161,1440,2,10,1163,1450,29,13,1192,1437,2386,295,315,337,0,,0,0.0,0.0,0.0,0.0,0.0
2024,9,28,6,2024-09-28,B6,1503,SLC,MIA,"Salt Lake City, UT",Utah,"Miami, FL",Florida,1841,1286,-29,-20,1812,1266,14,7,1826,1259,1992,257,277,278,0,,0,0.0,0.0,0.0,0.0,0.0
2024,11,1,5,2024-11-01,AS,4312,IAD,IAH,"Washington, DC",District of Columbia,"Houston, TX",Texas,1037,1324,-25,-20,1012,1304,20,11,1032,1293,2126,256,276,287,0,,0,0.0,0.0,0.0,0.0,0.0
2024,5,1,3,2024-05-01,UA,509,MIA,DFW,"Miami, FL",Florida,"Dallas/Fort Worth, TX",Texas,1737,747,0,-5,1737,742,12,16,1749,726,626,72,92,100,0,,0,0.0,0.0,0.0,0.0,0.0
2024,5,7,2,2024-05-07,YX,2016,MIA,MCO,"Miami, FL",Florida,"Orlando, FL",Florida,813,1533,9,5,822,1538,28,14,850,1524,963,128,148,170,0,,0,0.0,0.0,0.0,0.0,0.0
2024,4,22,1,2024-04-22,HA,4167,DTW,TPA,"Detroit, MI",Michigan,"Tampa, FL",Florida,1978,1855,-22,-15,1956,1840,28,12,1984,1828,2084,263,283,303,0,,0,0.0,0.0,0.0,0.0,0.0
2024,9,29,7,2024-09-29,NK,2959,LGA,MSP,"New York, NY",New York,"Minneapolis, MN",Minnesota,1922,1483,-14,-5,1908,1478,25,11,1933,1467,2665,330,350,366,0,,0,0.0,0.0,0.0,0.0,0.0
2024,12,1,7,2024-12-01,OH,7172,TPA,SAN,"Tampa, FL",Florida,"San Diego, CA",California,2275,1788,-12,-15,2263,1773,18,4,2281,1769,2918,371,391,393,0,,0,0.0,0.0,0.0,0.0,0.0
2024,5,9,4,2024-05-09,AS,2151,STL,MSP,"St. Louis, MO",Missouri,"Minneapolis, MN",Minnesota,1745,913,-15,-10,1730,903,24,11,1754,892,2371,288,308,323,0,,0,0.0,0.0,0.0,0.0,0.0
2024,5,11,6,2024-05-11,WN,3801,MDW,CLT,"Chicago, IL",Illinois,"Charlotte, NC",North Carolina,1079,1256,9,0,1088,1256,14,17,1102,1239,511,55,75,86,0,,0,0.0,0.0,0.0,0.0,0.0
2024,3,25,1,2024-03-25,UA,8314,PDX,PHX,"Portland, OR",Oregon,"Phoenix, AZ",Arizona,761,897,4,-5,765,892,17,18,782,874,1352,174,194,209,0,,0,0.0,0.0,0.0,0.0,0.0
2024,12,15,7,2024-12-15,B6,3068,IAH,PHL,"Houston, TX",Texas,"Philadelphia, PA",Pennsylvania,995,822,-17,-10,978,812,23,3,1001,809,556,64,84,90,0,,0,0.0,0.0,0.0,0.0,0.0
2024,3,21,4,2024-03-21,UA,9036,BWI,MDW,"Baltimore, MD",Maryland,"Chicago, IL",Illinois,1122,952,4,-5,1126,947,6,7,1132,940,1377,178,198,191,0,,0,0.0,0.0,0.0,0.0,0.0
2024,11,20,3,2024-11-20,9E,701,TPA,BWI,"Tampa, FL",Florida,"Baltimore, MD",Maryland,629,1015,-5,5,624,1020,9,9,633,1011,1898,231,251,249,0,,0,0.0,0.0,0.0,0.0,0.0
2024,3,9,6,2024-03-09,G4,8034,SFO,PHL,"San Francisco, CA",California,"Philadelphia, PA",Pennsylvania,1682,661,-12,-15,1670,646,18,3,1688,643,1260,161,181,182,0,,0,0.0,0.0,0.0,0.0,0.0
2024,5,27,1,2024-05-27,G4,5374,CLT,SEA,"Charlotte, NC",North Carolina,"Seattle, WA",Washington,1291,1207,-8,0,1283,1207,28,19,1311,1188,977,112,132,159,0,,0,0.0,0.0,0.0,0.0,0.0
2024,1,16,2,2024-01-16,AS,1942,MDW,IAH,"Chicago, IL",Illinois,"Houston, TX",Texas,1814,1223,-17,-10,1797,1213,25,17,1822,1196,908,103,123,145,0,,0,0.0,0.0,0.0,0.0,0.0
2024,11,2,6,2024-11-02,MQ,2762,LAS,PHL,"Las Vegas, NV",Nevada,"Philadelphia, PA",Pennsylvania,2066,975,4,-5,2070,970,27,10,2097,960,2213,277,297,314,0,,0,0.0,0.0,0.0,0.0,0.0
2024,4,14,7,2024-04-14,OO,8774,ORD,ATL,"Chicago, IL",Illinois,"Atlanta, GA",Georgia,588,1198,13,10,601,1208,25,16,626,1192,313,48,68,89,0,,0,0.0,0.0,0.0,0.0,0.0
2024,6,13,4,2024-06-13,AS,4136,DTW,PHX,"Detroit, MI",Michigan,"Phoenix, AZ",Arizona,1467,1004,24,15,1491,1019,29,10,1520,1009,1717,207,227,246,0,,0,0.0,0.0,0.0,0.0,0.0
2024,7,19,5,2024-07-19,YX,2739,ATL,STL,"Atlanta, GA",Georgia,"St. Louis, MO",Missouri,1855,1528,-2,-10,1853,1518,28,18,1881,1500,203,25,45,71,0,,0,0.0,0.0,0.0,0.0,0.0
2024,7,15,1,2024-07-15,OH,5626,EWR,IAH,"Newark, NJ",New Jersey,"Houston, TX",Texas,1129,1878,-2,0,1127,1878,12,14,1139,1864,910,112,132,138,0,,0,0.0,0.0,0.0,0.0,0.0
2024,7,3,3,2024-07-03,WN,5468,LGA,SFO,"New York, NY",New York,"San Francisco, CA",California,1005,2074,8,5,1013,2079,5,9,1018,2070,957,116,136,130,0,,0,0.0,0.0,0.0,0.0,0.0
2024,11,17,7,2024-11-17,WN,7243,STL,DFW,"St. Louis, MO",Missouri,"Dallas/Fort Worth, TX",Texas,1653,989,3,10,1656,999,9,7,1665,992,838,109,129,125,0,,0,0.0,0.0,0.0,0.0,0.0
2024,9,21,6,2024-09-21,DL,6203,SFO,ORD,"San Francisco, CA",California,"Chicago, IL",Illinois,706,2248,3,10,709,2258,29,3,738,2255,2874,360,380,392,0,,0,0.0,0.0,0.0,0.0,0.0
2024,12,28,6,2024-12-28,9E,3925,SAN,SLC,"San Diego, CA",California,"Salt Lake City, UT",Utah,1883,1365,1,0,1884,1365,15,13,1899,1352,2692,328,348,356,0,,0,0.0,0.0,0.0,0.0,0.0
2024,4,9,2,2024-04-09,WN,9974,JFK,ATL,"New York, NY",New York,"Atlanta, GA",Georgia,1582,947,27,30,1609,977,12,14,1621,963,667,85,105,111,0,,0,6.0,0.0,1.0,0.0,23.0
2024,12,7,6,2024-12-07,F9,5770,BWI,MIA,"Baltimore, MD",Maryland,"Miami, FL",Florida,1619,2125,25,20,1644,2145,21,16,1665,2129,2083,259,279,296,0,,0,7.0,1.0,2.0,0.0,10.0
2024,11,15,5,2024-11-15,MQ,4896,SFO,SLC,"San Francisco, CA",California,"Salt Lake City, UT",Utah,1769,1945,0,0,1769,1945,29,14,1798,1931,2894,370,390,413,0,,0,0.0,0.0,0.0,0.0,0.0
2024,8,1,4,2024-08-01,9E,3708,BOS,PHX,"Boston, MA",Massachusetts,"Phoenix, AZ",Arizona,1982,2167,-4,0,1978,2167,14,14,1992,2153,2424,295,315,323,0,,0,0.0,0.0,0.0,0.0,0.0
2024,10,4,5,2024-10-04,DL,6978,SFO,IAH,"San Francisco, CA",California,"Houston, TX",Texas,1668,1687,14,5,1682,1692,18,5,1700,1687,1935,249,269,272,0,,0,0.0,0.0,0.0,0.0,0.0
2024,6,10,1,2024-06-10,G4,1118,IAD,LAS,"Washington, DC",District of Columbia,"Las Vegas, NV",Nevada,1833,1777,-2,-5,1831,1772,5,9,1836,1763,2810,351,371,365,0,,0,0.0,0.0,0.0,0.0,0.0
2024,6,5,3,2024-06-05,OH,5449,LAX,LAS,"Los Angeles, CA",California,"Las Vegas, NV",Nevada,2160,1557,4,5,2164,1562,9,12,2173,1550,2749,343,363,364,0,,0,0.0,0.0,0.0,0.0,0.0
2024,9,7,6,2024-09-07,AA,4860,MSP,LGA,"Minneapolis, MN",Minnesota,"New York, NY",New York,1033,1116,-9,0,1024,1116,19,12,1043,1104,2278,283,303,314,0,,0,0.0,0.0,0.0,0.0,0.0
2024,4,6,6,2024-04-06,MQ,1411,LAX,EWR,"Los Angeles, CA",California,"Newark, NJ",New Jersey,1904,2018,-18,-20,1886,1998,14,6,1900,1992,1986,251,271,271,0,,0,0.0,0.0,0.0,0.0,0.0
2024,1,18,4,2024-01-18,DL,9710,SLC,IAH,"Salt Lake City, UT",Utah,"Houston, TX",Texas,1876,929,8,10,1884,939,19,19,1903,920,370,52,72,90,0,,0,0.0,0.0,0.0,0.0,0.0
2024,11,22,5,2024-11-22,HA,2600,EWR,MDW,"Newark, NJ",New Jersey,"Chicago, IL",Illinois,1383,2086,22,15,1405,2101,5,12,1410,2089,1311,172,192,189,0,,0,0.0,0.0,0.0,0.0,0.0
2024,4,6,6,2024-04-06,DL,2767,PDX,TPA,"Portland, OR",Oregon,"Tampa, FL",Florida,1450,2345,-21,-20,1429,2325,28,4,1457,2321,2938,373,393,405,0,,0,0.0,0.0,0.0,0.0,0.0
2024,1,1,1,2024-01-01,OO,6134,MSP,SLC,"Minneapolis, MN",Minnesota,"Salt Lake City, UT",Utah,784,1573,8,5,792,1578,15,4,807,1574,653,75,95,94,0,,0,0.0,0.0,0.0,0.0,0.0
2024,8,3,6,2024-08-03,MQ,9678,BOS,BWI,"Boston, MA",Massachusetts,"Baltimore, MD",Maryland,1218,691,-13,-5,1205,686,22,11,1227,675,978,130,150,163,0,,0,0.0,0.0,0.0,0.0,0.0
2024,5,11,6,2024-05-11,HA,5330,LAX,STL,"Los Angeles, CA",California,"St. Louis, MO",Missouri,1001,1845,-4,0,997,1845,10,15,1007,1830,2936,364,384,389,0,,0,0.0,0.0,0.0,0.0,0.0
2024,9,16,1,2024-09-16,OH,9436,PHL,PDX,"Philadelphia, PA",Pennsylvania,"Portland, OR",Oregon,757,789,0,0,757,789,6,7,763,782,2775,344,364,357,0,,0,0.0,0.0,0.0,0.0,0.0
2024,5,4,6,2024-05-04,AS,4934,HNL,IAD,"Honolulu, HI",Hawaii,"Washington, DC",District of Columbia,1309,1171,-5,0,1304,1171,6,11,1310,1160,2980,378,398,395,0,,0,0.0,0.0,0.0,0.0,0.0
2024,3,22,5,2024-03-22,HA,1646,DCA,LAX,"Washington, DC",District of Columbia,"Los Angeles, CA",California,551,804,4,0,555,804,21,17,576,787,1392,179,199,217,0,,0,0.0,0.0,0.0,0.0,0.0
2024,10,9,3,2024-10-09,OH,2245,PHX,BWI,"Phoenix, AZ",Arizona,"Baltimore, MD",Maryland,1049,811,14,10,1063,821,26,12,1089,809,1125,141,161,179,0,,0,0.0,0.0,0.0,0.0,0.0
2024,6,19,3,2024-06-19,NK,2263,STL,MCO,"St. Louis, MO",Missouri,"Orlando, FL",Florida,1164,1369,2,5,1166,1374,9,12,1175,1362,2676,336,356,357,0,,0,0.0,0.0,0.0,0.0,0.0
2024,2,28,3,2024-02-28,MQ,3112,EWR,SAN,"Newark, NJ",New Jersey,"San Diego, CA",California,1739,688,-3,-5,1736,683,24,6,1760,677,2775,351,371,381,0,,0,0.0,0.0,0.0,0.0,0.0
2024,2,1,4,2024-02-01,HA,4544,MSP,SEA,"Minneapolis, MN",Minnesota,"Seattle, WA",Washington,1969,1554,6,5,1975,1559,18,5,1993,1554,1451,182,202,205,0,,0,0.0,0.0,0.0,0.0,0.0
2024,6,9,7,2024-06-09,HA,3523,HNL,BOS,"Honolulu, HI",Hawaii,"Boston, MA",Massachusetts,1746,962,21,20,1767,982,16,13,1783,969,1638,197,217,226,0,,0,1.0,3.0,0.0,0.0,16.0
2024,10,10,4,2024-10-10,UA,7279,CLT,IAD,"Charlotte, NC",North Carolina,"Washington, DC",District of Columbia,1154,1994,-17,-15,1137,1979,8,19,1145,1960,1557,190,210,217,0,,0,0.0,0.0,0.0,0.0,0.0
2024,4,15,1,2024-04-15,OO,3659,TPA,EWR,"Tampa, FL",Florida,"Newark, NJ",New Jersey,1465,931,4,-5,1469,926,13,3,1482,923,979,125,145,141,0,,0,0.0,0.0,0.0,0.0,0.0
2024,4,14,7,2024-04-14,G4,9848,ORD,MDW,"Chicago, IL",Illinois,"Chicago, IL",Illinois,1628,1520,16,10,1644,1530,22,13,1666,1517,1202,144,164,179,0,,0,0.0,0.0,0.0,0.0,0.0
2024,8,15,4,2024-08-15,B6,2786,EWR,SFO,"Newark, NJ",New Jersey,"San Francisco, CA",California,1021,1307,9,5,1030,1312,14,6,1044,1306,260,28,48,48,0,,0,0.0,0.0,0.0,0.0,0.0
2024,7,6,6,2024-07-06,B6,2432,DTW,SLC,"Detroit, MI",Michigan,"Salt Lake City, UT",Utah,1468,2049,17,15,1485,2064,11,18,1496,2046,2157,268,288,297,0,,0,0.0,0.0,0.0,0.0,0.0
2024,3,10,7,2024-03-10,OO,6166,ATL,SLC,"Atlanta, GA",Georgia,"Salt Lake City, UT",Utah,2277,1443,-17,-20,2260,1423,9,4,2269,1419,852,113,133,126,0,,0,0.0,0.0,0.0,0.0,0.0
2024,11,13,3,2024-11-13,YX,1756,DEN,PHX,"Denver, CO",Colorado,"Phoenix, AZ",Arizona,1500,2078,7,10,1507,2088,19,5,1526,2083,1689,203,223,227,0,,0,0.0,0.0,0.0,0.0,0.0
2024,10,16,3,2024-10-16,WN,6879,JFK,ORD,"New York, NY",New York,"Chicago, IL",Illinois,1387,1294,7,5,1394,1299,17,8,1411,1291,2410,303,323,328,0,,0,0.0,0.0,0.0,0.0,0.0
2024,3,27,3,2024-03-27,G4,6138,PHX,BWI,"Phoenix, AZ",Arizona,"Baltimore, MD",Maryland,1906,1021,2,10,1908,1031,18,3,1926,1028,2980,374,394,395,0,,0,0.0,0.0,0.0,0.0,0.0
2024,12,27,5,2024-12-27,F9,8836,PDX,IAH,"Portland, OR",Oregon,"Houston, TX",Texas,1637,1362,-3,0,1634,1362,29,7,1663,1355,1541,198,218,234,0,,0,0.0,0.0,0.0,0.0,0.0
2024,2,25,7,2024-02-25,YX,8683,SEA,BOS,"Seattle, WA",Washington,"Boston, MA",Massachusetts,1244,1335,-20,-15,1224,1320,8,14,1232,1306,219,32,52,54,0,,0,0.0,0.0,0.0,0.0,0.0
2024,4,22,1,2024-04-22,WN,5389,MDW,HNL,"Chicago, IL",Illinois,"Honolulu, HI",Hawaii,1592,1794,0,0,1592,1794,10,7,1602,1787,2089,269,289,286,0,,0,0.0,0.0,0.0,0.0,0.0
2024,1,13,6,2024-01-13,WN,6320,SAN,PHX,"San Diego, CA",California,"Phoenix, AZ",Arizona,1888,1309,-6,-5,1882,1304,19,3,1901,1301,2314,287,307,309,0,,0,0.0,0.0,0.0,0.0,0.0
2024,1,18,4,2024-01-18,DL,396,TPA,MDW,"Tampa, FL",Florida,"Chicago, IL",Illinois,1567,848,-3,0,1564,848,17,7,1581,841,581,78,98,102,0,,0,0.0,0.0,0.0,0.0,0.0
2024,6,30,7,2024-06-30,G4,6573,HNL,LAS,"Honolulu, HI",Hawaii,"Las Vegas, NV",Nevada,2204,780,2,5,2206,785,17,5,2223,780,1926,247,267,269,0,,0,0.0,0.0,0.0,0.0,0.0
2024,4,22,1,2024-04-22,UA,1186,SAN,SFO,"San Diego, CA",California,"San Francisco, CA",California,710,2098,-4,0,706,2098,22,3,728,2095,1071,130,150,155,0,,0,0.0,0.0,0.0,0.0,0.0
2024,8,16,5,2024-08-16,WN,6459,IAD,PHX,"Washington, DC",District of Columbia,"Phoenix, AZ",Arizona,775,1082,-2,-10,773,1072,21,12,794,1060,1062,123,143,156,0,,0,0.0,0.0,0.0,0.0,0.0
2024,6,19,3,2024-06-19,OH,5294,BWI,MSP,"Baltimore, MD",Maryland,"Minneapolis, MN",Minnesota,1630,2007,1,0,1631,2007,5,17,1636,1990,1855,236,256,258,0,,0,0.0,0.0,0.0,0.0,0.0
2024,10,21,1,2024-10-21,NK,5905,EWR,PDX,"Newark, NJ",New Jersey,"Portland, OR",Oregon,978,1388,-23,-15,955,1373,8,13,963,1360,782,92,112,113,0,,0,0.0,0.0,0.0,0.0,0.0
2024,7,7,7,2024-07-07,9E,6822,PDX,DEN,"Portland, OR",Oregon,"Denver, CO",Colorado,2202,2027,-20,-20,2182,2007,15,5,2197,2002,2877,357,377,377,0,,0,0.0,0.0,0.0,0.0,0.0
2024,3,19,2,2024-03-19,F9,9408,ORD,IAH,"Chicago, IL",Illinois,"Houston, TX",Texas,704,1784,-3,-5,701,1779,29,9,730,1770,900,119,139,157,0,,0,0.0,0.0,0.0,0.0,0.0
2024,5,25,6,2024-05-25,F9,9368,DTW,MSP,"Detroit, MI",Michigan,"Minneapolis, MN",Minnesota,618,847,10,5,628,852,23,9,651,843,1212,149,169,181,0,,0,0.0,0.0,0.0,0.0,0.0
2024,6,30,7,2024-06-30,WN,595,DCA,DEN,"Washington, DC",District of Columbia,"Denver, CO",Colorado,985,918,8,10,993,928,17,14,1010,914,2553,328,348,359,0,,0,0.0,0.0,0.0,0.0,0.0
2024,10,12,6,2024-10-12,HA,3095,CLT,LAS,"Charlotte, NC",North Carolina,"Las Vegas, NV",Nevada,608,1563,5,0,613,1563,20,3,633,1560,1410,168,188,191,1,,0,0.0,0.0,0.0,0.0,0.0
2024,9,6,5,2024-09-06,NK,193,LGA,SLC,"New York, NY",New York,"Salt Lake City, UT",Utah,953,1299,4,10,957,1309,23,5,980,1304,2776,340,360,368,0,,0,0.0,0.0,0.0,0.0,0.0
2024,12,19,4,2024-12-19,9E,4424,HNL,ORD,"Honolulu, HI",Hawaii,"Chicago, IL",Illinois,1762,1130,-18,-15,1744,1115,19,16,1763,1099,1019,124,144,159,0,,0,0.0,0.0,0.0,0.0,0.0
2024,11,9,6,2024-11-09,AA,6493,SLC,IAD,"Salt Lake City, UT",Utah,"Washington, DC",District of Columbia,1531,1736,21,20,1552,1756,16,11,1568,1745,1274,155,175,182,0,,0,5.0,1.0,1.0,0.0,13.0
2024,7,14,7,2024-07-14,AS,5610,LAX,MCO,"Los Angeles, CA",California,"Orlando, FL",Florida,1011,1162,7,15,1018,1177,27,15,1045,1162,2828,359,379,401,0,,0,0.0,0.0,0.0,0.0,0.0
2024,11,18,1,2024-11-18,AS,820,PHL,CLT,"Philadelphia, PA",Pennsylvania,"Charlotte, NC",North Carolina,1566,1967,-8,0,1558,1967,12,7,1570,1960,799,106,126,125,0,,0,0.0,0.0,0.0,0.0,0.0
2024,3,11,1,2024-03-11,AS,5175,SEA,PDX,"Seattle, WA",Washington,"Portland, OR",Oregon,1917,722,-13,-15,1904,707,26,5,1930,702,2966,374,394,405,0,,0,0.0,0.0,0.0,0.0,0.0
2024,9,4,3,2024-09-04,YX,6425,JFK,ORD,"New York, NY",New York,"Chicago, IL",Illinois,631,1349,-8,0,623,1349,5,19,628,1330,1673,216,236,240,0,,0,0.0,0.0,0.0,0.0,0.0
2024,5,25,6,2024-05-25,DL,5199,HNL,PHX,"Honolulu, HI",Hawaii,"Phoenix, AZ",Arizona,2241,918,-12,-10,2229,908,26,6,2255,902,2944,372,392,404,0,,0,0.0,0.0,0.0,0.0,0.0
2024,4,15,1,2024-04-15,F9,4126,MCO,DEN,"Orlando, FL",Florida,"Denver, CO",Colorado,1250,2197,-10,0,1240,2197,12,12,1252,2185,284,32,52,56,0,,0,0.0,0.0,0.0,0.0,0.0
2024,9,19,4,2024-09-19,OH,5157,MIA,SLC,"Miami, FL",Florida,"Salt Lake City, UT",Utah,893,2101,-15,-10,878,2091,9,7,887,2084,2860,351,371,367,0,,0,0.0,0.0,0.0,0.0,0.0
2024,10,22,2,2024-10-22,HA,6910,DEN,ATL,"Denver, CO",Colorado,"Atlanta, GA",Georgia,2081,2036,8,0,2089,2036,28,11,2117,2025,2106,271,291,310,0,,0,0.0,0.0,0.0,0.0,0.0
2024,3,10,7,2024-03-10,HA,1206,CLT,PHX,"Charlotte, NC",North Carolina,"Phoenix, AZ",Arizona,697,1185,-5,-10,692,1175,5,18,697,1157,841,112,132,135,0,,0,0.0,0.0,0.0,0.0,0.0
2024,7,11,4,2024-07-11,B6,5405,ATL,STL,"Atlanta, GA",Georgia,"St. Louis, MO",Missouri,1987,844,-20,-10,1967,834,16,14,1983,820,416,53,73,83,0,,0,0.0,0.0,0.0,0.0,0.0
2024,3,8,5,2024-03-08,B6,7834,ORD,EWR,"Chicago, IL",Illinois,"Newark, NJ",New Jersey,1644,1143,-11,-10,1633,1133,8,19,1641,1114,994,132,152,159,0,,0,0.0,0.0,0.0,0.0,0.0
2024,10,31,4,2024-10-31,DL,6774,MCO,PDX,"Orlando, FL",Florida,"Portland, OR",Oregon,1823,2080,-29,-20,1794,2060,19,10,1813,2050,2299,281,301,310,0,,0,0.0,0.0,0.0,0.0,0.0
2024,2,21,3,2024-02-21,WN,9663,DCA,SFO,"Washington, DC",District of Columbia,"San Francisco, CA",California,719,752,-3,5,716,757,13,15,729,742,2876,358,378,386,1,,0,0.0,0.0,0.0,0.0,0.0
2024,12,28,6,2024-12-28,YX,8714,SAN,BOS,"San Diego, CA",California,"Boston, MA",Massachusetts,1367,1255,-9,-5,1358,1250,14,17,1372,1233,762,100,120,131,0,,0,0.0,0.0,0.0,0.0,0.0
2024,10,11,5,2024-10-11,G4,2105,JFK,MDW,"New York, NY",New York,"Chicago, IL",Illinois,593,614,0,5,593,619,25,11,618,608,877,101,121,137,0,,0,0.0,0.0,0.0,0.0,0.0
2024,11,29,5,2024-11-29,G4,5361,MSP,LGA,"Minneapolis, MN",Minnesota,"New York, NY",New York,1815,2066,9,5,1824,2071,17,3,1841,2068,1242,149,169,169,0,,0,0.0,0.0,0.0,0.0,0.0
2024,1,9,2,2024-01-09,AS,863,DCA,DTW,"Washington, DC",District of Columbia,"Detroit, MI",Michigan,652,1927,-24,-15,628,1912,14,17,642,1895,817,111,131,142,0,,0,0.0,0.0,0.0,0.0,0.0
2024,9,7,6,2024-09-07,OO,9189,SFO,MCO,"San Francisco, CA",California,"Orlando, FL",Florida,1024,844,1,-5,1025,839,14,5,1039,834,357,45,65,64,0,,0,0.0,0.0,0.0,0.0,0.0
2024,11,27,3,2024-11-27,HA,9244,DEN,MSP,"Denver, CO",Colorado,"Minneapolis, MN",Minnesota,1218,1390,8,0,1226,1390,18,17,1244,1373,696,77,97,112,0,,0,0.0,0.0,0.0,0.0,0.0
2024,10,24,4,2024-10-24,G4,5791,SAN,JFK,"San Diego, CA",California,"New York, NY",New York,1266,1166,18,15,1284,1181,23,13,1307,1168,2321,282,302,318,0,,0,0.0,0.0,0.0,0.0,0.0
2024,7,2,2,2024-07-02,WN,7159,ORD,MDW,"Chicago, IL",Illinois,"Chicago, IL",Illinois,1945,1153,1,-5,1946,1148,23,11,1969,1137,2068,256,276,290,0,,0,0.0,0.0,0.0,0.0,0.0
2024,6,27,4,2024-06-27,HA,4579,SEA,SLC,"Seattle, WA",Washington,"Salt Lake City, UT",Utah,1681,1498,8,0,1689,1498,29,5,1718,1493,1876,237,257,271,0,,0,0.0,0.0,0.0,0.0,0.0
2024,7,16,2,2024-07-16,OO,4298,BWI,JFK,"Baltimore, MD",Maryland,"New York, NY",New York,1793,2078,-4,5,1789,2083,5,15,1794,2068,2146,274,294,294,0,,0,0.0,0.0,0.0,0.0,0.0
2024,5,7,2,2024-05-07,AA,9191,LAX,PHX,"Los Angeles, CA",California,"Phoenix, AZ",Arizona,1317,1982,15,10,1332,1992,26,8,1358,1984,346,48,68,82,0,,0,0.0,0.0,0.0,0.0,0.0
2024,1,20,6,2024-01-20,DL,4123,STL,MSP,"St. Louis, MO",Missouri,"Minneapolis, MN",Minnesota,2103,651,24,15,2127,666,26,8,2153,658,684,92,112,126,0,,0,0.0,0.0,0.0,0.0,0.0
2024,11,23,6,2024-11-23,MQ,4305,HNL,MCO,"Honolulu, HI",Hawaii,"Orlando, FL",Florida,756,610,5,0,761,610,28,13,789,597,470,57,77,98,0,,0,0.0,0.0,0.0,0.0,0.0
2024,3,5,2,2024-03-05,AA,3741,DEN,DCA,"Denver, CO",Colorado,"Washington, DC",District of Columbia,1200,1422,-18,-10,1182,1412,12,11,1194,1401,2147,269,289,292,0,,0,0.0,0.0,0.0,0.0,0.0
2024,6,30,7,2024-06-30,F9,3643,BOS,DFW,"Boston, MA",Massachusetts,"Dallas/Fort Worth, TX",Texas,1014,2223,8,5,1022,2228,21,19,1043,2209,2603,319,339,359,0,,0,0.0,0.0,0.0,0.0,0.0
2024,8,28,3,2024-08-28,G4,5691,DFW,EWR,"Dallas/Fort Worth, TX",Texas,"Newark, NJ",New Jersey,1760,826,-19,-15,1741,811,27,19,1768,792,2019,260,280,306,0,,0,0.0,0.0,0.0,0.0,0.0
2024,1,24,3,2024-01-24,9E,7343,SLC,MDW,"Salt Lake City, UT",Utah,"Chicago, IL",Illinois,944,713,-6,-5,938,708,14,11,952,697,2809,358,378,383,0,,0,0.0,0.0,0.0,0.0,0.0
2024,3,23,6,2024-03-23,YX,6216,DTW,SFO,"Detroit, MI",Michigan,"San Francisco, CA",California,2167,2160,-2,0,2165,2160,5,5,2170,2155,1000,125,145,135,0,,0,0.0,0.0,0.0,0.0,0.0
2024,11,14,4,2024-11-14,AS,6433,IAH,ATL,"Houston, TX",Texas,"Atlanta, GA",Georgia,670,1203,2,5,672,1208,12,16,684,1192,2035,251,271,279,0,,0,0.0,0.0,0.0,0.0,0.0
2024,7,3,3,2024-07-03,DL,861,SEA,MCO,"Seattle, WA",Washington,"Orlando, FL",Florida,769,1710,9,5,778,1715,9,17,787,1698,2302,277,297,303,1,,0,0.0,0.0,0.0,0.0,0.0
2024,11,11,1,2024-11-11,AS,2507,PHL,MCO,"Philadelphia, PA",Pennsylvania,"Orlando, FL",Florida,1100,1192,-9,-10,1091,1182,6,3,1097,1179,2368,291,311,300,0,,0,0.0,0.0,0.0,0.0,0.0
2024,4,8,1,2024-04-08,G4,985,IAH,PHL,"Houston, TX",Texas,"Philadelphia, PA",Pennsylvania,2138,1873,25,30,2163,1903,23,6,2186,1897,1565,197,217,226,0,,0,4.0,6.0,1.0,0.0,19.0
2024,3,2,6,2024-03-02,YX,6322,SAN,EWR,"San Diego, CA",California,"Newark, NJ",New Jersey,1136,1873,-6,-10,1130,1863,29,17,1159,1846,1104,142,162,188,0,,0,0.0,0.0,0.0,0.0,0.0
2024,10,12,6,2024-10-12,UA,2743,BWI,IAH,"Baltimore, MD",Maryland,"Houston, TX",Texas,566,1536,-11,-15,555,1521,6,17,561,1504,1259,149,169,172,0,,0,0.0,0.0,0.0,0.0,0.0
2024,1,22,1,2024-01-22,G4,9527,BWI,MIA,"Baltimore, MD",Maryland,"Miami, FL",Florida,1274,2044,2,5,1276,2049,24,5,1300,2044,2445,307,327,336,0,,0,0.0,0.0,0.0,0.0,0.0
2024,7,30,2,2024-07-30,DL,5210,LAX,BOS,"Los Angeles, CA",California,"Boston, MA",Massachusetts,507,809,16,15,523,824,27,7,550,817,841,111,131,145,0,,0,0.0,0.0,0.0,0.0,0.0
2024,5,5,7,2024-05-05,OO,1568,PHL,MSP,"Philadelphia, PA",Pennsylvania,"Minneapolis, MN",Minnesota,2079,1550,9,0,2088,1550,28,3,2116,1547,1394,180,200,211,0,,0,0.0,0.0,0.0,0.0,0.0
2024,2,11,7,2024-02-11,B6,6392,TPA,MIA,"Tampa, FL",Florida,"Miami, FL",Florida,1971,2144,-9,0,1962,2144,15,18,1977,2126,1377,172,192,205,0,,0,0.0,0.0,0.0,0.0,0.0
2024,4,7,7,2024-04-07,OO,8301,PHX,BWI,"Phoenix, AZ",Arizona,"Baltimore, MD",Maryland,634,1604,-2,0,632,1604,7,18,639,1586,780,98,118,123,0,,0,0.0,0.0,0.0,0.0,0.0
2024,1,31,3,2024-01-31,DL,5761,LAX,HNL,"Los Angeles, CA",California,"Honolulu, HI",Hawaii,2283,1210,-23,-20,2260,1190,13,18,2273,1172,1502,179,199,210,0,,0,0.0,0.0,0.0,0.0,0.0
2024,6,6,4,2024-06-06,NK,9083,PHL,DCA,"Philadelphia, PA",Pennsylvania,"Washington, DC",District of Columbia,1315,2171,2,5,1317,2176,12,17,1329,2159,772,91,111,120,0,,0,0.0,0.0,0.0,0.0,0.0
2024,4,21,7,2024-04-21,OO,6163,STL,CLT,"St. Louis, MO",Missouri,"Charlotte, NC",North Carolina,1329,1680,-12,-5,1317,1675,10,7,1327,1668,1578,193,213,210,0,,0,0.0,0.0,0.0,0.0,0.0
2024,9,3,2,2024-09-03,9E,7115,IAH,TPA,"Houston, TX",Texas,"Tampa, FL",Florida,524,1686,9,15,533,1701,18,4,551,1697,2236,288,308,310,0,,0,0.0,0.0,0.0,0.0,0.0
2024,5,1,3,2024-05-01,HA,9954,SLC,IAH,"Salt Lake City, UT",Utah,"Houston, TX",Texas,964,937,-4,-10,960,927,12,10,972,917,2288,294,314,316,0,,0,0.0,0.0,0.0,0.0,0.0
2024,9,29,7,2024-09-29,G4,6423,JFK,MIA,"New York, NY",New York,"Miami, FL",Florida,873,1324,-9,-5,864,1319,19,17,883,1302,2600,317,337,353,0,,0,0.0,0.0,0.0,0.0,0.0
2024,10,20,7,2024-10-20,NK,9035,DEN,SAN,"Denver, CO",Colorado,"San Diego, CA",California,695,1414,-10,0,685,1414,28,11,713,1403,993,133,153,172,0,,0,0.0,0.0,0.0,0.0,0.0
2024,7,25,4,2024-07-25,YX,2528,DEN,MCO,"Denver, CO",Colorado,"Orlando, FL",Florida,1203,1131,-1,0,1202,1131,7,11,1209,1120,1304,171,191,189,0,,0,0.0,0.0,0.0,0.0,0.0
2024,4,19,5,2024-04-19,B6,9408,LAX,SAN,"Los Angeles, CA",California,"San Diego, CA",California,901,1358,-2,-5,899,1353,27,5,926,1348,1623,204,224,236,0,,0,0.0,0.0,0.0,0.0,0.0
2024,10,4,5,2024-10-04,HA,7208,BOS,PHL,"Boston, MA",Massachusetts,"Philadelphia, PA",Pennsylvania,621,605,3,-5,624,600,12,17,636,583,1350,161,181,190,0,,0,0.0,0.0,0.0,0.0,0.0
2024,2,25,7,2024-02-25,WN,1454,PHX,MIA,"Phoenix, AZ",Arizona,"Miami, FL",Florida,1271,1184,-17,-15,1254,1169,26,19,1280,1150,499,57,77,102,0,,0,0.0,0.0,0.0,0.0,0.0
2024,2,26,1,2024-02-26,YX,5927,TPA,DTW,"Tampa, FL",Florida,"Detroit, MI",Michigan,1058,1218,10,10,1068,1228,20,3,1088,1225,357,48,68,71,0,,0,0.0,0.0,0.0,0.0,0.0
2024,10,17,4,2024-10-17,WN,2580,PHL,IAD,"Philadelphia, PA",Pennsylvania,"Washington, DC",District of Columbia,1732,2228,-4,-5,1728,2223,10,13,1738,2210,329,42,62,65,0,,0,0.0,0.0,0.0,0.0,0.0
2024,4,23,2,2024-04-23,HA,1286,MSP,MIA,"Minneapolis, MN",Minnesota,"Miami, FL",Florida,1824,2134,-10,0,1814,2134,11,3,1825,2131,1035,129,149,143,0,,0,0.0,0.0,0.0,0.0,0.0
2024,11,3,7,2024-11-03,9E,7009,SFO,SEA,"San Francisco, CA",California,"Seattle, WA",Washington,2124,1396,9,0,2133,1396,17,8,2150,1388,749,92,112,117,0,,0,0.0,0.0,0.0,0.0,0.0
2024,12,6,5,2024-12-06,F9,4187,SFO,CLT,"San Francisco, CA",California,"Charlotte, NC",North Carolina,1453,2084,6,0,1459,2084,24,14,1483,2070,1374,170,190,208,0,,0,0.0,0.0,0.0,0.0,0.0
2024,7,16,2,2024-07-16,9E,6328,MSP,PHL,"Minneapolis, MN",Minnesota,"Philadelphia, PA",Pennsylvania,2038,955,-5,5,2033,960,13,16,2046,944,2276,280,300,309,0,,0,0.0,0.0,0.0,0.0,0.0
2024,11,16,6,2024-11-16,MQ,2931,TPA,DTW,"Tampa, FL",Florida,"Detroit, MI",Michigan,1407,818,-10,0,1397,818,23,15,1420,803,695,80,100,118,0,,0,0.0,0.0,0.0,0.0,0.0
2024,6,27,4,2024-06-27,9E,3761,SLC,DFW,"Salt Lake City, UT",Utah,"Dallas/Fort Worth, TX",Texas,2180,966,-3,-10,2177,956,11,13,2188,943,1280,161,181,185,0,,0,0.0,0.0,0.0,0.0,0.0
2024,8,6,2,2024-08-06,OH,1848,IAD,LAS,"Washington, DC",District of Columbia,"Las Vegas, NV",Nevada,2057,1488,-2,0,2055,1488,20,19,2075,1469,400,42,62,81,0,,0,0.0,0.0,0.0,0.0,0.0
2024,10,3,4,2024-10-03,9E,8034,DEN,PDX,"Denver, CO",Colorado,"Portland, OR",Oregon,1562,1160,-4,-10,1558,1150,29,7,1587,1143,1444,179,199,215,0,,0,0.0,0.0,0.0,0.0,0.0
2024,1,16,2,2024-01-16,9E,9406,MIA,DFW,"Miami, FL",Florida,"Dallas/Fort Worth, TX",Texas,1118,963,2,0,1120,963,28,8,1148,955,2601,324,344,360,0,,0,0.0,0.0,0.0,0.0,0.0
2024,3,1,5,2024-03-01,9E,7652,LGA,DTW,"New York, NY",New York,"Detroit, MI",Michigan,2135,2013,1,-5,2136,2008,11,10,2147,1998,1048,126,146,147,0,,0,0.0,0.0,0.0,0.0,0.0
2024,2,23,5,2024-02-23,AA,3364,MDW,DCA,"Chicago, IL",Illinois,"Washington, DC",District of Columbia,1240,1918,-20,-20,1220,1898,19,6,1239,1892,937,121,141,146,0,,0,0.0,0.0,0.0,0.0,0.0
2024,6,16,7,2024-06-16,B6,5472,LGA,IAH,"New York, NY",New York,"Houston, TX",Texas,1446,1104,11,5,1457,1109,9,3,1466,1106,2186,274,294,286,0,,0,0.0,0.0,0.0,0.0,0.0
2024,1,26,5,2024-01-26,OH,5874,TPA,PHL,"Tampa, FL",Florida,"Philadelphia, PA",Pennsylvania,1296,1911,-12,-10,1284,1901,6,17,1290,1884,1113,134,154,157,0,,0,0.0,0.0,0.0,0.0,0.0
2024,12,1,7,2024-12-01,DL,5463,IAH,DCA,"Houston, TX",Texas,"Washington, DC",District of Columbia,705,776,18,15,723,791,6,9,729,782,1708,222,242,237,0,,0,0.0,0.0,0.0,0.0,0.0
2024,3,5,2,2024-03-05,MQ,7991,CLT,BWI,"Charlotte, NC",North Carolina,"Baltimore, MD",Maryland,1082,1922,-20,-10,1062,1912,24,18,1086,1894,2219,283,303,325,0,,0,0.0,0.0,0.0,0.0,0.0
2024,4,9,2,2024-04-09,OO,6950,PDX,SFO,"Portland, OR",Oregon,"San Francisco, CA",California,2204,2243,57,60,2261,2303,9,8,2270,2295,2052,258,278,275,0,,0,21.0,13.0,8.0,1.0,17.0
2024,3,14,4,2024-03-14,G4,1163,LAX,PHX,"Los Angeles, CA",California,"Phoenix, AZ",Arizona,1196,1907,-9,0,1187,1907,16,9,1203,1898,2030,249,269,274,0,,0,0.0,0.0,0.0,0.0,0.0
2024,7,10,3,2024-07-10,NK,6759,MSP,BWI,"Minneapolis, MN",Minnesota,"Baltimore, MD",Maryland,911,1412,-27,-20,884,1392,8,8,892,1384,974,118,138,134,0,,0,0.0,0.0,0.0,0.0,0.0
2024,6,19,3,2024-06-19,9E,3848,MDW,EWR,"Chicago, IL",Illinois,"Newark, NJ",New Jersey,1856,1176,-8,-15,1848,1161,22,15,1870,1146,286,44,64,81,0,,0,0.0,0.0,0.0,0.0,0.0
2024,9,29,7,2024-09-29,F9,4645,DFW,LGA,"Dallas/Fort Worth, TX",Texas,"New York, NY",New York,707,1417,-13,-15,694,1402,24,4,718,1398,1324,162,182,190,0,,0,0.0,0.0,0.0,0.0,0.0
2024,7,5,5,2024-07-05,AS,2832,SAN,DCA,"San Diego, CA",California,"Washington, DC",District of Columbia,904,1677,-12,-15,892,1662,15,7,907,1655,579,73,93,95,0,,0,0.0,0.0,0.0,0.0,0.0
2024,1,23,2,2024-01-23,G4,1972,CLT,TPA,"Charlotte, NC",North Carolina,"Tampa, FL",Florida,887,1418,-10,-10,877,1408,25,5,902,1403,315,38,58,68,0,,0,0.0,0.0,0.0,0.0,0.0
2024,6,29,6,2024-06-29,AS,4820,IAD,MIA,"Washington, DC",District of Columbia,"Miami, FL",Florida,2010,1943,-5,-5,2005,1938,24,11,2029,1927,2070,260,280,295,0,,0,0.0,0.0,0.0,0.0,0.0
2024,11,22,5,2024-11-22,NK,2069,HNL,DCA,"Honolulu, HI",Hawaii,"Washington, DC",District of Columbia,1905,1078,-18,-15,1887,1063,10,5,1897,1058,1631,210,230,225,0,,0,0.0,0.0,0.0,0.0,0.0
2024,4,17,3,2024-04-17,NK,9176,STL,SEA,"St. Louis, MO",Missouri,"Seattle, WA",Washington,1366,2165,-4,-5,1362,2160,17,14,1379,2146,2668,333,353,364,0,,0,0.0,0.0,0.0,0.0,0.0
2024,11,30,6,2024-11-30,G4,418,EWR,IAH,"Newark, NJ",New Jersey,"Houston, TX",Texas,770,1321,-15,-5,755,1316,27,5,782,1311,415,44,64,76,0,,0,0.0,0.0,0.0,0.0,0.0
2024,6,10,1,2024-06-10,OO,3817,LAS,EWR,"Las Vegas, NV",Nevada,"Newark, NJ",New Jersey,936,1844,5,0,941,1844,9,19,950,1825,2197,275,295,303,0,,0,0.0,0.0,0.0,0.0,0.0
2024,10,28,1,2024-10-28,F9,5591,SEA,ATL,"Seattle, WA",Washington,"Atlanta, GA",Georgia,1357,2305,-3,-10,1354,2295,29,17,1383,2278,2756,347,367,393,0,,0,0.0,0.0,0.0,0.0,0.0
2024,7,24,3,2024-07-24,MQ,1474,DCA,JFK,"Washington, DC",District of Columbia,"New York, NY",New York,1953,1966,5,15,1958,1981,8,19,1966,1962,1128,139,159,166,0,,0,0.0,0.0,0.0,0.0,0.0
2024,3,18,1,2024-03-18,AA,5542,SFO,ORD,"San Francisco, CA",California,"Chicago, IL",Illinois,2170,1837,9,0,2179,1837,14,9,2193,1828,1609,193,213,216,0,,0,0.0,0.0,0.0,0.0,0.0
2024,1,16,2,2024-01-16,WN,8779,TPA,SEA,"Tampa, FL",Florida,"Seattle, WA",Washington,2181,1945,7,0,2188,1945,6,11,2194,1934,404,58,78,75,0,,0,0.0,0.0,0.0,0.0,0.0
2024,11,22,5,2024-11-22,NK,550,CLT,BWI,"Charlotte, NC",North Carolina,"Baltimore, MD",Maryland,844,1180,-21,-20,823,1160,12,4,835,1156,2917,360,380,376,0,,0,0.0,0.0,0.0,0.0,0.0
2024,4,5,5,2024-04-05,OO,8644,MCO,IAD,"Orlando, FL",Florida,"Washington, DC",District of Columbia,648,1345,0,0,648,1345,24,19,672,1326,1193,144,164,187,0,,0,0.0,0.0,0.0,0.0,0.0
2024,5,26,7,2024-05-26,F9,7280,SEA,LAS,"Seattle, WA",Washington,"Las Vegas, NV",Nevada,1127,1638,0,-5,1127,1633,24,16,1151,1617,1810,221,241,261,1,,0,0.0,0.0,0.0,0.0,0.0
2024,1,2,2,2024-01-02,NK,2040,IAD,LAS,"Washington, DC",District of Columbia,"Las Vegas, NV",Nevada,1915,2103,9,15,1924,2118,7,19,1931,2099,1196,149,169,175,0,,0,0.0,0.0,0.0,0.0,0.0
2024,1,10,3,2024-01-10,YX,2467,DFW,ATL,"Dallas/Fort Worth, TX",Texas,"Atlanta, GA",Georgia,686,1477,0,10,686,1487,13,13,699,1474,595,73,93,99,0,,0,0.0,0.0,0.0,0.0,0.0
2024,5,4,6,2024-05-04,UA,7987,HNL,JFK,"Honolulu, HI",Hawaii,"New York, NY",New York,519,733,7,0,526,733,24,3,550,730,1817,228,248,255,0,,0,0.0,0.0,0.0,0.0,0.0
2024,3,21,4,2024-03-21,HA,347,EWR,IAH,"Newark, NJ",New Jersey,"Houston, TX",Texas,1861,1317,1,5,1862,1322,6,3,1868,1319,532,65,85,74,0,,0,0.0,0.0,0.0,0.0,0.0
2024,5,19,7,2024-05-19,WN,3603,PHX,SAN,"Phoenix, AZ",Arizona,"San Diego, CA",California,872,1647,-10,0,862,1647,21,17,883,1630,2125,272,292,310,0,,0,0.0,0.0,0.0,0.0,0.0
2024,11,21,4,2024-11-21,YX,8859,TPA,CLT,"Tampa, FL",Florida,"Charlotte, NC",North Carolina,1478,976,-29,-20,1449,956,5,4,1454,952,2180,266,286,275,0,,0,0.0,0.0,0.0,0.0,0.0
2024,5,29,3,2024-05-29,NK,8975,PHX,HNL,"Phoenix, AZ",Arizona,"Honolulu, HI",Hawaii,2279,2220,-4,5,2275,2225,28,14,2303,2211,2216,278,298,320,0,,0,0.0,0.0,0.0,0.0,0.0
2024,10,14,1,2024-10-14,F9,8935,PHL,IAD,"Philadelphia, PA",Pennsylvania,"Washington, DC",District of Columbia,566,1765,-5,-10,561,1755,21,15,582,1740,633,86,106,122,0,,0,0.0,0.0,0.0,0.0,0.0
2024,12,26,4,2024-12-26,NK,578,LGA,HNL,"New York, NY",New York,"Honolulu, HI",Hawaii,1962,1251,2,5,1964,1256,9,12,1973,1244,1739,221,241,242,0,,0,0.0,0.0,0.0,0.0,0.0
2024,12,5,4,2024-12-05,AS,2860,MDW,ATL,"Chicago, IL",Illinois,"Atlanta, GA",Georgia,1585,2062,-21,-20,1564,2042,17,4,1581,2038,1099,145,165,166,0,,0,0.0,0.0,0.0,0.0,0.0
2024,5,8,3,2024-05-08,G4,8068,LAS,MSP,"Las Vegas, NV",Nevada,"Minneapolis, MN",Minnesota,2009,1947,4,-5,2013,1942,12,4,2025,1938,1900,233,253,249,0,,0,0.0,0.0,0.0,0.0,0.0
2024,8,26,1,2024-08-26,G4,6040,DEN,MSP,"Denver, CO",Colorado,"Minneapolis, MN",Minnesota,1285,1745,5,0,1290,1745,11,19,1301,1726,1427,168,188,198,0,,0,0.0,0.0,0.0,0.0,0.0
2024,2,27,2,2024-02-27,OO,4552,SLC,STL,"Salt Lake City, UT",Utah,"St. Louis, MO",Missouri,1121,1923,-11,-5,1110,1918,27,11,1137,1907,2107,256,276,294,0,,0,0.0,0.0,0.0,0.0,0.0
2024,7,16,2,2024-07-16,MQ,1468,LAX,DEN,"Los Angeles, CA",California,"Denver, CO",Colorado,2091,1964,-2,5,2089,1969,18,16,2107,1953,2188,267,287,301,0,,0,0.0,0.0,0.0,0.0,0.0
2024,7,29,1,2024-07-29,NK,2326,ATL,MIA,"Atlanta, GA",Georgia,"Miami, FL",Florida,584,1802,2,0,586,1802,12,13,598,1789,1952,245,265,270,1,,0,0.0,0.0,0.0,0.0,0.0
2024,2,14,3,2024-02-14,F9,3712,JFK,IAH,"New York, NY",New York,"Houston, TX",Texas,1929,1831,17,20,1946,1851,15,14,1961,1837,507,68,88,97,0,,0,3.0,2.0,3.0,0.0,12.0
2024,4,6,6,2024-04-06,AS,5662,DTW,SFO,"Detroit, MI",Michigan,"San Francisco, CA",California,2299,765,-3,-5,2296,760,7,9,2303,751,2694,330,350,346,0,,0,0.0,0.0,0.0,0.0,0.0
2024,10,5,6,2024-10-05,AA,1159,MCO,SFO,"Orlando, FL",Florida,"San Francisco, CA",California,1918,1664,-1,5,1917,1669,9,3,1926,1666,790,103,123,115,0,,0,0.0,0.0,0.0,0.0,0.0
2024,1,23,2,2024-01-23,AA,1744,MCO,SLC,"Orlando, FL",Florida,"Salt Lake City, UT",Utah,2142,2257,16,10,2158,2267,22,18,2180,2249,661,74,94,114,0,,0,0.0,0.0,0.0,0.0,0.0
2024,11,30,6,2024-11-30,AS,5365,PHL,DTW,"Philadelphia, PA",Pennsylvania,"Detroit, MI",Michigan,2047,2179,-6,-10,2041,2169,9,17,2050,2152,1951,240,260,266,0,,0,0.0,0.0,0.0,0.0,0.0
2024,2,13,2,2024-02-13,DL,1911,IAD,LAS,"Washington, DC",District of Columbia,"Las Vegas, NV",Nevada,675,1698,1,5,676,1703,17,15,693,1688,2707,346,366,378,0,,0,0.0,0.0,0.0,0.0,0.0
2024,1,27,6,2024-01-27,OH,2293,CLT,PHX,"Charlotte, NC",North Carolina,"Phoenix, AZ",Arizona,858,2103,-6,-5,852,2098,9,8,861,2090,2194,280,300,297,0,,0,0.0,0.0,0.0,0.0,0.0
2024,10,8,2,2024-10-08,F9,267,BWI,MCO,"Baltimore, MD",Maryland,"Orlando, FL",Florida,1330,1971,-23,-15,1307,1956,6,4,1313,1952,552,69,89,79,0,,0,0.0,0.0,0.0,0.0,0.0
2024,4,6,6,2024-04-06,AA,7542,DTW,PHL,"Detroit, MI",Michigan,"Philadelphia, PA",Pennsylvania,2062,871,-15,-20,2047,851,17,11,2064,840,1172,149,169,177,0,,0,0.0,0.0,0.0,0.0,0.0
2024,2,5,1,2024-02-05,MQ,4282,EWR,PHL,"Newark, NJ",New Jersey,"Philadelphia, PA",Pennsylvania,790,1589,14,5,804,1594,10,3,814,1591,1888,228,248,241,0,,0,0.0,0.0,0.0,0.0,0.0
2024,4,18,4,2024-04-18,DL,8445,STL,IAH,"St. Louis, MO",Missouri,"Houston, TX",Texas,629,765,-6,-10,623,755,21,11,644,744,1199,155,175,187,0,,0,0.0,0.0,0.0,0.0,0.0
2024,2,24,6,2024-02-24,F9,2644,DEN,BOS,"Denver, CO",Colorado,"Boston, MA",Massachusetts,2262,1361,-20,-15,2242,1346,12,12,2254,1334,2967,363,383,387,0,,0,0.0,0.0,0.0,0.0,0.0
2024,7,10,3,2024-07-10,YX,3968,DCA,BWI,"Washington, DC",District of Columbia,"Baltimore, MD",Maryland,978,1709,-1,0,977,1709,21,4,998,1705,456,65,85,90,0,,0,0.0,0.0,0.0,0.0,0.0
2024,8,6,2,2024-08-06,AS,8606,TPA,DFW,"Tampa, FL",Florida,"Dallas/Fort Worth, TX",Texas,1147,1248,-9,-5,1138,1243,23,16,1161,1227,739,93,113,132,0,,0,0.0,0.0,0.0,0.0,0.0
2024,7,3,3,2024-07-03,YX,6050,JFK,IAD,"New York, NY",New York,"Washington, DC",District of Columbia,1031,1444,13,5,1044,1449,19,5,1063,1444,934,114,134,138,0,,0,0.0,0.0,0.0,0.0,0.0
2024,3,9,6,2024-03-09,9E,9014,JFK,EWR,"New York, NY",New York,"Newark, NJ",New Jersey,763,1150,-21,-15,742,1135,5,18,747,1117,811,92,112,115,0,,0,0.0,0.0,0.0,0.0,0.0
2024,11,12,2,2024-11-12,DL,2409,SLC,PHL,"Salt Lake City, UT",Utah,"Philadelphia, PA",Pennsylvania,1458,1198,-19,-15,1439,1183,22,11,1461,1172,564,64,84,97,0,,0,0.0,0.0,0.0,0.0,0.0
2024,5,9,4,2024-05-09,DL,6730,MCO,CLT,"Orlando, FL",Florida,"Charlotte, NC",North Carolina,2194,754,-13,-5,2181,749,11,4,2192,745,1337,166,186,181,0,,0,0.0,0.0,0.0,0.0,0.0
2024,2,24,6,2024-02-24,OO,6786,DFW,SLC,"Dallas/Fort Worth, TX",Texas,"Salt Lake City, UT",Utah,1002,2295,-9,0,993,2295,11,6,1004,2289,510,55,75,72,0,,0,0.0,0.0,0.0,0.0,0.0
2024,4,6,6,2024-04-06,OH,2123,LAS,CLT,"Las Vegas, NV",Nevada,"Charlotte, NC",North Carolina,1683,2199,18,10,1701,2209,20,13,1721,2196,2865,366,386,399,0,,0,0.0,0.0,0.0,0.0,0.0
2024,12,1,7,2024-12-01,NK,449,SAN,SLC,"San Diego, CA",California,"Salt Lake City, UT",Utah,1408,1846,-9,0,1399,1846,15,10,1414,1836,556,76,96,101,0,,0,0.0,0.0,0.0,0.0,0.0
2024,3,27,3,2024-03-27,B6,9115,BOS,DCA,"Boston, MA",Massachusetts,"Washington, DC",District of Columbia,2061,1016,23,15,2084,1031,9,18,2093,1013,1842,224,244,251,0,,0,0.0,0.0,0.0,0.0,0.0
2024,10,20,7,2024-10-20,B6,8729,HNL,MIA,"Honolulu, HI",Hawaii,"Miami, FL",Florida,1604,1985,-3,-10,1601,1975,25,7,1626,1968,329,33,53,65,0,,0,0.0,0.0,0.0,0.0,0.0
2024,4,28,7,2024-04-28,F9,8460,MCO,PHX,"Orlando, FL",Florida,"Phoenix, AZ",Arizona,1936,1969,-10,0,1926,1969,18,4,1944,1965,875,116,136,138,0,,0,0.0,0.0,0.0,0.0,0.0
2024,7,26,5,2024-07-26,YX,8053,TPA,DCA,"Tampa, FL",Florida,"Washington, DC",District of Columbia,974,1769,3,5,977,1774,27,17,1004,1757,2917,367,387,411,0,,0,0.0,0.0,0.0,0.0,0.0
2024,11,29,5,2024-11-29,YX,3401,STL,SEA,"St. Louis, MO",Missouri,"Seattle, WA",Washington,1387,2339,10,5,1397,2344,14,8,1411,2336,443,47,67,69,0,,0,0.0,0.0,0.0,0.0,0.0
2024,6,2,7,2024-06-02,NK,4218,MCO,PDX,"Orlando, FL",Florida,"Portland, OR",Oregon,517,666,27,30,544,696,9,10,553,686,2729,338,358,357,0,,0,10.0,6.0,5.0,0.0,9.0
2024,2,4,7,2024-02-04,YX,6919,TPA,DEN,"Tampa, FL",Florida,"Denver, CO",Colorado,1592,1116,0,0,1592,1116,28,4,1620,1112,1369,178,198,210,0,,0,0.0,0.0,0.0,0.0,0.0
2024,3,19,2,2024-03-19,OH,2869,DEN,LAX,"Denver, CO",Colorado,"Los Angeles, CA",California,1407,1682,0,-5,1407,1677,23,6,1430,1671,829,100,120,129,0,,0,0.0,0.0,0.0,0.0,0.0
2024,3,7,4,2024-03-07,G4,4599,JFK,SAN,"New York, NY",New York,"San Diego, CA",California,629,1606,19,10,648,1616,22,6,670,1610,2376,293,313,321,0,,0,0.0,0.0,0.0,0.0,0.0
2024,12,8,7,2024-12-08,WN,2280,DTW,STL,"Detroit, MI",Michigan,"St. Louis, MO",Missouri,1437,1187,-11,-10,1426,1177,8,14,1434,1163,2421,309,329,331,0,,0,0.0,0.0,0.0,0.0,0.0
2024,2,3,6,2024-02-03,9E,3445,SLC,IAD,"Salt Lake City, UT",Utah,"Washington, DC",District of Columbia,2170,1371,-15,-20,2155,1351,27,3,2182,1348,2783,346,366,376,0,,0,0.0,0.0,0.0,0.0,0.0
2024,4,6,6,2024-04-06,WN,2765,PHL,PDX,"Philadelphia, PA",Pennsylvania,"Portland, OR",Oregon,1314,1359,-3,-5,1311,1354,13,11,1324,1343,476,57,77,81,0,,0,0.0,0.0,0.0,0.0,0.0
2024,6,17,1,2024-06-17,DL,8523,PHX,TPA,"Phoenix, AZ",Arizona,"Tampa, FL",Florida,2253,1639,-14,-10,2239,1629,23,17,2262,1612,2964,362,382,402,0,,0,0.0,0.0,0.0,0.0,0.0
2024,6,17,1,2024-06-17,UA,9350,LAS,DCA,"Las Vegas, NV",Nevada,"Washington, DC",District of Columbia,1833,2210,-15,-5,1818,2205,15,10,1833,2195,1799,222,242,247,0,,0,0.0,0.0,0.0,0.0,0.0
2024,5,30,4,2024-05-30,AA,2642,MDW,DTW,"Chicago, IL",Illinois,"Detroit, MI",Michigan,2010,2109,33,30,2043,2139,7,19,2050,2120,2001,255,275,281,1,,0,6.0,6.0,1.0,0.0,17.0
2024,3,11,1,2024-03-11,AA,9425,CLT,LAS,"Charlotte, NC",North Carolina,"Las Vegas, NV",Nevada,514,775,-7,-5,507,770,15,17,522,753,1876,242,262,274,0,,0,0.0,0.0,0.0,0.0,0.0
2024,1,3,3,2024-01-03,NK,5540,CLT,PHX,"Charlotte, NC",North Carolina,"Phoenix, AZ",Arizona,2019,921,8,5,2027,926,11,12,2038,914,1618,194,214,217,0,,0,0.0,0.0,0.0,0.0,0.0
2024,11,9,6,2024-11-09,OH,8248,TPA,STL,"Tampa, FL",Florida,"St. Louis, MO",Missouri,1709,2084,-17,-10,1692,2074,21,15,1713,2059,301,27,47,63,0,,0,0.0,0.0,0.0,0.0,0.0
2024,2,1,4,2024-02-01,OH,7210,PHX,PHL,"Phoenix, AZ",Arizona,"Philadelphia, PA",Pennsylvania,1940,735,-7,-5,1933,730,27,13,1960,717,1854,238,258,278,0,,0,0.0,0.0,0.0,0.0,0.0
2024,10,13,7,2024-10-13,B6,3980,PHX,HNL,"Phoenix, AZ",Arizona,"Honolulu, HI",Hawaii,1506,1027,-19,-10,1487,1017,22,18,1509,999,1485,184,204,224,0,,0,0.0,0.0,0.0,0.0,0.0
2024,3,22,5,2024-03-22,UA,2837,STL,IAH,"St. Louis, MO",Missouri,"Houston, TX",Texas,1206,1530,0,0,1206,1530,19,17,1225,1513,977,119,139,155,0,,0,0.0,0.0,0.0,0.0,0.0
2024,2,12,1,2024-02-12,NK,2531,LGA,LAS,"New York, NY",New York,"Las Vegas, NV",Nevada,1202,1510,-1,-10,1201,1500,21,14,1222,1486,1159,141,161,176,0,,0,0.0,0.0,0.0,0.0,0.0
2024,4,14,7,2024-04-14,OH,1487,STL,IAH,"St. Louis, MO",Missouri,"Houston, TX",Texas,1245,1279,8,5,1253,1284,29,5,1282,1279,2233,279,299,313,0,,0,0.0,0.0,0.0,0.0,0.0
2024,1,1,1,2024-01-01,DL,9729,IAH,CLT,"Houston, TX",Texas,"Charlotte, NC",North Carolina,931,2165,-2,5,929,2170,21,14,950,2156,532,56,76,91,0,,0,0.0,0.0,0.0,0.0,0.0
2024,3,1,5,2024-03-01,UA,3465,MCO,ATL,"Orlando, FL",Florida,"Atlanta, GA",Georgia,1589,921,-13,-5,1576,916,28,3,1604,913,567,64,84,95,0,,0,0.0,0.0,0.0,0.0,0.0
2024,9,26,4,2024-09-26,AA,2539,ATL,DEN,"Atlanta, GA",Georgia,"Denver, CO",Colorado,1604,1959,-21,-20,1583,1939,14,7,1597,1932,2154,275,295,296,0,,0,0.0,0.0,0.0,0.0,0.0
2024,6,28,5,2024-06-28,F9,1416,MSP,LGA,"Minneapolis, MN",Minnesota,"New York, NY",New York,535,1380,-11,-20,524,1360,19,10,543,1350,714,80,100,109,0,,0,0.0,0.0,0.0,0.0,0.0
2024,8,11,7,2024-08-11,DL,5304,PHX,BWI,"Phoenix, AZ",Arizona,"Baltimore, MD",Maryland,1246,2136,-10,0,1236,2136,27,7,1263,2129,963,125,145,159,0,,0,0.0,0.0,0.0,0.0,0.0
2024,1,6,6,2024-01-06,HA,5104,DCA,PDX,"Washington, DC",District of Columbia,"Portland, OR",Oregon,516,770,8,10,524,780,20,10,544,770,1991,239,259,269,0,,0,0.0,0.0,0.0,0.0,0.0
2024,4,12,5,2024-04-12,NK,784,TPA,MIA,"Tampa, FL",Florida,"Miami, FL",Florida,1013,1523,2,0,1015,1523,19,15,1034,1508,2729,344,364,378,0,,0,0.0,0.0,0.0,0.0,0.0
2024,1,10,3,2024-01-10,OO,6540,IAH,DTW,"Houston, TX",Texas,"Detroit, MI",Michigan,532,728,-5,-5,527,723,13,19,540,704,1099,138,158,170,0,,0,0.0,0.0,0.0,0.0,0.0
2024,3,11,1,2024-03-11,G4,3187,BOS,LGA,"Boston, MA",Massachusetts,"New York, NY",New York,848,1279,9,10,857,1289,25,10,882,1279,1640,198,218,233,0,,0,0.0,0.0,0.0,0.0,0.0
2024,3,30,6,2024-03-30,AS,9967,SEA,PDX,"Seattle, WA",Washington,"Portland, OR",Oregon,1903,2041,-20,-10,1883,2031,23,5,1906,2026,1874,238,258,266,0,,0,0.0,0.0,0.0,0.0,0.0
2024,8,13,2,2024-08-13,DL,2213,CLT,PHX,"Charlotte, NC",North Carolina,"Phoenix, AZ",Arizona,1007,996,-3,-5,1004,991,5,14,1009,977,2747,335,355,354,0,,0,0.0,0.0,0.0,0.0,0.0
2024,6,6,4,2024-06-06,DL,1057,MSP,SAN,"Minneapolis, MN",Minnesota,"San Diego, CA",California,1145,660,-2,0,1143,660,6,15,1149,645,748,91,111,112,0,,0,0.0,0.0,0.0,0.0,0.0
2024,8,15,4,2024-08-15,G4,5878,BOS,ORD,"Boston, MA",Massachusetts,"Chicago, IL",Illinois,1438,1740,-13,-10,1425,1730,10,11,1435,1719,2180,271,291,292,0,,0,0.0,0.0,0.0,0.0,0.0
2024,5,5,7,2024-05-05,9E,8179,MIA,DEN,"Miami, FL",Florida,"Denver, CO",Colorado,1355,2258,62,60,1417,2318,28,18,1445,2300,2092,255,275,301,0,,0,19.0,0.0,0.0,0.0,41.0
2024,7,27,6,2024-07-27,F9,6128,IAD,LAX,"Washington, DC",District of Columbia,"Los Angeles, CA",California,1790,1072,-3,0,1787,1072,13,3,1800,1069,969,112,132,128,0,,0,0.0,0.0,0.0,0.0,0.0
2024,4,6,6,2024-04-06,OH,5800,LAS,SLC,"Las Vegas, NV",Nevada,"Salt Lake City, UT",Utah,1016,1337,-9,-15,1007,1322,28,3,1035,1319,2989,368,388,399,0,,0,0.0,0.0,0.0,0.0,0.0
2024,3,14,4,2024-03-14,OH,3194,IAH,BOS,"Houston, TX",Texas,"Boston, MA",Massachusetts,1297,996,-20,-10,1277,986,22,10,1299,976,2937,369,389,401,0,,0,0.0,0.0,0.0,0.0,0.0
2024,4,24,3,2024-04-24,OH,2907,MIA,ATL,"Miami, FL",Florida,"Atlanta, GA",Georgia,984,1403,1,0,985,1403,5,5,990,1398,1429,173,193,183,0,,0,0.0,0.0,0.0,0.0,0.0
2024,7,9,2,2024-07-09,G4,7682,MCO,HNL,"Orlando, FL",Florida,"Honolulu, HI",Hawaii,1870,1556,1,0,1871,1556,14,16,1885,1540,2019,246,266,276,1,,0,0.0,0.0,0.0,0.0,0.0
2024,6,18,2,2024-06-18,WN,9112,SAN,SLC,"San Diego, CA",California,"Salt Lake City, UT",Utah,2126,2321,30,30,2156,2351,8,16,2164,2335,1513,192,212,216,0,,0,6.0,2.0,3.0,0.0,19.0
2024,11,2,6,2024-11-02,WN,987,LAS,BOS,"Las Vegas, NV",Nevada,"Boston, MA",Massachusetts,1163,2220,0,0,1163,2220,18,19,1181,2201,2840,363,383,400,0,,0,0.0,0.0,0.0,0.0,0.0
2024,7,22,1,2024-07-22,HA,6115,BOS,SLC,"Boston, MA",Massachusetts,"Salt Lake City, UT",Utah,942,1841,10,5,952,1846,25,3,977,1843,2920,359,379,387,0,,0,0.0,0.0,0.0,0.0,0.0
2024,2,25,7,2024-02-25,HA,5524,BOS,EWR,"Boston, MA",Massachusetts,"Newark, NJ",New Jersey,877,1254,-16,-10,861,1244,10,6,871,1238,2782,351,371,367,0,,0,0.0,0.0,0.0,0.0,0.0
2024,7,26,5,2024-07-26,DL,4093,MSP,DCA,"Minneapolis, MN",Minnesota,"Washington, DC",District of Columbia,2153,2100,-17,-15,2136,2085,24,8,2160,2077,966,118,138,150,0,,0,0.0,0.0,0.0,0.0,0.0
2024,2,10,6,2024-02-10,OH,3184,DFW,DTW,"Dallas/Fort Worth, TX",Texas,"Detroit, MI",Michigan,1513,1201,-1,0,1512,1201,9,17,1521,1184,595,79,99,105,0,,0,0.0,0.0,0.0,0.0,0.0
2024,2,1,4,2024-02-01,9E,975,MSP,DEN,"Minneapolis, MN",Minnesota,"Denver, CO",Colorado,1462,867,10,10,1472,877,19,15,1491,862,2251,290,310,324,0,,0,0.0,0.0,0.0,0.0,0.0
2024,1,15,1,2024-01-15,AA,5369,BOS,HNL,"Boston, MA",Massachusetts,"Honolulu, HI",Hawaii,1072,675,-8,0,1064,675,28,11,1092,664,1446,181,201,220,0,,0,0.0,0.0,0.0,0.0,0.0
2024,3,2,6,2024-03-02,9E,7608,MDW,PDX,"Chicago, IL",Illinois,"Portland, OR",Oregon,857,1692,-5,-5,852,1687,14,9,866,1678,2694,345,365,368,0,,0,0.0,0.0,0.0,0.0,0.0
2024,6,3,1,2024-06-03,MQ,4096,ATL,LAS,"Atlanta, GA",Georgia,"Las Vegas, NV",Nevada,1037,2068,-3,0,1034,2068,7,8,1041,2060,1395,177,197,192,0,,0,0.0,0.0,0.0,0.0,0.0
2024,10,10,4,2024-10-10,WN,656,SFO,MCO,"San Francisco, CA",California,"Orlando, FL",Florida,1120,1921,-10,0,1110,1921,21,11,1131,1910,1599,206,226,238,0,,0,0.0,0.0,0.0,0.0,0.0
2024,7,27,6,2024-07-27,9E,5393,IAD,ATL,"Washington, DC",District of Columbia,"Atlanta, GA",Georgia,1733,2097,-9,-15,1724,2082,13,8,1737,2074,348,51,71,72,0,,0,0.0,0.0,0.0,0.0,0.0
2024,11,15,5,2024-11-15,9E,9000,SLC,DCA,"Salt Lake City, UT",Utah,"Washington, DC",District of Columbia,2294,1783,10,5,2304,1788,13,13,2317,1775,2905,359,379,385,0,,0,0.0,0.0,0.0,0.0,0.0
2024,7,5,5,2024-07-05,OO,817,MIA,JFK,"Miami, FL",Florida,"New York, NY",New York,1305,1497,5,0,1310,1497,19,8,1329,1489,744,101,121,128,0,,0,0.0,0.0,0.0,0.0,0.0
2024,5,9,4,2024-05-09,F9,3765,DFW,STL,"Dallas/Fort Worth, TX",Texas,"St. Louis, MO",Missouri,1565,1631,-13,-5,1552,1626,22,5,1574,1621,2703,332,352,359,0,,0,0.0,0.0,0.0,0.0,0.0
2024,5,6,1,2024-05-06,DL,6647,MCO,IAD,"Orlando, FL",Florida,"Washington, DC",District of Columbia,1315,2354,4,0,1319,2354,7,16,1326,2338,622,84,104,107,0,,0,0.0,0.0,0.0,0.0,0.0
2024,10,18,5,2024-10-18,MQ,5296,PHX,DEN,"Phoenix, AZ",Arizona,"Denver, CO",Colorado,512,2108,-19,-10,493,2098,12,8,505,2090,1382,164,184,184,0,,0,0.0,0.0,0.0,0.0,0.0
2024,4,23,2,2024-04-23,YX,2119,DCA,PHX,"Washington, DC",District of Columbia,"Phoenix, AZ",Arizona,2124,1421,-5,-5,2119,1416,7,4,2126,1412,2492,311,331,322,0,,0,0.0,0.0,0.0,0.0,0.0
2024,7,17,3,2024-07-17,OO,8582,MSP,DTW,"Minneapolis, MN",Minnesota,"Detroit, MI",Michigan,2123,687,-2,0,2121,687,23,12,2144,675,1594,205,225,240,0,,0,0.0,0.0,0.0,0.0,0.0
2024,1,13,6,2024-01-13,F9,2283,MIA,LAS,"Miami, FL",Florida,"Las Vegas, NV",Nevada,1323,1764,-16,-10,1307,1754,26,9,1333,1745,931,109,129,144,0,,0,0.0,0.0,0.0,0.0,0.0
2024,9,27,5,2024-09-27,AA,3979,JFK,HNL,"New York, NY",New York,"Honolulu, HI",Hawaii,988,2164,-3,5,985,2169,17,7,1002,2162,670,87,107,111,0,,0,0.0,0.0,0.0,0.0,0.0
2024,3,29,5,2024-03-29,HA,3036,DTW,PDX,"Detroit, MI",Michigan,"Portland, OR",Oregon,1710,1124,-3,0,1707,1124,26,17,1733,1107,880,104,124,147,0,,0,0.0,0.0,0.0,0.0,0.0
2024,8,2,5,2024-08-02,AA,6791,DTW,LAX,"Detroit, MI",Michigan,"Los Angeles, CA",California,1586,1425,5,10,1591,1435,20,12,1611,1423,1630,203,223,235,0,,0,0.0,0.0,0.0,0.0,0.0
2024,10,4,5,2024-10-04,WN,7145,DFW,CLT,"Dallas/Fort Worth, TX",Texas,"Charlotte, NC",North Carolina,1859,1174,6,10,1865,1184,11,4,1876,1180,2024,259,279,274,0,,0,0.0,0.0,0.0,0.0,0.0
2024,7,21,7,2024-07-21,NK,2913,TPA,IAD,"Tampa, FL",Florida,"Washington, DC",District of Columbia,1054,1966,1,0,1055,1966,24,4,1079,1962,1633,201,221,229,0,,0,0.0,0.0,0.0,0.0,0.0
2024,3,14,4,2024-03-14,G4,1337,LGA,BWI,"New York, NY",New York,"Baltimore, MD",Maryland,1244,1286,-14,-10,1230,1276,9,10,1239,1266,870,110,130,129,0,,0,0.0,0.0,0.0,0.0,0.0
2024,1,25,4,2024-01-25,B6,4941,IAD,ATL,"Washington, DC",District of Columbia,"Atlanta, GA",Georgia,2269,1574,3,5,2272,1579,23,8,2295,1571,2402,305,325,336,0,,0,0.0,0.0,0.0,0.0,0.0
2024,4,10,3,2024-04-10,DL,3143,DCA,PDX,"Washington, DC",District of Columbia,"Portland, OR",Oregon,574,1839,-7,-5,567,1834,6,14,573,1820,2516,308,328,328,0,,0,0.0,0.0,0.0,0.0,0.0
2024,6,24,1,2024-06-24,YX,6572,BOS,TPA,"Boston, MA",Massachusetts,"Tampa, FL",Florida,1264,1105,-10,0,1254,1105,7,18,1261,1087,1911,246,266,271,0,,0,0.0,0.0,0.0,0.0,0.0
2024,4,26,5,2024-04-26,NK,3187,CLT,IAH,"Charlotte, NC",North Carolina,"Houston, TX",Texas,1324,2222,-23,-15,1301,2207,7,18,1308,2189,1662,215,235,240,0,,0,0.0,0.0,0.0,0.0,0.0
2024,6,14,5,2024-06-14,OO,3658,IAH,PHL,"Houston, TX",Texas,"Philadelphia, PA",Pennsylvania,1672,673,-6,0,1666,673,6,17,1672,656,2817,344,364,367,0,,0,0.0,0.0,0.0,0.0,0.0
2024,2,10,6,2024-02-10,DL,5393,DTW,IAD,"Detroit, MI",Michigan,"Washington, DC",District of Columbia,2217,1405,-5,-5,2212,1400,20,12,2232,1388,1526,187,207,219,0,,0,0.0,0.0,0.0,0.0,0.0
2024,12,9,1,2024-12-09,G4,8990,DEN,LAX,"Denver, CO",Colorado,"Los Angeles, CA",California,706,1180,-12,-5,694,1175,21,6,715,1169,297,40,60,67,0,,0,0.0,0.0,0.0,0.0,0.0
2024,4,29,1,2024-04-29,G4,2953,IAH,IAD,"Houston, TX",Texas,"Washington, DC",District of Columbia,1192,1692,21,20,1213,1712,20,10,1233,1702,2190,270,290,300,0,,0,7.0,0.0,2.0,0.0,11.0
2024,4,6,6,2024-04-06,UA,1945,SAN,DTW,"San Diego, CA",California,"Detroit, MI",Michigan,2208,822,-15,-5,2193,817,20,11,2213,806,1427,186,206,217,0,,0,0.0,0.0,0.0,0.0,0.0
2024,5,24,5,2024-05-24,MQ,6462,ORD,ATL,"Chicago, IL",Illinois,"Atlanta, GA",Georgia,1764,1496,-5,5,1759,1501,23,19,1782,1482,2861,361,381,403,0,,0,0.0,0.0,0.0,0.0,0.0
2024,8,3,6,2024-08-03,F9,6756,DCA,ORD,"Washington, DC",District of Columbia,"Chicago, IL",Illinois,1175,985,2,0,1177,985,21,8,1198,977,2253,290,310,319,0,,0,0.0,0.0,0.0,0.0,0.0
2024,8,16,5,2024-08-16,OO,7666,IAH,SLC,"Houston, TX",Texas,"Salt Lake City, UT",Utah,1074,1908,-6,-15,1068,1893,28,18,1096,1875,545,70,90,116,0,,0,0.0,0.0,0.0,0.0,0.0
2024,11,8,5,2024-11-08,WN,3282,HNL,TPA,"Honolulu, HI",Hawaii,"Tampa, FL",Florida,1393,721,-1,5,1392,726,9,9,1401,717,2710,340,360,358,0,,0,0.0,0.0,0.0,0.0,0.0
2024,5,9,4,2024-05-09,UA,563,MDW,SFO,"Chicago, IL",Illinois,"San Francisco, CA",California,1758,1332,4,-5,1762,1327,16,6,1778,1321,1488,186,206,208,0,,0,0.0,0.0,0.0,0.0,0.0
2024,12,17,2,2024-12-17,AA,3960,LAS,TPA,"Las Vegas, NV",Nevada,"Tampa, FL",Florida,624,2064,-4,5,620,2069,26,6,646,2063,746,83,103,115,0,,0,0.0,0.0,0.0,0.0,0.0
2024,11,13,3,2024-11-13,B6,5860,PDX,SLC,"Portland, OR",Oregon,"Salt Lake City, UT",Utah,756,1422,8,0,764,1422,16,11,780,1411,1846,228,248,255,0,,0,0.0,0.0,0.0,0.0,0.0
2024,5,16,4,2024-05-16,MQ,7360,MCO,ORD,"Orlando, FL",Florida,"Chicago, IL",Illinois,1615,1056,-9,-5,1606,1051,11,16,1617,1035,2153,276,296,303,0,,0,0.0,0.0,0.0,0.0,0.0
2024,11,19,2,2024-11-19,OH,550,JFK,ATL,"New York, NY",New York,"Atlanta, GA",Georgia,1236,763,0,-5,1236,758,11,12,1247,746,902,102,122,125,0,,0,0.0,0.0,0.0,0.0,0.0
2024,12,2,1,2024-12-02,OO,2015,TPA,MDW,"Tampa, FL",Florida,"Chicago, IL",Illinois,2230,1886,-2,5,2228,1891,8,5,2236,1886,2985,367,387,380,0,,0,0.0,0.0,0.0,0.0,0.0
2024,9,29,7,2024-09-29,WN,9215,DTW,EWR,"Detroit, MI",Michigan,"Newark, NJ",New Jersey,1730,691,7,0,1737,691,10,13,1747,678,686,89,109,112,0,,0,0.0,0.0,0.0,0.0,0.0
2024,4,26,5,2024-04-26,AA,3722,ATL,IAD,"Atlanta, GA",Georgia,"Washington, DC",District of Columbia,1940,935,5,5,1945,940,20,5,1965,935,738,93,113,118,0,,0,0.0,0.0,0.0,0.0,0.0
2024,11,1,5,2024-11-01,9E,7176,TPA,IAH,"Tampa, FL",Florida,"Houston, TX",Texas,787,1185,-5,-10,782,1175,12,15,794,1160,2037,248,268,275,0,,0,0.0,0.0,0.0,0.0,0.0
2024,4,3,3,2024-04-03,F9,415,SEA,DCA,"Seattle, WA",Washington,"Washington, DC",District of Columbia,1738,1534,4,5,1742,1539,10,14,1752,1525,1107,146,166,170,0,,0,0.0,0.0,0.0,0.0,0.0
2024,6,16,7,2024-06-16,F9,4866,DEN,HNL,"Denver, CO",Colorado,"Honolulu, HI",Hawaii,2221,913,-14,-5,2207,908,27,15,2234,893,1142,138,158,180,0,,0,0.0,0.0,0.0,0.0,0.0
2024,7,21,7,2024-07-21,MQ,4893,DTW,MCO,"Detroit, MI",Michigan,"Orlando, FL",Florida,1137,1201,-1,0,1136,1201,23,12,1159,1189,1323,162,182,197,0,,0,0.0,0.0,0.0,0.0,0.0
2024,12,6,5,2024-12-06,F9,1476,LAS,MDW,"Las Vegas, NV",Nevada,"Chicago, IL",Illinois,1266,1593,-23,-15,1243,1578,29,12,1272,1566,1095,141,161,182,0,,0,0.0,0.0,0.0,0.0,0.0
2024,5,28,2,2024-05-28,UA,2915,IAD,BWI,"Washington, DC",District of Columbia,"Baltimore, MD",Maryland,1011,1509,-4,-5,1007,1504,14,3,1021,1501,1532,198,218,215,0,,0,0.0,0.0,0.0,0.0,0.0
2024,7,1,1,2024-07-01,AS,1362,DFW,SLC,"Dallas/Fort Worth, TX",Texas,"Salt Lake City, UT",Utah,1072,2089,9,0,1081,2089,20,5,1101,2084,281,27,47,52,0,,0,0.0,0.0,0.0,0.0,0.0
2024,5,31,5,2024-05-31,YX,9419,HNL,ORD,"Honolulu, HI",Hawaii,"Chicago, IL",Illinois,867,2264,-19,-10,848,2254,6,16,854,2238,1727,213,233,235,0,,0,0.0,0.0,0.0,0.0,0.0
2024,3,14,4,2024-03-14,YX,3025,ATL,JFK,"Atlanta, GA",Georgia,"New York, NY",New York,1924,2024,7,10,1931,2034,18,18,1949,2016,2716,342,362,378,0,,0,0.0,0.0,0.0,0.0,0.0
2024,12,30,1,2024-12-30,NK,9344,LGA,PHX,"New York, NY",New York,"Phoenix, AZ",Arizona,1724,1160,12,5,1736,1165,15,3,1751,1162,1151,138,158,156,0,,0,0.0,0.0,0.0,0.0,0.0
2024,9,30,1,2024-09-30,G4,3568,ORD,DEN,"Chicago, IL",Illinois,"Denver, CO",Colorado,2104,2221,8,10,2112,2231,28,11,2140,2220,2781,337,357,376,0,,0,0.0,0.0,0.0,0.0,0.0
2024,2,11,7,2024-02-11,B6,4121,PHX,PDX,"Phoenix, AZ",Arizona,"Portland, OR",Oregon,784,1084,-5,-5,779,1079,28,4,807,1075,320,40,60,72,0,,0,0.0,0.0,0.0,0.0,0.0
2024,7,30,2,2024-07-30,G4,4509,MIA,PHL,"Miami, FL",Florida,"Philadelphia, PA",Pennsylvania,562,1255,-28,-20,534,1235,6,8,540,1227,2898,363,383,377,0,,0,0.0,0.0,0.0,0.0,0.0
2024,4,10,3,2024-04-10,AS,647,DCA,DTW,"Washington, DC",District of Columbia,"Detroit, MI",Michigan,1145,2270,-3,0,1142,2270,29,19,1171,2251,1838,236,256,284,0,,0,0.0,0.0,0.0,0.0,0.0
2024,2,14,3,2024-02-14,9E,4991,MDW,PHX,"Chicago, IL",Illinois,"Phoenix, AZ",Arizona,1250,1226,-11,-5,1239,1221,7,10,1246,1211,2799,344,364,361,0,,0,0.0,0.0,0.0,0.0,0.0
2024,3,22,5,2024-03-22,9E,3623,PHL,IAH,"Philadelphia, PA",Pennsylvania,"Houston, TX",Texas,1263,1900,-1,-5,1262,1895,26,5,1288,1890,2790,352,372,383,0,,0,0.0,0.0,0.0,0.0,0.0
2024,1,17,3,2024-01-17,9E,7142,DEN,BOS,"Denver, CO",Colorado,"Boston, MA",Massachusetts,860,665,4,5,864,670,15,3,879,667,1791,214,234,232,0,,0,0.0,0.0,0.0,0.0,0.0
2024,3,13,3,2024-03-13,WN,9821,ATL,MIA,"Atlanta, GA",Georgia,"Miami, FL",Florida,1710,2322,8,5,1718,2327,8,10,1726,2317,1549,190,210,208,0,,0,0.0,0.0,0.0,0.0,0.0
2024,1,14,7,2024-01-14,MQ,5705,MIA,PHL,"Miami, FL",Florida,"Philadelphia, PA",Pennsylvania,2006,800,-26,-20,1980,780,18,4,1998,776,2337,298,318,320,0,,0,0.0,0.0,0.0,0.0,0.0
2024,6,5,3,2024-06-05,AA,206,MSP,CLT,"Minneapolis, MN",Minnesota,"Charlotte, NC",North Carolina,870,1067,12,5,882,1072,9,11,891,1061,1131,142,162,162,0,,0,0.0,0.0,0.0,0.0,0.0
2024,8,10,6,2024-08-10,AA,9148,HNL,BOS,"Honolulu, HI",Hawaii,"Boston, MA",Massachusetts,1544,1033,1,0,1545,1033,7,13,1552,1020,586,64,84,84,0,,0,0.0,0.0,0.0,0.0,0.0
2024,5,11,6,2024-05-11,OH,3084,PHX,MCO,"Phoenix, AZ",Arizona,"Orlando, FL",Florida,1440,737,-8,0,1432,737,12,18,1444,719,2867,363,383,393,0,,0,0.0,0.0,0.0,0.0,0.0
2024,12,3,2,2024-12-03,9E,5568,MIA,SEA,"Miami, FL",Florida,"Seattle, WA",Washington,1440,1615,-13,-10,1427,1605,14,11,1441,1594,1126,134,154,159,0,,0,0.0,0.0,0.0,0.0,0.0
2024,2,16,5,2024-02-16,B6,5952,IAH,DTW,"Houston, TX",Texas,"Detroit, MI",Michigan,1354,1675,-2,-5,1352,1670,16,19,1368,1651,1671,203,223,238,0,,0,0.0,0.0,0.0,0.0,0.0
2024,4,16,2,2024-04-16,MQ,1350,BWI,TPA,"Baltimore, MD",Maryland,"Tampa, FL",Florida,1302,2348,-5,5,1297,2353,12,17,1309,2336,2748,350,370,379,0,,0,0.0,0.0,0.0,0.0,0.0
2024,4,17,3,2024-04-17,OH,6839,ATL,DEN,"Atlanta, GA",Georgia,"Denver, CO",Colorado,1831,2075,-2,5,1829,2080,27,9,1856,2071,357,46,66,82,0,,0,0.0,0.0,0.0,0.0,0.0
2024,9,21,6,2024-09-21,UA,6232,SFO,MSP,"San Francisco, CA",California,"Minneapolis, MN",Minnesota,545,1781,-8,-5,537,1776,11,6,548,1770,2162,262,282,279,0,,0,0.0,0.0,0.0,0.0,0.0
2024,7,23,2,2024-07-23,B6,1711,HNL,EWR,"Honolulu, HI",Hawaii,"Newark, NJ",New Jersey,693,1401,7,5,700,1406,6,17,706,1389,1202,143,163,166,0,,0,0.0,0.0,0.0,0.0,0.0
2024,3,19,2,2024-03-19,B6,8028,PHL,MIA,"Philadelphia, PA",Pennsylvania,"Miami, FL",Florida,1580,1461,-5,-10,1575,1451,16,19,1591,1432,623,74,94,109,0,,0,0.0,0.0,0.0,0.0,0.0
2024,6,3,1,2024-06-03,AA,1890,SAN,SFO,"San Diego, CA",California,"San Francisco, CA",California,2077,1829,15,10,2092,1839,26,12,2118,1827,933,106,126,144,0,,0,0.0,0.0,0.0,0.0,0.0
2024,9,27,5,2024-09-27,OH,7317,PHL,LAS,"Philadelphia, PA",Pennsylvania,"Las Vegas, NV",Nevada,1980,1965,-2,0,1978,1965,24,14,2002,1951,864,108,128,146,0,,0,0.0,0.0,0.0,0.0,0.0
2024,9,3,2,2024-09-03,F9,967,ORD,BWI,"Chicago, IL",Illinois,"Baltimore, MD",Maryland,832,1939,13,5,845,1944,15,18,860,1926,1249,152,172,185,0,,0,0.0,0.0,0.0,0.0,0.0
2024,1,19,5,2024-01-19,B6,2869,PHX,MSP,"Phoenix, AZ",Arizona,"Minneapolis, MN",Minnesota,1246,735,-3,0,1243,735,13,9,1256,726,2570,329,349,351,0,,0,0.0,0.0,0.0,0.0,0.0
2024,12,11,3,2024-12-11,B6,427,SAN,PHX,"San Diego, CA",California,"Phoenix, AZ",Arizona,1365,1698,-2,-10,1363,1688,9,12,1372,1676,372,38,58,59,0,,0,0.0,0.0,0.0,0.0,0.0
2024,1,26,5,2024-01-26,G4,3916,MCO,PHL,"Orlando, FL",Florida,"Philadelphia, PA",Pennsylvania,1539,1048,-15,-5,1524,1043,10,4,1534,1039,912,113,133,127,0,,0,0.0,0.0,0.0,0.0,0.0
2024,8,4,7,2024-08-04,F9,3248,SFO,DCA,"San Francisco, CA",California,"Washington, DC",District of Columbia,1144,668,-3,-5,1141,663,11,14,1152,649,1847,223,243,248,0,,0,0.0,0.0,0.0,0.0,0.0
2024,6,2,7,2024-06-02,MQ,6876,SLC,LAS,"Salt Lake City, UT",Utah,"Las Vegas, NV",Nevada,2036,1552,-3,-5,2033,1547,18,8,2051,1539,1168,136,156,162,0,,0,0.0,0.0,0.0,0.0,0.0
2024,6,2,7,2024-06-02,AA,2655,IAH,MDW,"Houston, TX",Texas,"Chicago, IL",Illinois,1243,1412,-17,-10,1226,1402,22,4,1248,1398,227,24,44,50,0,,0,0.0,0.0,0.0,0.0,0.0
2024,6,22,6,2024-06-22,UA,9422,SAN,SFO,"San Diego, CA",California,"San Francisco, CA",California,649,2184,4,5,653,2189,19,16,672,2173,1220,151,171,186,0,,0,0.0,0.0,0.0,0.0,0.0
2024,4,1,1,2024-04-01,YX,4436,DFW,DCA,"Dallas/Fort Worth, TX",Texas,"Washington, DC",District of Columbia,1505,1825,-15,-15,1490,1810,5,9,1495,1801,2484,302,322,316,0,,0,0.0,0.0,0.0,0.0,0.0
2024,12,3,2,2024-12-03,NK,2582,CLT,DEN,"Charlotte, NC",North Carolina,"Denver, CO",Colorado,2157,1614,13,10,2170,1624,20,7,2190,1617,2566,320,340,347,0,,0,0.0,0.0,0.0,0.0,0.0
2024,6,29,6,2024-06-29,AA,3199,JFK,MCO,"New York, NY",New York,"Orlando, FL",Florida,1301,2197,-16,-10,1285,2187,19,11,1304,2176,831,106,126,136,0,,0,0.0,0.0,0.0,0.0,0.0
2024,5,10,5,2024-05-10,AA,9848,BWI,LAS,"Baltimore, MD",Maryland,"Las Vegas, NV",Nevada,1381,1790,22,20,1403,1810,26,15,1429,1795,322,36,56,77,0,,0,2.0,3.0,1.0,0.0,14.0
2024,10,24,4,2024-10-24,B6,5886,PDX,MDW,"Portland, OR",Oregon,"Chicago, IL",Illinois,1325,2340,34,30,1359,2370,13,17,1372,2353,2493,314,334,344,0,,0,4.0,2.0,2.0,0.0,22.0
2024,10,1,2,2024-10-01,G4,6832,MCO,MSP,"Orlando, FL",Florida,"Minneapolis, MN",Minnesota,1736,2284,1,-5,1737,2279,11,7,1748,2272,1796,219,239,237,0,,0,0.0,0.0,0.0,0.0,0.0
2024,9,29,7,2024-09-29,AS,8085,MCO,DFW,"Orlando, FL",Florida,"Dallas/Fort Worth, TX",Texas,890,1744,35,30,925,1774,16,10,941,1764,1357,162,182,188,0,,0,5.0,0.0,4.0,0.0,21.0
2024,3,16,6,2024-03-16,9E,6154,LGA,LAX,"New York, NY",New York,"Los Angeles, CA",California,780,696,0,10,780,706,13,9,793,697,519,54,74,76,0,,0,0.0,0.0,0.0,0.0,0.0
2024,6,25,2,2024-06-25,DL,668,PDX,DTW,"Portland, OR",Oregon,"Detroit, MI",Michigan,2175,976,-14,-15,2161,961,16,14,2177,947,827,99,119,129,0,,0,0.0,0.0,0.0,0.0,0.0
2024,7,2,2,2024-07-02,OO,1754,EWR,PDX,"Newark, NJ",New Jersey,"Portland, OR",Oregon,2194,2114,24,15,2218,2129,15,14,2233,2115,1510,195,215,224,0,,0,0.0,0.0,0.0,0.0,0.0
2024,11,14,4,2024-11-14,G4,7232,ATL,STL,"Atlanta, GA",Georgia,"St. Louis, MO",Missouri,1038,1676,-12,-20,1026,1656,7,16,1033,1640,973,111,131,134,0,,0,0.0,0.0,0.0,0.0,0.0
2024,5,10,5,2024-05-10,AS,3833,DTW,MDW,"Detroit, MI",Michigan,"Chicago, IL",Illinois,841,608,-14,-10,827,598,17,18,844,580,1708,211,231,246,0,,0,0.0,0.0,0.0,0.0,0.0
2024,12,28,6,2024-12-28,B6,3329,DEN,ATL,"Denver, CO",Colorado,"Atlanta, GA",Georgia,1173,1604,-6,0,1167,1604,9,15,1176,1589,1158,137,157,161,0,,0,0.0,0.0,0.0,0.0,0.0
2024,2,18,7,2024-02-18,B6,6911,DEN,ATL,"Denver, CO",Colorado,"Atlanta, GA",Georgia,2153,930,-18,-15,2135,915,26,15,2161,900,2921,357,377,398,0,,0,0.0,0.0,0.0,0.0,0.0
2024,2,24,6,2024-02-24,HA,8442,TPA,MSP,"Tampa, FL",Florida,"Minneapolis, MN",Minnesota,1860,850,-17,-10,1843,840,26,17,1869,823,351,50,70,93,0,,0,0.0,0.0,0.0,0.0,0.0
2024,6,2,7,2024-06-02,YX,1895,MSP,IAD,"Minneapolis, MN",Minnesota,"Washington, DC",District of Columbia,1518,959,23,20,1541,979,25,13,1566,966,1937,246,266,284,0,,0,0.0,5.0,1.0,0.0,14.0
2024,12,20,5,2024-12-20,UA,6639,PDX,SFO,"Portland, OR",Oregon,"San Francisco, CA",California,1598,948,40,45,1638,993,22,10,1660,983,1601,192,212,224,0,,0,12.0,6.0,7.0,1.0,19.0
2024,7,18,4,2024-07-18,OH,8640,MSP,MIA,"Minneapolis, MN",Minnesota,"Miami, FL",Florida,592,723,13,5,605,728,15,11,620,717,2562,329,349,355,0,,0,0.0,0.0,0.0,0.0,0.0
2024,11,3,7,2024-11-03,AS,6314,BOS,SFO,"Boston, MA",Massachusetts,"San Francisco, CA",California,2069,1233,-7,0,2062,1233,7,7,2069,1226,2015,260,280,274,0,,0,0.0,0.0,0.0,0.0,0.0
2024,12,21,6,2024-12-21,HA,8688,SAN,IAH,"San Diego, CA",California,"Houston, TX",Texas,1519,798,14,15,1533,813,26,4,1559,809,1529,190,210,220,0,,0,0.0,0.0,0.0,0.0,0.0
2024,4,27,6,2024-04-27,HA,6245,PHX,BWI,"Phoenix, AZ",Arizona,"Baltimore, MD",Maryland,614,1428,-7,-15,607,1413,13,12,620,1401,1477,179,199,204,0,,0,0.0,0.0,0.0,0.0,0.0
2024,9,19,4,2024-09-19,MQ,2709,LAX,ORD,"Los Angeles, CA",California,"Chicago, IL",Illinois,1944,2034,14,15,1958,2049,12,15,1970,2034,1310,162,182,189,0,,0,0.0,0.0,0.0,0.0,0.0
2024,2,15,4,2024-02-15,WN,9450,SLC,IAD,"Salt Lake City, UT",Utah,"Washington, DC",District of Columbia,612,2003,-3,-5,609,1998,28,17,637,1981,1514,184,204,229,0,,0,0.0,0.0,0.0,0.0,0.0
2024,10,28,1,2024-10-28,MQ,8437,CLT,MIA,"Charlotte, NC",North Carolina,"Miami, FL",Florida,1891,1517,2,10,1893,1527,12,16,1905,1511,2624,324,344,352,0,,0,0.0,0.0,0.0,0.0,0.0
2024,12,21,6,2024-12-21,YX,2326,LAS,LAX,"Las Vegas, NV",Nevada,"Los Angeles, CA",California,1583,2128,2,5,1585,2133,17,13,1602,2120,2034,255,275,285,0,,0,0.0,0.0,0.0,0.0,0.0
2024,7,7,7,2024-07-07,9E,8555,LAS,MSP,"Las Vegas, NV",Nevada,"Minneapolis, MN",Minnesota,1805,1718,19,20,1824,1738,15,16,1839,1722,2538,326,346,357,0,,0,3.0,3.0,1.0,0.0,13.0
2024,11,5,2,2024-11-05,OH,6030,CLT,ATL,"Charlotte, NC",North Carolina,"Atlanta, GA",Georgia,736,629,1,10,737,639,10,9,747,630,2943,367,387,386,0,,0,0.0,0.0,0.0,0.0,0.0
2024,11,13,3,2024-11-13,HA,6942,HNL,ORD,"Honolulu, HI",Hawaii,"Chicago, IL",Illinois,1137,1715,0,10,1137,1725,17,16,1154,1709,1566,190,210,223,0,,0,0.0,0.0,0.0,0.0,0.0
2024,5,8,3,2024-05-08,DL,3180,CLT,BWI,"Charlotte, NC",North Carolina,"Baltimore, MD",Maryland,1568,1195,-1,0,1567,1195,15,5,1582,1190,964,129,149,149,0,,0,0.0,0.0,0.0,0.0,0.0
2024,2,18,7,2024-02-18,MQ,1087,MDW,SLC,"Chicago, IL",Illinois,"Salt Lake City, UT",Utah,2264,1638,12,10,2276,1648,18,12,2294,1636,990,130,150,160,0,,0,0.0,0.0,0.0,0.0,0.0
2024,1,25,4,2024-01-25,UA,9639,BOS,JFK,"Boston, MA",Massachusetts,"New York, NY",New York,1720,1254,-5,5,1715,1259,18,8,1733,1251,2661,337,357,363,0,,0,0.0,0.0,0.0,0.0,0.0
2024,9,22,7,2024-09-22,G4,1460,PHX,MSP,"Phoenix, AZ",Arizona,"Minneapolis, MN",Minnesota,1223,1420,-19,-10,1204,1410,23,8,1227,1402,2092,266,286,297,0,,0,0.0,0.0,0.0,0.0,0.0
2024,4,27,6,2024-04-27,OO,7150,IAD,MDW,"Washington, DC",District of Columbia,"Chicago, IL",Illinois,998,1059,-1,0,997,1059,9,5,1006,1054,1137,132,152,146,0,,0,0.0,0.0,0.0,0.0,0.0
2024,5,23,4,2024-05-23,OO,7646,ORD,LGA,"Chicago, IL",Illinois,"New York, NY",New York,2106,2344,-22,-15,2084,2329,19,18,2103,2311,2139,271,291,308,0,,0,0.0,0.0,0.0,0.0,0.0
2024,7,18,4,2024-07-18,G4,1826,IAH,SLC,"Houston, TX",Texas,"Salt Lake City, UT",Utah,2270,622,6,10,2276,632,17,13,2293,619,2898,354,374,384,0,,0,0.0,0.0,0.0,0.0,0.0
2024,6,5,3,2024-06-05,AS,1007,MDW,IAH,"Chicago, IL",Illinois,"Houston, TX",Texas,948,925,-21,-15,927,910,28,19,955,891,1567,192,212,239,0,,0,0.0,0.0,0.0,0.0,0.0
2024,12,13,5,2024-12-13,9E,9475,BWI,HNL,"Baltimore, MD",Maryland,"Honolulu, HI",Hawaii,2202,1476,35,30,2237,1506,20,14,2257,1492,896,102,122,136,0,,0,7.0,5.0,2.0,0.0,16.0
2024,5,13,1,2024-05-13,9E,2924,BOS,SLC,"Boston, MA",Massachusetts,"Salt Lake City, UT",Utah,694,2279,-9,-5,685,2274,23,5,708,2269,1177,156,176,184,0,,0,0.0,0.0,0.0,0.0,0.0
2024,5,27,1,2024-05-27,OH,9550,PHL,HNL,"Philadelphia, PA",Pennsylvania,"Honolulu, HI",Hawaii,2208,1710,-12,-10,2196,1700,21,6,2217,1694,610,69,89,96,0,,0,0.0,0.0,0.0,0.0,0.0
2024,12,1,7,2024-12-01,G4,8125,PHL,SFO,"Philadelphia, PA",Pennsylvania,"San Francisco, CA",California,1718,1816,24,15,1742,1831,20,13,1762,1818,1660,213,233,246,0,,0,0.0,0.0,0.0,0.0,0.0
2024,3,11,1,2024-03-11,WN,8490,JFK,IAH,"New York, NY",New York,"Houston, TX",Texas,1074,1284,-22,-20,1052,1264,18,11,1070,1253,2510,317,337,346,0,,0,0.0,0.0,0.0,0.0,0.0
2024,8,20,2,2024-08-20,OO,9348,LAX,DCA,"Los Angeles, CA",California,"Washington, DC",District of Columbia,1081,862,0,0,1081,862,21,8,1102,854,796,103,123,132,0,,0,0.0,0.0,0.0,0.0,0.0
2024,11,29,5,2024-11-29,B6,2555,MDW,DCA,"Chicago, IL",Illinois,"Washington, DC",District of Columbia,2258,2052,11,5,2269,2057,11,11,2280,2046,1471,181,201,203,0,,0,0.0,0.0,0.0,0.0,0.0
2024,10,25,5,2024-10-25,9E,5308,DEN,MCO,"Denver, CO",Colorado,"Orlando, FL",Florida,809,1406,-5,-5,804,1401,10,16,814,1385,1814,216,236,242,0,,0,0.0,0.0,0.0,0.0,0.0
2024,6,2,7,2024-06-02,AS,7874,CLT,BWI,"Charlotte, NC",North Carolina,"Baltimore, MD",Maryland,1090,1983,-2,0,1088,1983,9,8,1097,1975,2319,289,309,306,0,,0,0.0,0.0,0.0,0.0,0.0
2024,3,30,6,2024-03-30,MQ,3465,LGA,EWR,"New York, NY",New York,"Newark, NJ",New Jersey,1047,2185,13,5,1060,2190,28,18,1088,2172,419,60,80,106,0,,0,0.0,0.0,0.0,0.0,0.0
2024,11,29,5,2024-11-29,HA,9552,SFO,STL,"San Francisco, CA",California,"St. Louis, MO",Missouri,888,1032,17,20,905,1052,28,11,933,1041,1564,194,214,233,0,,0,2.0,4.0,1.0,0.0,13.0
2024,7,17,3,2024-07-17,G4,5379,DCA,LAX,"Washington, DC",District of Columbia,"Los Angeles, CA",California,2230,1159,-21,-15,2209,1144,5,9,2214,1135,2851,347,367,361,0,,0,0.0,0.0,0.0,0.0,0.0
2024,6,9,7,2024-06-09,MQ,6051,IAD,CLT,"Washington, DC",District of Columbia,"Charlotte, NC",North Carolina,1958,1107,-15,-10,1943,1097,20,14,1963,1083,2217,277,297,311,0,,0,0.0,0.0,0.0,0.0,0.0
2024,1,26,5,2024-01-26,B6,9605,EWR,LAS,"Newark, NJ",New Jersey,"Las Vegas, NV",Nevada,2252,648,8,0,2260,648,27,7,2287,641,662,90,110,124,0,,0,0.0,0.0,0.0,0.0,0.0
2024,4,30,2,2024-04-30,F9,6797,STL,MCO,"St. Louis, MO",Missouri,"Orlando, FL",Florida,1299,767,-5,-5,1294,762,18,16,1312,746,2412,308,328,342,0,,0,0.0,0.0,0.0,0.0,0.0
2024,10,27,7,2024-10-27,OO,8869,CLT,BOS,"Charlotte, NC",North Carolina,"Boston, MA",Massachusetts,1160,2302,-14,-5,1146,2297,6,16,1152,2281,828,96,116,118,0,,0,0.0,0.0,0.0,0.0,0.0
2024,7,30,2,2024-07-30,AA,6776,SLC,PHX,"Salt Lake City, UT",Utah,"Phoenix, AZ",Arizona,2019,1040,-18,-10,2001,1030,8,5,2009,1025,1442,177,197,190,0,,0,0.0,0.0,0.0,0.0,0.0
2024,3,3,7,2024-03-03,B6,1120,PHX,MIA,"Phoenix, AZ",Arizona,"Miami, FL",Florida,1284,1193,-9,0,1275,1193,5,9,1280,1184,2160,274,294,288,0,,0,0.0,0.0,0.0,0.0,0.0
2024,3,8,5,2024-03-08,9E,3944,EWR,ATL,"Newark, NJ",New Jersey,"Atlanta, GA",Georgia,1724,2198,12,10,1736,2208,6,18,1742,2190,2913,362,382,386,0,,0,0.0,0.0,0.0,0.0,0.0
2024,9,9,1,2024-09-09,AA,3673,PHL,MIA,"Philadelphia, PA",Pennsylvania,"Miami, FL",Florida,2189,827,-10,-10,2179,817,13,11,2192,806,2835,351,371,375,0,,0,0.0,0.0,0.0,0.0,0.0
2024,1,2,2,2024-01-02,9E,5542,MIA,IAH,"Miami, FL",Florida,"Houston, TX",Texas,1033,813,-10,-10,1023,803,5,19,1028,784,1414,175,195,199,0,,0,0.0,0.0,0.0,0.0,0.0
2024,4,17,3,2024-04-17,OH,8014,SLC,PHX,"Salt Lake City, UT",Utah,"Phoenix, AZ",Arizona,796,2265,7,5,803,2270,27,11,830,2259,1065,132,152,170,0,,0,0.0,0.0,0.0,0.0,0.0
2024,10,12,6,2024-10-12,AS,6158,MDW,DTW,"Chicago, IL",Illinois,"Detroit, MI",Michigan,2017,1479,-7,-15,2010,1464,24,16,2034,1448,582,62,82,102,0,,0,0.0,0.0,0.0,0.0,0.0
2024,2,18,7,2024-02-18,NK,8051,BOS,DEN,"Boston, MA",Massachusetts,"Denver, CO",Colorado,1326,1777,7,5,1333,1782,27,6,1360,1776,2337,286,306,319,0,,0,0.0,0.0,0.0,0.0,0.0
2024,5,19,7,2024-05-19,YX,8902,ORD,LAS,"Chicago, IL",Illinois,"Las Vegas, NV",Nevada,1226,1207,-15,-5,1211,1202,20,17,1231,1185,1536,197,217,234,0,,0,0.0,0.0,0.0,0.0,0.0
2024,8,5,1,2024-08-05,OH,8620,SAN,HNL,"San Diego, CA",California,"Honolulu, HI",Hawaii,830,2030,-3,-5,827,2025,18,6,845,2019,1789,226,246,250,0,,0,0.0,0.0,0.0,0.0,0.0
2024,2,13,2,2024-02-13,B6,646,TPA,BOS,"Tampa, FL",Florida,"Boston, MA",Massachusetts,1133,1349,-10,-5,1123,1344,27,7,1150,1337,2445,296,316,330,0,,0,0.0,0.0,0.0,0.0,0.0
2024,9,25,3,2024-09-25,AA,8630,BOS,CLT,"Boston, MA",Massachusetts,"Charlotte, NC",North Carolina,1354,1641,-8,-5,1346,1636,17,6,1363,1630,1883,233,253,256,0,,0,0.0,0.0,0.0,0.0,0.0
2024,3,18,1,2024-03-18,AS,3281,LGA,DTW,"New York, NY",New York,"Detroit, MI",Michigan,1784,1066,18,10,1802,1076,23,11,1825,1065,2416,293,313,327,0,,0,0.0,0.0,0.0,0.0,0.0
2024,8,3,6,2024-08-03,9E,9098,DTW,CLT,"Detroit, MI",Michigan,"Charlotte, NC",North Carolina,1578,943,18,15,1596,958,19,13,1615,945,2824,358,378,390,0,,0,0.0,0.0,0.0,0.0,0.0
2024,4,7,7,2024-04-07,B6,9325,BWI,LAX,"Baltimore, MD",Maryland,"Los Angeles, CA",California,1805,923,-5,0,1800,923,22,16,1822,907,468,64,84,102,0,,0,0.0,0.0,0.0,0.0,0.0
2024,8,23,5,2024-08-23,AS,4087,JFK,BWI,"New York, NY",New York,"Baltimore, MD",Maryland,1271,1869,6,0,1277,1869,7,14,1284,1855,665,75,95,96,0,,0,0.0,0.0,0.0,0.0,0.0
2024,10,8,2,2024-10-08,OO,3433,PHX,IAH,"Phoenix, AZ",Arizona,"Houston, TX",Texas,1374,1683,-24,-15,1350,1668,19,14,1369,1654,699,82,102,115,0,,0,0.0,0.0,0.0,0.0,0.0
2024,5,28,2,2024-05-28,9E,2840,BOS,HNL,"Boston, MA",Massachusetts,"Honolulu, HI",Hawaii,1241,2117,10,5,1251,2122,19,11,1270,2111,903,104,124,134,0,,0,0.0,0.0,0.0,0.0,0.0
2024,10,30,3,2024-10-30,HA,5001,STL,IAD,"St. Louis, MO",Missouri,"Washington, DC",District of Columbia,1137,2265,-6,0,1131,2265,9,4,1140,2261,2171,266,286,279,0,,0,0.0,0.0,0.0,0.0,0.0
2024,3,6,3,2024-03-06,NK,9988,DTW,BWI,"Detroit, MI",Michigan,"Baltimore, MD",Maryland,941,1461,-6,-15,935,1446,17,8,952,1438,723,98,118,123,0,,0,0.0,0.0,0.0,0.0,0.0
2024,8,21,3,2024-08-21,NK,5808,IAD,CLT,"Washington, DC",District of Columbia,"Charlotte, NC",North Carolina,1782,1672,-15,-10,1767,1662,28,15,1795,1647,2055,260,280,303,0,,0,0.0,0.0,0.0,0.0,0.0
2024,3,27,3,2024-03-27,DL,2182,SAN,LGA,"San Diego, CA",California,"New York, NY",New York,2085,1277,-19,-10,2066,1267,29,17,2095,1250,883,117,137,163,0,,0,0.0,0.0,0.0,0.0,0.0
2024,3,19,2,2024-03-19,HA,4752,SLC,MIA,"Salt Lake City, UT",Utah,"Miami, FL",Florida,2259,1279,-16,-10,2243,1269,24,4,2267,1265,2351,284,304,312,0,,0,0.0,0.0,0.0,0.0,0.0
2024,7,23,2,2024-07-23,YX,9977,MCO,DFW,"Orlando, FL",Florida,"Dallas/Fort Worth, TX",Texas,1392,1876,4,5,1396,1881,20,18,1416,1863,867,117,137,155,0,,0,0.0,0.0,0.0,0.0,0.0
2024,10,5,6,2024-10-05,UA,4686,SEA,MIA,"Seattle, WA",Washington,"Miami, FL",Florida,645,1447,23,15,668,1462,26,8,694,1454,2976,380,400,414,0,,0,0.0,0.0,0.0,0.0,0.0
2024,12,2,1,2024-12-02,YX,9895,SLC,PHX,"Salt Lake City, UT",Utah,"Phoenix, AZ",Arizona,890,2006,-5,5,885,2011,24,16,909,1995,668,89,109,129,0,,0,0.0,0.0,0.0,0.0,0.0
2024,9,10,2,2024-09-10,AS,360,SAN,PHX,"San Diego, CA",California,"Phoenix, AZ",Arizona,872,1932,-5,0,867,1932,19,17,886,1915,1015,121,141,157,0,,0,0.0,0.0,0.0,0.0,0.0
2024,10,30,3,2024-10-30,UA,3896,DCA,BOS,"Washington, DC",District of Columbia,"Boston, MA",Massachusetts,1568,1175,0,-5,1568,1170,18,14,1586,1156,440,50,70,82,0,,0,0.0,0.0,0.0,0.0,0.0
2024,5,9,4,2024-05-09,DL,6082,LAX,DFW,"Los Angeles, CA",California,"Dallas/Fort Worth, TX",Texas,1920,1144,-6,-5,1914,1139,13,4,1927,1135,1490,180,200,197,0,,0,0.0,0.0,0.0,0.0,0.0
2024,3,24,7,2024-03-24,WN,600,SFO,DCA,"San Francisco, CA",California,"Washington, DC",District of Columbia,761,657,-3,0,758,657,25,18,783,639,1168,147,167,190,0,,0,0.0,0.0,0.0,0.0,0.0
2024,10,2,3,2024-10-02,B6,1115,IAD,SAN,"Washington, DC",District of Columbia,"San Diego, CA",California,1430,663,4,-5,1434,658,22,17,1456,641,2346,296,316,335,0,,0,0.0,0.0,0.0,0.0,0.0
2024,7,5,5,2024-07-05,OO,8205,IAH,SEA,"Houston, TX",Texas,"Seattle, WA",Washington,2002,1498,-2,-10,2000,1488,21,10,2021,1478,2744,342,362,373,0,,0,0.0,0.0,0.0,0.0,0.0
2024,2,15,4,2024-02-15,9E,7764,SAN,IAH,"San Diego, CA",California,"Houston, TX",Texas,1245,724,9,0,1254,724,9,4,1263,720,239,29,49,42,0,,0,0.0,0.0,0.0,0.0,0.0
2024,7,1,1,2024-07-01,G4,4063,MDW,PDX,"Chicago, IL",Illinois,"Portland, OR",Oregon,1064,660,-9,-5,1055,655,19,16,1074,639,888,112,132,147,0,,0,0.0,0.0,0.0,0.0,0.0
2024,9,24,2,2024-09-24,UA,5418,PDX,HNL,"Portland, OR",Oregon,"Honolulu, HI",Hawaii,2008,979,-16,-20,1992,959,28,6,2020,953,2319,286,306,320,0,,0,0.0,0.0,0.0,0.0,0.0
2024,10,22,2,2024-10-22,UA,2806,SLC,HNL,"Salt Lake City, UT",Utah,"Honolulu, HI",Hawaii,2270,1577,-26,-20,2244,1557,15,13,2259,1544,2611,316,336,344,0,,0,0.0,0.0,0.0,0.0,0.0
2024,11,17,7,2024-11-17,AS,6235,DTW,IAD,"Detroit, MI",Michigan,"Washington, DC",District of Columbia,2231,1761,-17,-10,2214,1751,26,19,2240,1732,1118,148,168,193,0,,0,0.0,0.0,0.0,0.0,0.0
2024,4,9,2,2024-04-09,B6,5881,MCO,IAD,"Orlando, FL",Florida,"Washington, DC",District of Columbia,1015,665,8,0,1023,665,16,9,1039,656,2230,277,297,302,0,,0,0.0,0.0,0.0,0.0,0.0
2024,3,18,1,2024-03-18,AS,2199,DFW,MCO,"Dallas/Fort Worth, TX",Texas,"Orlando, FL",Florida,2095,1802,3,-5,2098,1797,11,3,2109,1794,432,45,65,59,0,,0,0.0,0.0,0.0,0.0,0.0
2024,9,28,6,2024-09-28,NK,6486,MDW,DCA,"Chicago, IL",Illinois,"Washington, DC",District of Columbia,1184,1397,-21,-20,1163,1377,29,11,1192,1366,2550,317,337,357,0,,0,0.0,0.0,0.0,0.0,0.0
2024,12,4,3,2024-12-04,OO,5438,LAS,HNL,"Las Vegas, NV",Nevada,"Honolulu, HI",Hawaii,2107,1794,-13,-10,2094,1784,24,19,2118,1765,1302,167,187,210,0,,0,0.0,0.0,0.0,0.0,0.0
2024,6,10,1,2024-06-10,UA,2665,HNL,MSP,"Honolulu, HI",Hawaii,"Minneapolis, MN",Minnesota,985,1354,-6,-15,979,1339,25,3,1004,1336,2754,351,371,379,0,,0,0.0,0.0,0.0,0.0,0.0
2024,2,13,2,2024-02-13,HA,8400,SEA,DFW,"Seattle, WA",Washington,"Dallas/Fort Worth, TX",Texas,2110,1231,5,15,2115,1246,13,4,2128,1242,1535,185,205,202,0,,0,0.0,0.0,0.0,0.0,0.0
2024,8,25,7,2024-08-25,MQ,5116,STL,IAH,"St. Louis, MO",Missouri,"Houston, TX",Texas,1333,1967,4,-5,1337,1962,7,13,1344,1949,378,48,68,68,0,,0,0.0,0.0,0.0,0.0,0.0
2024,5,13,1,2024-05-13,B6,8357,DFW,MCO,"Dallas/Fort Worth, TX",Texas,"Orlando, FL",Florida,965,2327,-18,-20,947,2307,21,12,968,2295,1076,125,145,158,0,,0,0.0,0.0,0.0,0.0,0.0
2024,7,10,3,2024-07-10,F9,3181,MCO,SFO,"Orlando, FL",Florida,"San Francisco, CA",California,965,1810,1,5,966,1815,28,12,994,1803,1397,164,184,204,0,,0,0.0,0.0,0.0,0.0,0.0
2024,12,21,6,2024-12-21,WN,4397,SFO,ATL,"San Francisco, CA",California,"Atlanta, GA",Georgia,521,1557,-19,-10,502,1547,13,3,515,1544,1258,148,168,164,0,,0,0.0,0.0,0.0,0.0,0.0
2024,10,4,5,2024-10-04,9E,6013,DCA,CLT,"Washington, DC",District of Columbia,"Charlotte, NC",North Carolina,895,826,-2,0,893,826,15,5,908,821,1311,164,184,184,0,,0,0.0,0.0,0.0,0.0,0.0
2024,1,18,4,2024-01-18,DL,3048,DCA,LAX,"Washington, DC",District of Columbia,"Los Angeles, CA",California,1732,1889,-2,-10,1730,1879,18,18,1748,1861,2711,338,358,374,0,,0,0.0,0.0,0.0,0.0,0.0
2024,1,12,5,2024-01-12,WN,8505,DCA,LAX,"Washington, DC",District of Columbia,"Los Angeles, CA",California,2086,791,28,30,2114,821,14,15,2128,806,2949,358,378,387,0,,0,6.0,5.0,0.0,0.0,19.0
2024,6,28,5,2024-06-28,DL,6311,JFK,DTW,"New York, NY",New York,"Detroit, MI",Michigan,644,1351,26,20,670,1371,8,11,678,1360,363,45,65,64,0,,0,7.0,0.0,0.0,0.0,13.0
2024,5,2,4,2024-05-02,UA,1140,MIA,DCA,"Miami, FL",Florida,"Washington, DC",District of Columbia,919,2229,12,5,931,2234,20,10,951,2224,1299,158,178,188,0,,0,0.0,0.0,0.0,0.0,0.0
2024,9,2,1,2024-09-02,WN,8088,DEN,BOS,"Denver, CO",Colorado,"Boston, MA",Massachusetts,1872,1749,4,5,1876,1754,20,13,1896,1741,2435,301,321,334,0,,0,0.0,0.0,0.0,0.0,0.0
2024,8,9,5,2024-08-09,WN,7573,SAN,PHX,"San Diego, CA",California,"Phoenix, AZ",Arizona,804,1555,-15,-5,789,1550,16,11,805,1539,2327,294,314,321,0,,0,0.0,0.0,0.0,0.0,0.0
2024,2,20,2,2024-02-20,9E,7659,IAH,BOS,"Houston, TX",Texas,"Boston, MA",Massachusetts,1500,2097,20,20,1520,2117,10,13,1530,2104,504,55,75,78,0,,0,5.0,3.0,1.0,0.0,11.0
2024,3,11,1,2024-03-11,G4,1087,PDX,SEA,"Portland, OR",Oregon,"Seattle, WA",Washington,543,698,3,-5,546,693,11,15,557,678,2572,329,349,355,0,,0,0.0,0.0,0.0,0.0,0.0
2024,2,17,6,2024-02-17,9E,3295,JFK,PHL,"New York, NY",New York,"Philadelphia, PA",Pennsylvania,606,943,-2,-10,604,933,27,16,631,917,310,33,53,76,0,,0,0.0,0.0,0.0,0.0,0.0
2024,1,19,5,2024-01-19,AS,5199,EWR,DCA,"Newark, NJ",New Jersey,"Washington, DC",District of Columbia,649,842,-24,-15,625,827,12,11,637,816,2935,358,378,381,0,,0,0.0,0.0,0.0,0.0,0.0
2024,9,18,3,2024-09-18,G4,603,DEN,DCA,"Denver, CO",Colorado,"Washington, DC",District of Columbia,2129,619,-16,-10,2113,609,10,5,2123,604,1645,207,227,222,0,,0,0.0,0.0,0.0,0.0,0.0
2024,3,24,7,2024-03-24,WN,5444,CLT,ATL,"Charlotte, NC",North Carolina,"Atlanta, GA",Georgia,1787,2252,-8,0,1779,2252,11,8,1790,2244,1095,142,162,161,0,,0,0.0,0.0,0.0,0.0,0.0
2024,6,3,1,2024-06-03,G4,9047,IAH,LAX,"Houston, TX",Texas,"Los Angeles, CA",California,609,958,-8,-10,601,948,13,16,614,932,2855,346,366,375,0,,0,0.0,0.0,0.0,0.0,0.0
2024,2,22,4,2024-02-22,OO,9633,SEA,LGA,"Seattle, WA",Washington,"New York, NY",New York,1541,1032,1,5,1542,1037,20,15,1562,1022,2246,284,304,319,0,,0,0.0,0.0,0.0,0.0,0.0
2024,4,16,2,2024-04-16,MQ,8248,LGA,SFO,"New York, NY",New York,"San Francisco, CA",California,1249,1599,-5,-5,1244,1594,26,3,1270,1591,1071,127,147,156,0,,0,0.0,0.0,0.0,0.0,0.0
2024,12,22,7,2024-12-22,G4,6110,SEA,LAS,"Seattle, WA",Washington,"Las Vegas, NV",Nevada,1859,1210,16,10,1875,1220,17,16,1892,1204,1042,139,159,172,0,,0,0.0,0.0,0.0,0.0,0.0
2024,10,30,3,2024-10-30,AS,1481,SLC,HNL,"Salt Lake City, UT",Utah,"Honolulu, HI",Hawaii,738,1086,-10,0,728,1086,19,14,747,1072,690,86,106,119,0,,0,0.0,0.0,0.0,0.0,0.0
2024,5,14,2,2024-05-14,B6,5702,PDX,MDW,"Portland, OR",Oregon,"Chicago, IL",Illinois,1223,929,-7,0,1216,929,22,5,1238,924,888,102,122,129,0,,0,0.0,0.0,0.0,0.0,0.0
2024,3,9,6,2024-03-09,UA,7112,ORD,MSP,"Chicago, IL",Illinois,"Minneapolis, MN",Minnesota,1242,2290,-10,0,1232,2290,8,16,1240,2274,1235,146,166,170,0,,0,0.0,0.0,0.0,0.0,0.0
2024,1,11,4,2024-01-11,OH,3826,IAD,MCO,"Washington, DC",District of Columbia,"Orlando, FL",Florida,827,1930,8,10,835,1940,9,4,844,1936,2543,322,342,335,0,,0,0.0,0.0,0.0,0.0,0.0
2024,5,22,3,2024-05-22,HA,1987,IAH,MSP,"Houston, TX",Texas,"Minneapolis, MN",Minnesota,1361,784,-8,-15,1353,769,12,12,1365,757,2853,346,366,370,0,,0,0.0,0.0,0.0,0.0,0.0
2024,7,10,3,2024-07-10,B6,9615,PDX,TPA,"Portland, OR",Oregon,"Tampa, FL",Florida,1817,934,-9,-15,1808,919,8,6,1816,913,1563,194,214,208,0,,0,0.0,0.0,0.0,0.0,0.0
2024,3,9,6,2024-03-09,HA,3909,EWR,DTW,"Newark, NJ",New Jersey,"Detroit, MI",Michigan,1936,1105,13,5,1949,1110,21,9,1970,1101,352,39,59,69,0,,0,0.0,0.0,0.0,0.0,0.0
2024,1,23,2,2024-01-23,UA,2231,ATL,CLT,"Atlanta, GA",Georgia,"Charlotte, NC",North Carolina,960,1062,9,5,969,1067,21,19,990,1048,1657,207,227,247,0,,0,0.0,0.0,0.0,0.0,0.0
2024,6,29,6,2024-06-29,B6,2524,DFW,PDX,"Dallas/Fort Worth, TX",Texas,"Portland, OR",Oregon,1604,1594,-6,-5,1598,1589,6,12,1604,1577,553,60,80,78,0,,0,0.0,0.0,0.0,0.0,0.0
2024,10,19,6,2024-10-19,B6,5539,HNL,LAS,"Honolulu, HI",Hawaii,"Las Vegas, NV",Nevada,1778,602,-4,-5,1774,597,28,4,1802,593,2282,285,305,317,0,,0,0.0,0.0,0.0,0.0,0.0
2024,1,9,2,2024-01-09,DL,5574,ORD,IAH,"Chicago, IL",Illinois,"Houston, TX",Texas,1243,1268,-5,-10,1238,1258,20,17,1258,1241,379,50,70,87,0,,0,0.0,0.0,0.0,0.0,0.0
2024,9,27,5,2024-09-27,OH,9300,DCA,DTW,"Washington, DC",District of Columbia,"Detroit, MI",Michigan,862,774,-9,-10,853,764,23,14,876,750,2286,282,302,319,0,,0,0.0,0.0,0.0,0.0,0.0
2024,4,2,2,2024-04-02,OH,1417,DCA,MIA,"Washington, DC",District of Columbia,"Miami, FL",Florida,2244,2204,5,15,2249,2219,26,3,2275,2216,1926,244,264,273,0,,0,0.0,0.0,0.0,0.0,0.0
2024,1,17,3,2024-01-17,G4,6747,BWI,PDX,"Baltimore, MD",Maryland,"Portland, OR",Oregon,1980,2156,-8,-10,1972,2146,11,12,1983,2134,858,110,130,133,0,,0,0.0,0.0,0.0,0.0,0.0
2024,6,2,7,2024-06-02,HA,3316,PDX,PHX,"Portland, OR",Oregon,"Phoenix, AZ",Arizona,1397,1599,-7,0,1390,1599,15,11,1405,1588,1842,225,245,251,0,,0,0.0,0.0,0.0,0.0,0.0
2024,11,23,6,2024-11-23,NK,116,PDX,SFO,"Portland, OR",Oregon,"San Francisco, CA",California,942,897,14,5,956,902,5,16,961,886,2365,298,318,319,0,,0,0.0,0.0,0.0,0.0,0.0
2024,5,28,2,2024-05-28,OH,4770,IAH,MSP,"Houston, TX",Texas,"Minneapolis, MN",Minnesota,1385,717,-19,-20,1366,697,25,11,1391,686,919,121,141,157,0,,0,0.0,0.0,0.0,0.0,0.0
2024,9,23,1,2024-09-23,AS,2723,DFW,SLC,"Dallas/Fort Worth, TX",Texas,"Salt Lake City, UT",Utah,1483,1388,-12,-20,1471,1368,22,12,1493,1356,1178,153,173,187,0,,0,0.0,0.0,0.0,0.0,0.0
2024,11,23,6,2024-11-23,B6,229,HNL,IAH,"Honolulu, HI",Hawaii,"Houston, TX",Texas,2056,1241,-1,-5,2055,1236,11,12,2066,1224,1046,128,148,151,0,,0,0.0,0.0,0.0,0.0,0.0
2024,4,15,1,2024-04-15,HA,1573,MDW,IAD,"Chicago, IL",Illinois,"Washington, DC",District of Columbia,1761,805,3,5,1764,810,17,13,1781,797,1496,196,216,226,0,,0,0.0,0.0,0.0,0.0,0.0
2024,2,4,7,2024-02-04,WN,9241,PHL,PDX,"Philadelphia, PA",Pennsylvania,"Portland, OR",Oregon,760,2332,-14,-10,746,2322,7,5,753,2317,1750,220,240,232,0,,0,0.0,0.0,0.0,0.0,0.0
2024,4,28,7,2024-04-28,F9,9360,HNL,DEN,"Honolulu, HI",Hawaii,"Denver, CO",Colorado,1796,1758,-25,-20,1771,1738,13,14,1784,1724,367,44,64,71,0,,0,0.0,0.0,0.0,0.0,0.0
2024,1,14,7,2024-01-14,DL,4411,STL,ATL,"St. Louis, MO",Missouri,"Atlanta, GA",Georgia,779,1826,-12,-10,767,1816,21,5,788,1811,274,38,58,64,0,,0,0.0,0.0,0.0,0.0,0.0
2024,1,14,7,2024-01-14,F9,9915,BOS,PHX,"Boston, MA",Massachusetts,"Phoenix, AZ",Arizona,1425,1658,-8,-15,1417,1643,6,14,1423,1629,1860,232,252,252,0,,0,0.0,0.0,0.0,0.0,0.0
2024,9,22,7,2024-09-22,AA,2995,HNL,SAN,"Honolulu, HI",Hawaii,"San Diego, CA",California,1445,629,-13,-10,1432,619,19,13,1451,606,2935,357,377,389,0,,0,0.0,0.0,0.0,0.0,0.0
2024,5,19,7,2024-05-19,9E,2836,ORD,ATL,"Chicago, IL",Illinois,"Atlanta, GA",Georgia,1673,2051,2,-5,1675,2046,13,16,1688,2030,256,32,52,61,0,,0,0.0,0.0,0.0,0.0,0.0
2024,10,20,7,2024-10-20,AA,5198,MDW,PHL,"Chicago, IL",Illinois,"Philadelphia, PA",Pennsylvania,651,1541,-13,-15,638,1526,11,19,649,1507,2936,358,378,388,0,,0,0.0,0.0,0.0,0.0,0.0
2024,12,29,7,2024-12-29,UA,2046,DTW,LAX,"Detroit, MI",Michigan,"Los Angeles, CA",California,1293,1422,1,5,1294,1427,23,14,1317,1413,1958,242,262,279,0,,0,0.0,0.0,0.0,0.0,0.0
2024,4,28,7,2024-04-28,B6,5659,TPA,LGA,"Tampa, FL",Florida,"New York, NY",New York,2096,856,-9,-10,2087,846,15,6,2102,840,1609,198,218,219,0,,0,0.0,0.0,0.0,0.0,0.0
2024,8,25,7,2024-08-25,OH,8908,IAD,LAX,"Washington, DC",District of Columbia,"Los Angeles, CA",California,2171,2004,-1,5,2170,2009,28,7,2198,2002,1640,196,216,231,0,,0,0.0,0.0,0.0,0.0,0.0
2024,2,3,6,2024-02-03,AS,400,PHX,DCA,"Phoenix, AZ",Arizona,"Washington, DC",District of Columbia,1535,781,5,0,1540,781,25,5,1565,776,972,116,136,146,0,,0,0.0,0.0,0.0,0.0,0.0
2024,6,17,1,2024-06-17,WN,9276,PDX,LAX,"Portland, OR",Oregon,"Los Angeles, CA",California,513,807,7,10,520,817,22,17,542,800,1286,151,171,190,0,,0,0.0,0.0,0.0,0.0,0.0
2024,1,10,3,2024-01-10,NK,4601,ATL,JFK,"Atlanta, GA",Georgia,"New York, NY",New York,2034,1478,-19,-15,2015,1463,21,7,2036,1456,1279,156,176,184,0,,0,0.0,0.0,0.0,0.0,0.0
2024,5,1,3,2024-05-01,NK,8452,HNL,PDX,"Honolulu, HI",Hawaii,"Portland, OR",Oregon,2065,2264,-20,-10,2045,2254,26,19,2071,2235,2991,363,383,408,0,,0,0.0,0.0,0.0,0.0,0.0
2024,5,24,5,2024-05-24,DL,6014,DEN,EWR,"Denver, CO",Colorado,"Newark, NJ",New Jersey,1450,2198,1,10,1451,2208,8,6,1459,2202,2663,327,347,341,0,,0,0.0,0.0,0.0,0.0,0.0
2024,8,10,6,2024-08-10,DL,5771,LGA,LAS,"New York, NY",New York,"Las Vegas, NV",Nevada,1366,2062,8,10,1374,2072,6,15,1380,2057,1110,128,148,149,0,,0,0.0,0.0,0.0,0.0,0.0
2024,9,13,5,2024-09-13,DL,8317,LAS,MSP,"Las Vegas, NV",Nevada,"Minneapolis, MN",Minnesota,944,941,-6,-10,938,931,21,5,959,926,900,115,135,141,0,,0,0.0,0.0,0.0,0.0,0.0
2024,9,24,2,2024-09-24,HA,182,DCA,LGA,"Washington, DC",District of Columbia,"New York, NY",New York,1841,2212,-19,-15,1822,2197,27,16,1849,2181,467,51,71,94,0,,0,0.0,0.0,0.0,0.0,0.0
2024,12,24,2,2024-12-24,OH,8464,SLC,IAD,"Salt Lake City, UT",Utah,"Washington, DC",District of Columbia,1298,977,6,10,1304,987,24,19,1328,968,1112,148,168,191,0,,0,0.0,0.0,0.0,0.0,0.0
2024,1,4,4,2024-01-04,HA,1098,SFO,SLC,"San Francisco, CA",California,"Salt Lake City, UT",Utah,1231,1010,-1,-10,1230,1000,5,6,1235,994,1057,137,157,148,0,,0,0.0,0.0,0.0,0.0,0.0
2024,12,19,4,2024-12-19,DL,5904,SAN,EWR,"San Diego, CA",California,"Newark, NJ",New Jersey,737,2150,12,10,749,2160,17,12,766,2148,371,38,58,67,0,,0,0.0,0.0,0.0,0.0,0.0
2024,4,15,1,2024-04-15,MQ,7037,SFO,SEA,"San Francisco, CA",California,"Seattle, WA",Washington,1038,982,13,20,1051,1002,14,11,1065,991,926,109,129,134,0,,0,0.0,4.0,3.0,0.0,13.0
2024,3,25,1,2024-03-25,G4,3241,CLT,BWI,"Charlotte, NC",North Carolina,"Baltimore, MD",Maryland,1268,2088,-2,-10,1266,2078,21,10,1287,2068,2523,318,338,349,0,,0,0.0,0.0,0.0,0.0,0.0
2024,8,1,4,2024-08-01,OH,2982,PDX,EWR,"Portland, OR",Oregon,"Newark, NJ",New Jersey,1308,2016,9,10,1317,2026,27,3,1344,2023,536,68,88,98,0,,0,0.0,0.0,0.0,0.0,0.0
2024,4,30,2,2024-04-30,B6,7462,IAD,PDX,"Washington, DC",District of Columbia,"Portland, OR",Oregon,2177,1436,-12,-5,2165,1431,25,5,2190,1426,2683,330,350,360,0,,0,0.0,0.0,0.0,0.0,0.0
2024,5,11,6,2024-05-11,OO,3184,LAS,PHX,"Las Vegas, NV",Nevada,"Phoenix, AZ",Arizona,1261,1170,6,5,1267,1175,21,16,1288,1159,1715,217,237,254,0,,0,0.0,0.0,0.0,0.0,0.0
2024,12,3,2,2024-12-03,F9,2145,MSP,ATL,"Minneapolis, MN",Minnesota,"Atlanta, GA",Georgia,573,1774,-13,-5,560,1769,15,16,575,1753,2639,337,357,368,0,,0,0.0,0.0,0.0,0.0,0.0
2024,7,15,1,2024-07-15,B6,9052,DEN,LAS,"Denver, CO",Colorado,"Las Vegas, NV",Nevada,1957,2243,-18,-15,1939,2228,13,12,1952,2216,1474,174,194,199,0,,0,0.0,0.0,0.0,0.0,0.0
2024,1,19,5,2024-01-19,MQ,304,LAS,SFO,"Las Vegas, NV",Nevada,"San Francisco, CA",California,1821,968,11,5,1832,973,7,5,1839,968,1337,164,184,176,0,,0,0.0,0.0,0.0,0.0,0.0
2024,5,9,4,2024-05-09,OO,5384,BOS,EWR,"Boston, MA",Massachusetts,"Newark, NJ",New Jersey,2234,1730,-15,-10,2219,1720,14,4,2233,1716,662,78,98,96,0,,0,0.0,0.0,0.0,0.0,0.0
2024,1,12,5,2024-01-12,B6,1652,DTW,EWR,"Detroit, MI",Michigan,"Newark, NJ",New Jersey,795,1762,17,15,812,1777,21,9,833,1768,414,60,80,90,0,,0,0.0,0.0,0.0,0.0,0.0
2024,3,21,4,2024-03-21,AA,7916,DFW,PHL,"Dallas/Fort Worth, TX",Texas,"Philadelphia, PA",Pennsylvania,513,879,2,-5,515,874,20,6,535,868,2709,339,359,365,0,,0,0.0,0.0,0.0,0.0,0.0
2024,11,25,1,2024-11-25,AS,924,MSP,DEN,"Minneapolis, MN",Minnesota,"Denver, CO",Colorado,1111,671,-10,-15,1101,656,20,14,1121,642,559,68,88,102,0,,0,0.0,0.0,0.0,0.0,0.0
2024,12,19,4,2024-12-19,WN,3848,ORD,PHX,"Chicago, IL",Illinois,"Phoenix, AZ",Arizona,2126,1222,-10,-10,2116,1212,19,9,2135,1203,1077,129,149,157,0,,0,0.0,0.0,0.0,0.0,0.0
2024,9,18,3,2024-09-18,HA,5678,LAS,SFO,"Las Vegas, NV",Nevada,"San Francisco, CA",California,894,1104,13,10,907,1114,17,5,924,1109,482,55,75,77,0,,0,0.0,0.0,0.0,0.0,0.0
2024,5,4,6,2024-05-04,UA,6012,MDW,MCO,"Chicago, IL",Illinois,"Orlando, FL",Florida,690,1549,-15,-5,675,1544,6,4,681,1540,1714,216,236,226,0,,0,0.0,0.0,0.0,0.0,0.0
2024,11,2,6,2024-11-02,AS,7490,MSP,JFK,"Minneapolis, MN",Minnesota,"New York, NY",New York,1316,705,11,10,1327,715,10,14,1337,701,2452,308,328,332,0,,0,0.0,0.0,0.0,0.0,0.0
2024,9,23,1,2024-09-23,DL,5297,PHL,DFW,"Philadelphia, PA",Pennsylvania,"Dallas/Fort Worth, TX",Texas,1944,2124,-1,-10,1943,2114,7,8,1950,2106,494,58,78,73,0,,0,0.0,0.0,0.0,0.0,0.0
2024,5,19,7,2024-05-19,F9,9130,MCO,PDX,"Orlando, FL",Florida,"Portland, OR",Oregon,605,758,-5,0,600,758,28,13,628,745,562,76,96,117,0,,0,0.0,0.0,0.0,0.0,0.0
2024,11,24,7,2024-11-24,AA,4795,SEA,PHL,"Seattle, WA",Washington,"Philadelphia, PA",Pennsylvania,1917,1773,6,10,1923,1783,5,15,1928,1768,1441,185,205,205,0,,0,0.0,0.0,0.0,0.0,0.0
2024,1,2,2,2024-01-02,YX,6868,STL,JFK,"St. Louis, MO",Missouri,"New York, NY",New York,1961,613,-20,-20,1941,593,21,17,1962,576,1030,135,155,173,0,,0,0.0,0.0,0.0,0.0,0.0
2024,1,8,1,2024-01-08,G4,3783,IAD,SAN,"Washington, DC",District of Columbia,"San Diego, CA",California,506,604,-15,-5,491,599,28,8,519,591,691,80,100,116,0,,0,0.0,0.0,0.0,0.0,0.0
2024,9,6,5,2024-09-06,F9,2061,ATL,PDX,"Atlanta, GA",Georgia,"Portland, OR",Oregon,1604,1618,7,15,1611,1633,5,10,1616,1623,274,32,52,47,0,,0,0.0,0.0,0.0,0.0,0.0
2024,5,18,6,2024-05-18,AA,1037,SFO,MSP,"San Francisco, CA",California,"Minneapolis, MN",Minnesota,1264,2262,2,0,1266,2262,15,10,1281,2252,562,76,96,101,0,,0,0.0,0.0,0.0,0.0,0.0
2024,5,3,5,2024-05-03,9E,7695,MIA,IAD,"Miami, FL",Florida,"Washington, DC",District of Columbia,1151,1896,0,5,1151,1901,8,8,1159,1893,2938,362,382,378,0,,0,0.0,0.0,0.0,0.0,0.0
2024,11,4,1,2024-11-04,YX,524,JFK,ATL,"New York, NY",New York,"Atlanta, GA",Georgia,984,1961,9,10,993,1971,15,10,1008,1961,279,28,48,53,0,,0,0.0,0.0,0.0,0.0,0.0
2024,8,15,4,2024-08-15,HA,3151,SLC,MCO,"Salt Lake City, UT",Utah,"Orlando, FL",Florida,1880,810,-4,0,1876,810,17,19,1893,791,1464,183,203,219,0,,0,0.0,0.0,0.0,0.0,0.0
2024,1,10,3,2024-01-10,G4,3005,LAX,LAS,"Los Angeles, CA",California,"Las Vegas, NV",Nevada,1834,926,10,10,1844,936,26,9,1870,927,2459,310,330,345,0,,0,0.0,0.0,0.0,0.0,0.0
2024,7,30,2,2024-07-30,DL,2794,BOS,LGA,"Boston, MA",Massachusetts,"New York, NY",New York,1431,1457,4,0,1435,1457,21,5,1456,1452,590,65,85,91,0,,0,0.0,0.0,0.0,0.0,0.0
2024,4,21,7,2024-04-21,UA,3695,TPA,ATL,"Tampa, FL",Florida,"Atlanta, GA",Georgia,1005,2352,5,5,1010,2357,24,11,1034,2346,1654,213,233,248,0,,0,0.0,0.0,0.0,0.0,0.0
2024,1,8,1,2024-01-08,DL,1367,LAS,DCA,"Las Vegas, NV",Nevada,"Washington, DC",District of Columbia,1018,1065,-3,-10,1015,1055,25,19,1040,1036,1803,229,249,273,0,,0,0.0,0.0,0.0,0.0,0.0
2024,10,18,5,2024-10-18,MQ,521,MDW,LAS,"Chicago, IL",Illinois,"Las Vegas, NV",Nevada,2187,1702,5,15,2192,1717,17,11,2209,1706,1317,172,192,200,0,,0,0.0,0.0,0.0,0.0,0.0
2024,12,27,5,2024-12-27,OH,3366,SFO,CLT,"San Francisco, CA",California,"Charlotte, NC",North Carolina,1301,2228,8,5,1309,2233,21,16,1330,2217,1866,236,256,273,0,,0,0.0,0.0,0.0,0.0,0.0
2024,9,9,1,2024-09-09,F9,7117,BWI,PHX,"Baltimore, MD",Maryland,"Phoenix, AZ",Arizona,2161,1345,-9,-10,2152,1335,6,3,2158,1332,2850,364,384,373,0,,0,0.0,0.0,0.0,0.0,0.0
2024,1,14,7,2024-01-14,DL,9949,IAH,LAS,"Houston, TX",Texas,"Las Vegas, NV",Nevada,948,776,-10,0,938,776,6,8,944,768,2151,275,295,289,0,,0,0.0,0.0,0.0,0.0,0.0
2024,8,27,2,2024-08-27,9E,2200,DEN,LAS,"Denver, CO",Colorado,"Las Vegas, NV",Nevada,784,731,2,-5,786,726,26,19,812,707,2925,358,378,403,0,,0,0.0,0.0,0.0,0.0,0.0
2024,8,29,4,2024-08-29,DL,7229,DFW,MCO,"Dallas/Fort Worth, TX",Texas,"Orlando, FL",Florida,1805,1376,11,5,1816,1381,22,19,1838,1362,2624,325,345,366,0,,0,0.0,0.0,0.0,0.0,0.0
2024,12,7,6,2024-12-07,HA,8195,SEA,ORD,"Seattle, WA",Washington,"Chicago, IL",Illinois,573,1915,48,45,621,1960,10,7,631,1953,2181,281,301,298,0,,0,9.0,10.0,4.0,1.0,21.0
2024,5,28,2,2024-05-28,AA,8976,JFK,MCO,"New York, NY",New York,"Orlando, FL",Florida,544,2314,-19,-20,525,2294,29,19,554,2275,1533,184,204,232,0,,0,0.0,0.0,0.0,0.0,0.0
2024,8,23,5,2024-08-23,NK,2326,IAD,SAN,"Washington, DC",District of Columbia,"San Diego, CA",California,2052,2001,10,20,2062,2021,6,17,2068,2004,2847,356,376,379,0,,0,5.0,0.0,3.0,0.0,12.0
2024,11,1,5,2024-11-01,YX,4488,BOS,PDX,"Boston, MA",Massachusetts,"Portland, OR",Oregon,1244,1015,-7,-15,1237,1000,27,5,1264,995,1174,141,161,173,0,,0,0.0,0.0,0.0,0.0,0.0
2024,6,15,6,2024-06-15,DL,2522,MIA,MCO,"Miami, FL",Florida,"Orlando, FL",Florida,1175,943,-7,0,1168,943,15,16,1183,927,866,106,126,137,0,,0,0.0,0.0,0.0,0.0,0.0
2024,1,20,6,2024-01-20,9E,7326,IAD,LAS,"Washington, DC",District of Columbia,"Las Vegas, NV",Nevada,1980,2000,-6,0,1974,2000,21,3,1995,1997,2892,353,373,377,0,,0,0.0,0.0,0.0,0.0,0.0
2024,8,3,6,2024-08-03,B6,9369,MIA,MCO,"Miami, FL",Florida,"Orlando, FL",Florida,1074,1084,-16,-10,1058,1074,13,19,1071,1055,526,61,81,93,0,,0,0.0,0.0,0.0,0.0,0.0
2024,12,8,7,2024-12-08,B6,7416,SEA,JFK,"Seattle, WA",Washington,"New York, NY",New York,1930,1769,-9,0,1921,1769,24,3,1945,1766,1793,227,247,254,0,,0,0.0,0.0,0.0,0.0,0.0
2024,5,14,2,2024-05-14,UA,2943,LGA,DFW,"New York, NY",New York,"Dallas/Fort Worth, TX",Texas,592,2278,10,10,602,2288,9,19,611,2269,2796,358,378,386,0,,0,0.0,0.0,0.0,0.0,0.0
2024,5,8,3,2024-05-08,UA,4211,DTW,MSP,"Detroit, MI",Michigan,"Minneapolis, MN",Minnesota,821,2155,-18,-10,803,2145,24,6,827,2139,2980,376,396,406,0,,0,0.0,0.0,0.0,0.0,0.0
2024,10,20,7,2024-10-20,MQ,5759,STL,MSP,"St. Louis, MO",Missouri,"Minneapolis, MN",Minnesota,965,2193,-18,-15,947,2178,19,3,966,2175,1457,183,203,205,0,,0,0.0,0.0,0.0,0.0,0.0
2024,9,2,1,2024-09-02,YX,2003,PHX,ORD,"Phoenix, AZ",Arizona,"Chicago, IL",Illinois,1103,1919,-9,0,1094,1919,29,5,1123,1914,834,97,117,131,0,,0,0.0,0.0,0.0,0.0,0.0
2024,7,7,7,2024-07-07,UA,4324,PHL,MIA,"Philadelphia, PA",Pennsylvania,"Miami, FL",Florida,1384,1177,-2,5,1382,1182,21,5,1403,1177,2382,292,312,318,0,,0,0.0,0.0,0.0,0.0,0.0
2024,2,13,2,2024-02-13,AS,5079,IAH,DTW,"Houston, TX",Texas,"Detroit, MI",Michigan,1506,944,16,20,1522,964,14,14,1536,950,1653,198,218,226,0,,0,1.0,1.0,2.0,0.0,16.0
2024,3,26,2,2024-03-26,OH,5463,BOS,MSP,"Boston, MA",Massachusetts,"Minneapolis, MN",Minnesota,1053,2020,-2,-10,1051,2010,10,13,1061,1997,801,93,113,116,0,,0,0.0,0.0,0.0,0.0,0.0
2024,2,13,2,2024-02-13,WN,525,SLC,ATL,"Salt Lake City, UT",Utah,"Atlanta, GA",Georgia,1252,1074,23,15,1275,1089,17,7,1292,1082,950,112,132,136,0,,0,0.0,0.0,0.0,0.0,0.0
2024,11,25,1,2024-11-25,MQ,2501,BWI,SLC,"Baltimore, MD",Maryland,"Salt Lake City, UT",Utah,826,1124,-4,0,822,1124,25,15,847,1109,2433,300,320,340,0,,0,0.0,0.0,0.0,0.0,0.0
2024,5,24,5,2024-05-24,UA,9041,SAN,DTW,"San Diego, CA",California,"Detroit, MI",Michigan,2290,2197,-13,-10,2277,2187,20,14,2297,2173,273,37,57,71,0,,0,0.0,0.0,0.0,0.0,0.0
2024,2,20,2,2024-02-20,DL,7348,CLT,DFW,"Charlotte, NC",North Carolina,"Dallas/Fort Worth, TX",Texas,2106,645,23,20,2129,665,28,4,2157,661,895,117,137,149,1,,0,2.0,1.0,2.0,0.0,15.0
2024,8,29,4,2024-08-29,MQ,143,PDX,SLC,"Portland, OR",Oregon,"Salt Lake City, UT",Utah,1227,2228,-17,-10,1210,2218,6,3,1216,2215,1073,131,151,140,0,,0,0.0,0.0,0.0,0.0,0.0
2024,10,20,7,2024-10-20,UA,6398,BOS,DCA,"Boston, MA",Massachusetts,"Washington, DC",District of Columbia,2091,1580,8,5,2099,1585,24,11,2123,1574,1451,176,196,211,0,,0,0.0,0.0,0.0,0.0,0.0
2024,2,20,2,2024-02-20,WN,5142,SEA,BWI,"Seattle, WA",Washington,"Baltimore, MD",Maryland,1090,2051,-5,5,1085,2056,9,5,1094,2051,1485,187,207,201,0,,0,0.0,0.0,0.0,0.0,0.0
2024,9,22,7,2024-09-22,AS,1659,MIA,PHL,"Miami, FL",Florida,"Philadelphia, PA",Pennsylvania,1938,1846,-11,-5,1927,1841,28,8,1955,1833,1232,151,171,187,0,,0,0.0,0.0,0.0,0.0,0.0
2024,4,29,1,2024-04-29,WN,6135,JFK,LAS,"New York, NY",New York,"Las Vegas, NV",Nevada,2022,622,5,5,2027,627,21,13,2048,614,264,31,51,65,0,,0,0.0,0.0,0.0,0.0,0.0
2024,7,18,4,2024-07-18,F9,7171,IAD,SLC,"Washington, DC",District of Columbia,"Salt Lake City, UT",Utah,1350,666,4,0,1354,666,11,13,1365,653,1017,136,156,160,0,,0,0.0,0.0,0.0,0.0,0.0
2024,9,4,3,2024-09-04,UA,4294,LAX,HNL,"Los Angeles, CA",California,"Honolulu, HI",Hawaii,939,1225,-1,-10,938,1215,28,17,966,1198,2998,382,402,427,0,,0,0.0,0.0,0.0,0.0,0.0
2024,3,10,7,2024-03-10,YX,4051,SEA,MIA,"Seattle, WA",Washington,"Miami, FL",Florida,2156,2106,8,5,2164,2111,21,8,2185,2103,2646,332,352,361,0,,0,0.0,0.0,0.0,0.0,0.0
2024,12,6,5,2024-12-06,UA,247,IAD,JFK,"Washington, DC",District of Columbia,"New York, NY",New York,1213,805,17,15,1230,820,9,10,1239,810,1025,134,154,153,0,,0,0.0,0.0,0.0,0.0,0.0
2024,2,26,1,2024-02-26,UA,2270,LAX,SAN,"Los Angeles, CA",California,"San Diego, CA",California,931,2201,-4,0,927,2201,10,11,937,2190,1869,233,253,254,0,,0,0.0,0.0,0.0,0.0,0.0
2024,2,8,4,2024-02-08,F9,8403,SLC,SFO,"Salt Lake City, UT",Utah,"San Francisco, CA",California,1447,2185,52,45,1499,2230,14,8,1513,2222,918,119,139,141,0,,0,8.0,7.0,7.0,0.0,23.0
2024,10,15,2,2024-10-15,WN,5218,STL,MSP,"St. Louis, MO",Missouri,"Minneapolis, MN",Minnesota,827,2276,-10,-5,817,2271,9,19,826,2252,1218,143,163,171,0,,0,0.0,0.0,0.0,0.0,0.0
2024,1,18,4,2024-01-18,AA,7255,CLT,PHX,"Charlotte, NC",North Carolina,"Phoenix, AZ",Arizona,1780,857,9,0,1789,857,18,18,1807,839,2549,320,340,356,0,,0,0.0,0.0,0.0,0.0,0.0
2024,8,7,3,2024-08-07,DL,7397,SFO,ORD,"San Francisco, CA",California,"Chicago, IL",Illinois,2165,1145,1,5,2166,1150,29,18,2195,1132,546,67,87,114,0,,0,0.0,0.0,0.0,0.0,0.0
2024,11,8,5,2024-11-08,MQ,4263,MSP,IAD,"Minneapolis, MN",Minnesota,"Washington, DC",District of Columbia,1360,1407,-12,-10,1348,1397,24,15,1372,1382,1105,139,159,178,0,,0,0.0,0.0,0.0,0.0,0.0
2024,8,31,6,2024-08-31,OH,8126,LAX,SEA,"Los Angeles, CA",California,"Seattle, WA",Washington,2077,852,6,15,2083,867,18,14,2101,853,2204,272,292,304,0,,0,0.0,0.0,0.0,0.0,0.0
2024,12,17,2,2024-12-17,9E,9119,MIA,SEA,"Miami, FL",Florida,"Seattle, WA",Washington,1597,2204,7,10,1604,2214,6,11,1610,2203,1907,236,256,253,0,,0,0.0,0.0,0.0,0.0,0.0
2024,10,30,3,2024-10-30,MQ,8167,LGA,TPA,"New York, NY",New York,"Tampa, FL",Florida,1757,1812,5,10,1762,1822,13,8,1775,1814,2796,340,360,361,0,,0,0.0,0.0,0.0,0.0,0.0
2024,10,24,4,2024-10-24,MQ,3039,SAN,CLT,"San Diego, CA",California,"Charlotte, NC",North Carolina,2044,752,-2,0,2042,752,22,6,2064,746,2557,315,335,343,0,,0,0.0,0.0,0.0,0.0,0.0
2024,10,9,3,2024-10-09,OH,5827,IAH,DEN,"Houston, TX",Texas,"Denver, CO",Colorado,2066,2338,6,10,2072,2348,22,8,2094,2340,939,125,145,155,0,,0,0.0,0.0,0.0,0.0,0.0
2024,3,14,4,2024-03-14,DL,8164,LGA,DTW,"New York, NY",New York,"Detroit, MI",Michigan,2131,676,-1,5,2130,681,26,19,2156,662,2197,275,295,320,0,,0,0.0,0.0,0.0,0.0,0.0
2024,4,19,5,2024-04-19,OH,3716,BWI,CLT,"Baltimore, MD",Maryland,"Charlotte, NC",North Carolina,1781,1302,6,0,1787,1302,13,12,1800,1290,2481,315,335,340,0,,0,0.0,0.0,0.0,0.0,0.0
2024,6,28,5,2024-06-28,UA,5505,SLC,MCO,"Salt Lake City, UT",Utah,"Orlando, FL",Florida,728,1139,11,15,739,1154,9,10,748,1144,1518,198,218,217,0,,0,0.0,0.0,0.0,0.0,0.0
2024,2,1,4,2024-02-01,AS,7385,JFK,EWR,"New York, NY",New York,"Newark, NJ",New Jersey,1768,1324,0,-5,1768,1319,22,5,1790,1314,2800,354,374,381,0,,0,0.0,0.0,0.0,0.0,0.0
2024,8,21,3,2024-08-21,F9,8451,HNL,MIA,"Honolulu, HI",Hawaii,"Miami, FL",Florida,1950,968,0,0,1950,968,16,17,1966,951,2505,316,336,349,0,,0,0.0,0.0,0.0,0.0,0.0
2024,10,8,2,2024-10-08,YX,5980,DCA,CLT,"Washington, DC",District of Columbia,"Charlotte, NC",North Carolina,2233,1167,-7,-10,2226,1157,10,13,2236,1144,863,105,125,128,0,,0,0.0,0.0,0.0,0.0,0.0
2024,1,25,4,2024-01-25,AA,1113,PHL,MDW,"Philadelphia, PA",Pennsylvania,"Chicago, IL",Illinois,1979,1223,7,15,1986,1238,21,8,2007,1230,1233,160,180,189,0,,0,0.0,0.0,0.0,0.0,0.0
2024,11,26,2,2024-11-26,G4,8843,SEA,LAX,"Seattle, WA",Washington,"Los Angeles, CA",California,1243,1777,-13,-10,1230,1767,18,11,1248,1756,2673,342,362,371,0,,0,0.0,0.0,0.0,0.0,0.0
2024,10,5,6,2024-10-05,AA,7491,SAN,DFW,"San Diego, CA",California,"Dallas/Fort Worth, TX",Texas,1996,754,-6,-10,1990,744,14,13,2004,731,1613,202,222,229,0,,0,0.0,0.0,0.0,0.0,0.0
2024,8,13,2,2024-08-13,9E,1275,EWR,DEN,"Newark, NJ",New Jersey,"Denver, CO",Colorado,1501,1393,-17,-15,1484,1378,23,5,1507,1373,2378,300,320,328,0,,0,0.0,0.0,0.0,0.0,0.0
2024,2,26,1,2024-02-26,DL,9455,PHL,DFW,"Philadelphia, PA",Pennsylvania,"Dallas/Fort Worth, TX",Texas,1310,870,5,0,1315,870,7,11,1322,859,389,39,59,57,0,,0,0.0,0.0,0.0,0.0,0.0
2024,6,28,5,2024-06-28,UA,5347,PHL,CLT,"Philadelphia, PA",Pennsylvania,"Charlotte, NC",North Carolina,2086,1161,-3,-10,2083,1151,14,15,2097,1136,617,77,97,106,0,,0,0.0,0.0,0.0,0.0,0.0
2024,8,19,1,2024-08-19,NK,7618,STL,IAD,"St. Louis, MO",Missouri,"Washington, DC",District of Columbia,2252,2132,2,5,2254,2137,18,7,2272,2130,2209,284,304,309,0,,0,0.0,0.0,0.0,0.0,0.0
2024,12,8,7,2024-12-08,G4,6390,STL,EWR,"St. Louis, MO",Missouri,"Newark, NJ",New Jersey,673,2013,-9,-5,664,2008,19,15,683,1993,2501,305,325,339,0,,0,0.0,0.0,0.0,0.0,0.0
2024,10,13,7,2024-10-13,UA,1408,JFK,LAX,"New York, NY",New York,"Los Angeles, CA",California,1598,1691,14,5,1612,1696,20,17,1632,1679,2065,248,268,285,0,,0,0.0,0.0,0.0,0.0,0.0
2024,3,4,1,2024-03-04,F9,9784,TPA,EWR,"Tampa, FL",Florida,"Newark, NJ",New Jersey,1622,731,-11,-10,1611,721,10,11,1621,710,877,113,133,134,0,,0,0.0,0.0,0.0,0.0,0.0
2024,8,19,1,2024-08-19,HA,9533,STL,TPA,"St. Louis, MO",Missouri,"Tampa, FL",Florida,1012,2293,-9,-10,1003,2283,18,9,1021,2274,796,102,122,129,0,,0,0.0,0.0,0.0,0.0,0.0
2024,10,15,2,2024-10-15,G4,4927,BOS,MDW,"Boston, MA",Massachusetts,"Chicago, IL",Illinois,1647,1444,11,10,1658,1454,8,5,1666,1449,2235,277,297,290,0,,0,0.0,0.0,0.0,0.0,0.0
2024,7,31,3,2024-07-31,9E,5364,BOS,ATL,"Boston, MA",Massachusetts,"Atlanta, GA",Georgia,1640,864,-6,-5,1634,859,17,15,1651,844,2272,292,312,324,0,,0,0.0,0.0,0.0,0.0,0.0
2024,9,14,6,2024-09-14,NK,1877,SEA,SAN,"Seattle, WA",Washington,"San Diego, CA",California,1866,2305,-24,-15,1842,2290,12,13,1854,2277,1417,177,197,202,0,,0,0.0,0.0,0.0,0.0,0.0
2024,1,18,4,2024-01-18,WN,159,SAN,MIA,"San Diego, CA",California,"Miami, FL",Florida,2230,819,21,20,2251,839,27,5,2278,834,1987,239,259,271,0,,0,2.0,4.0,2.0,0.0,12.0
2024,6,23,7,2024-06-23,WN,9925,MCO,TPA,"Orlando, FL",Florida,"Tampa, FL",Florida,1756,2175,-15,-10,1741,2165,13,18,1754,2147,627,72,92,103,1,,0,0.0,0.0,0.0,0.0,0.0
2024,8,16,5,2024-08-16,WN,7086,LGA,DFW,"New York, NY",New York,"Dallas/Fort Worth, TX",Texas,628,1498,-20,-10,608,1488,25,12,633,1476,657,89,109,126,1,,0,0.0,0.0,0.0,0.0,0.0
2024,8,13,2,2024-08-13,AS,7960,SEA,JFK,"Seattle, WA",Washington,"New York, NY",New York,873,1536,-7,-5,866,1531,15,11,881,1520,2490,316,336,342,0,,0,0.0,0.0,0.0,0.0,0.0
2024,3,24,7,2024-03-24,WN,8627,DCA,LGA,"Washington, DC",District of Columbia,"New York, NY",New York,2098,1588,-6,-15,2092,1573,9,17,2101,1556,746,94,114,120,1,,0,0.0,0.0,0.0,0.0,0.0
2024,10,17,4,2024-10-17,B6,9122,LAX,SFO,"Los Angeles, CA",California,"San Francisco, CA",California,735,888,-5,-10,730,878,9,13,739,865,1565,190,210,212,0,,0,0.0,0.0,0.0,0.0,0.0
2024,9,2,1,2024-09-02,G4,1692,SAN,MSP,"San Diego, CA",California,"Minneapolis, MN",Minnesota,1241,1702,16,10,1257,1712,29,12,1286,1700,565,70,90,111,0,,0,0.0,0.0,0.0,0.0,0.0
2024,4,19,5,2024-04-19,YX,4480,SAN,JFK,"San Diego, CA",California,"New York, NY",New York,689,1350,-1,-10,688,1340,22,8,710,1332,1703,206,226,236,0,,0,0.0,0.0,0.0,0.0,0.0
2024,9,10,2,2024-09-10,NK,6197,PHL,IAD,"Philadelphia, PA",Pennsylvania,"Washington, DC",District of Columbia,2224,2195,-20,-15,2204,2180,20,8,2224,2172,343,36,56,64,0,,0,0.0,0.0,0.0,0.0,0.0
2024,3,28,4,2024-03-28,F9,6558,BWI,TPA,"Baltimore, MD",Maryland,"Tampa, FL",Florida,667,919,3,10,670,929,27,15,697,914,1701,218,238,260,0,,0,0.0,0.0,0.0,0.0,0.0
2024,3,12,2,2024-03-12,B6,9251,CLT,PHL,"Charlotte, NC",North Carolina,"Philadelphia, PA",Pennsylvania,2130,917,-7,-5,2123,912,23,17,2146,895,363,52,72,92,0,,0,0.0,0.0,0.0,0.0,0.0
2024,1,30,2,2024-01-30,B6,5817,SLC,IAD,"Salt Lake City, UT",Utah,"Washington, DC",District of Columbia,2192,1086,-1,-10,2191,1076,28,15,2219,1061,2690,334,354,377,0,,0,0.0,0.0,0.0,0.0,0.0
2024,6,20,4,2024-06-20,MQ,4266,LAS,BWI,"Las Vegas, NV",Nevada,"Baltimore, MD",Maryland,790,2014,-3,0,787,2014,13,5,800,2009,2982,372,392,390,0,,0,0.0,0.0,0.0,0.0,0.0
2024,11,4,1,2024-11-04,OO,6588,DCA,PHX,"Washington, DC",District of Columbia,"Phoenix, AZ",Arizona,1864,1187,-13,-20,1851,1167,15,4,1866,1163,780,94,114,113,0,,0,0.0,0.0,0.0,0.0,0.0
2024,12,8,7,2024-12-08,NK,8257,MIA,IAD,"Miami, FL",Florida,"Washington, DC",District of Columbia,1918,638,-4,-5,1914,633,15,3,1929,630,1183,148,168,166,0,,0,0.0,0.0,0.0,0.0,0.0
2024,6,25,2,2024-06-25,OO,9413,PDX,LAS,"Portland, OR",Oregon,"Las Vegas, NV",Nevada,1997,1822,-4,0,1993,1822,18,11,2011,1811,1909,247,267,276,0,,0,0.0,0.0,0.0,0.0,0.0
2024,5,18,6,2024-05-18,MQ,5519,IAH,MSP,"Houston, TX",Texas,"Minneapolis, MN",Minnesota,638,1542,17,20,655,1562,14,6,669,1556,341,32,52,52,0,,0,4.0,2.0,0.0,0.0,14.0
2024,7,12,5,2024-07-12,OH,9390,PHL,LAX,"Philadelphia, PA",Pennsylvania,"Los Angeles, CA",California,1714,704,-6,-5,1708,699,13,16,1721,683,1324,170,190,199,0,,0,0.0,0.0,0.0,0.0,0.0
2024,7,4,4,2024-07-04,YX,8434,LAS,DTW,"Las Vegas, NV",Nevada,"Detroit, MI",Michigan,1067,2205,-3,5,1064,2210,9,16,1073,2194,2196,271,291,296,0,,0,0.0,0.0,0.0,0.0,0.0
2024,8,5,1,2024-08-05,F9,1146,MSP,PHX,"Minneapolis, MN",Minnesota,"Phoenix, AZ",Arizona,2042,1106,-8,-15,2034,1091,15,19,2049,1072,1763,226,246,260,0,,0,0.0,0.0,0.0,0.0,0.0
2024,6,12,3,2024-06-12,G4,9360,PDX,DFW,"Portland, OR",Oregon,"Dallas/Fort Worth, TX",Texas,1574,1169,-7,-5,1567,1164,13,16,1580,1148,2618,325,345,354,0,,0,0.0,0.0,0.0,0.0,0.0
2024,6,9,7,2024-06-09,HA,7736,MSP,SEA,"Minneapolis, MN",Minnesota,"Seattle, WA",Washington,1490,928,-16,-10,1474,918,17,10,1491,908,461,56,76,83,0,,0,0.0,0.0,0.0,0.0,0.0
2024,1,13,6,2024-01-13,OH,4287,SFO,DEN,"San Francisco, CA",California,"Denver, CO",Colorado,2074,2314,2,0,2076,2314,23,9,2099,2305,1424,176,196,208,0,,0,0.0,0.0,0.0,0.0,0.0
2024,10,22,2,2024-10-22,DL,3440,BOS,PDX,"Boston, MA",Massachusetts,"Portland, OR",Oregon,797,1583,-11,-5,786,1578,12,11,798,1567,989,115,135,138,0,,0,0.0,0.0,0.0,0.0,0.0
2024,3,29,5,2024-03-29,UA,6277,BWI,DCA,"Baltimore, MD",Maryland,"Washington, DC",District of Columbia,1595,907,11,20,1606,927,27,10,1633,917,452,46,66,83,0,,0,6.0,1.0,2.0,0.0,11.0
2024,11,19,2,2024-11-19,YX,4873,MCO,DFW,"Orlando, FL",Florida,"Dallas/Fort Worth, TX",Texas,755,821,11,15,766,836,8,5,774,831,1359,176,196,189,0,,0,0.0,0.0,0.0,0.0,0.0
2024,2,11,7,2024-02-11,YX,3535,MSP,DTW,"Minneapolis, MN",Minnesota,"Detroit, MI",Michigan,808,1255,-8,0,800,1255,16,3,816,1252,1864,240,260,259,0,,0,0.0,0.0,0.0,0.0,0.0
2024,7,28,7,2024-07-28,DL,7400,MSP,DTW,"Minneapolis, MN",Minnesota,"Detroit, MI",Michigan,590,1650,-12,-10,578,1640,29,19,607,1621,2116,259,279,307,0,,0,0.0,0.0,0.0,0.0,0.0
2024,8,16,5,2024-08-16,9E,7002,LAX,IAD,"Los Angeles, CA",California,"Washington, DC",District of Columbia,648,1272,-8,0,640,1272,11,13,651,1259,2564,321,341,345,0,,0,0.0,0.0,0.0,0.0,0.0
2024,12,15,7,2024-12-15,NK,5899,DFW,BWI,"Dallas/Fort Worth, TX",Texas,"Baltimore, MD",Maryland,1553,750,0,5,1553,755,28,18,1581,737,2926,373,393,419,0,,0,0.0,0.0,0.0,0.0,0.0
2024,10,1,2,2024-10-01,YX,1065,PHL,BOS,"Philadelphia, PA",Pennsylvania,"Boston, MA",Massachusetts,961,772,-21,-20,940,752,12,8,952,744,792,101,121,121,0,,0,0.0,0.0,0.0,0.0,0.0
2024,10,5,6,2024-10-05,DL,7544,MDW,MCO,"Chicago, IL",Illinois,"Orlando, FL",Florida,1134,1322,-13,-5,1121,1317,23,4,1144,1313,1419,176,196,203,0,,0,0.0,0.0,0.0,0.0,0.0
2024,9,7,6,2024-09-07,YX,9471,EWR,PHL,"Newark, NJ",New Jersey,"Philadelphia, PA",Pennsylvania,1908,1578,-11,-20,1897,1558,27,11,1924,1547,2476,299,319,337,0,,0,0.0,0.0,0.0,0.0,0.0
2024,11,5,2,2024-11-05,OH,6778,STL,ORD,"St. Louis, MO",Missouri,"Chicago, IL",Illinois,2272,1645,-12,-10,2260,1635,12,13,2272,1622,1488,194,214,219,0,,0,0.0,0.0,0.0,0.0,0.0
2024,7,26,5,2024-07-26,HA,600,TPA,PHX,"Tampa, FL",Florida,"Phoenix, AZ",Arizona,1136,1409,-14,-15,1122,1394,23,7,1145,1387,720,95,115,125,0,,0,0.0,0.0,0.0,0.0,0.0
2024,11,16,6,2024-11-16,DL,4654,IAH,BOS,"Houston, TX",Texas,"Boston, MA",Massachusetts,1145,1476,21,20,1166,1496,29,13,1195,1483,1186,141,161,183,0,,0,1.0,1.0,2.0,0.0,16.0
2024,5,19,7,2024-05-19,OH,149,DTW,MCO,"Detroit, MI",Michigan,"Orlando, FL",Florida,1017,2168,-5,-10,1012,2158,8,15,1020,2143,1129,133,153,156,0,,0,0.0,0.0,0.0,0.0,0.0
2024,10,6,7,2024-10-06,OH,9261,LAX,HNL,"Los Angeles, CA",California,"Honolulu, HI",Hawaii,1896,1220,-10,-10,1886,1210,14,13,1900,1197,2398,292,312,319,0,,0,0.0,0.0,0.0,0.0,0.0
2024,2,3,6,2024-02-03,DL,1087,PHX,MIA,"Phoenix, AZ",Arizona,"Miami, FL",Florida,1720,2017,21,20,1741,2037,19,8,1760,2029,682,85,105,112,0,,0,2.0,5.0,2.0,0.0,11.0
2024,11,4,1,2024-11-04,HA,6871,STL,SAN,"St. Louis, MO",Missouri,"San Diego, CA",California,689,646,6,0,695,646,27,18,722,628,431,47,67,92,0,,0,0.0,0.0,0.0,0.0,0.0
2024,1,18,4,2024-01-18,YX,1215,SAN,JFK,"San Diego, CA",California,"New York, NY",New York,2271,2231,-2,5,2269,2236,12,16,2281,2220,464,62,82,90,0,,0,0.0,0.0,0.0,0.0,0.0
2024,2,26,1,2024-02-26,MQ,4032,STL,BOS,"St. Louis, MO",Missouri,"Boston, MA",Massachusetts,578,1748,-6,-5,572,1743,19,11,591,1732,2708,331,351,361,0,,0,0.0,0.0,0.0,0.0,0.0
2024,4,21,7,2024-04-21,WN,9771,TPA,DEN,"Tampa, FL",Florida,"Denver, CO",Colorado,2070,1958,6,0,2076,1958,20,15,2096,1943,1595,207,227,242,0,,0,0.0,0.0,0.0,0.0,0.0
2024,1,5,5,2024-01-05,AA,4534,ORD,PHX,"Chicago, IL",Illinois,"Phoenix, AZ",Arizona,1315,1918,-23,-20,1292,1898,28,16,1320,1882,1913,230,250,274,0,,0,0.0,0.0,0.0,0.0,0.0
2024,6,30,7,2024-06-30,DL,3667,HNL,MDW,"Honolulu, HI",Hawaii,"Chicago, IL",Illinois,571,1489,-9,-5,562,1484,25,6,587,1478,1025,127,147,158,0,,0,0.0,0.0,0.0,0.0,0.0
2024,1,13,6,2024-01-13,UA,1758,SLC,IAD,"Salt Lake City, UT",Utah,"Washington, DC",District of Columbia,542,1439,7,0,549,1439,11,5,560,1434,320,40,60,56,0,,0,0.0,0.0,0.0,0.0,0.0
2024,12,4,3,2024-12-04,NK,8044,SFO,SLC,"San Francisco, CA",California,"Salt Lake City, UT",Utah,1302,2160,-3,0,1299,2160,12,4,1311,2156,1266,162,182,178,0,,1,0.0,0.0,0.0,0.0,0.0
2024,10,11,5,2024-10-11,9E,5900,MDW,PHX,"Chicago, IL",Illinois,"Phoenix, AZ",Arizona,1656,2217,-14,-5,1642,2212,17,19,1659,2193,329,39,59,75,0,,0,0.0,0.0,0.0,0.0,0.0
2024,9,15,7,2024-09-15,AA,4476,HNL,MDW,"Honolulu, HI",Hawaii,"Chicago, IL",Illinois,1629,1169,8,5,1637,1174,17,8,1654,1166,2486,316,336,341,0,,0,0.0,0.0,0.0,0.0,0.0
2024,3,30,6,2024-03-30,AS,8117,DEN,MSP,"Denver, CO",Colorado,"Minneapolis, MN",Minnesota,2194,1137,5,0,2199,1137,6,4,2205,1133,1673,204,224,214,0,,0,0.0,0.0,0.0,0.0,0.0
2024,4,13,6,2024-04-13,UA,2915,DFW,PHL,"Dallas/Fort Worth, TX",Texas,"Philadelphia, PA",Pennsylvania,856,1920,9,0,865,1920,24,14,889,1906,2020,245,265,283,0,,0,0.0,0.0,0.0,0.0,0.0
2024,7,4,4,2024-07-04,UA,1070,MCO,HNL,"Orlando, FL",Florida,"Honolulu, HI",Hawaii,507,643,-11,-10,496,633,19,14,515,619,1140,144,164,177,0,,0,0.0,0.0,0.0,0.0,0.0
2024,9,6,5,2024-09-06,WN,7920,JFK,ORD,"New York, NY",New York,"Chicago, IL",Illinois,2297,1196,17,10,2314,1206,10,6,2324,1200,640,78,98,94,0,,0,0.0,0.0,0.0,0.0,0.0
2024,9,11,3,2024-09-11,MQ,5612,SEA,DTW,"Seattle, WA",Washington,"Detroit, MI",Michigan,1866,621,-11,-5,1855,616,29,8,1884,608,2909,357,377,394,0,,0,0.0,0.0,0.0,0.0,0.0
2024,3,16,6,2024-03-16,WN,307,MCO,LAX,"Orlando, FL",Florida,"Los Angeles, CA",California,936,825,5,0,941,825,22,5,963,820,514,72,92,99,0,,0,0.0,0.0,0.0,0.0,0.0
2024,4,17,3,2024-04-17,NK,359,TPA,DCA,"Tampa, FL",Florida,"Washington, DC",District of Columbia,579,1148,-5,-5,574,1143,11,10,585,1133,2870,366,386,387,0,,0,0.0,0.0,0.0,0.0,0.0
2024,6,4,2,2024-06-04,UA,5125,SAN,STL,"San Diego, CA",California,"St. Louis, MO",Missouri,2079,973,18,10,2097,983,6,18,2103,965,2893,367,387,391,0,,0,0.0,0.0,0.0,0.0,0.0
2024,3,22,5,2024-03-22,F9,4458,TPA,DEN,"Tampa, FL",Florida,"Denver, CO",Colorado,1188,1212,10,15,1198,1227,6,3,1204,1224,2486,306,326,315,1,,0,0.0,0.0,0.0,0.0,0.0
2024,3,17,7,2024-03-17,F9,9074,TPA,STL,"Tampa, FL",Florida,"St. Louis, MO",Missouri,1915,1253,-14,-10,1901,1243,5,4,1906,1239,1123,141,161,150,0,,0,0.0,0.0,0.0,0.0,0.0
2024,9,14,6,2024-09-14,OO,604,JFK,ATL,"New York, NY",New York,"Atlanta, GA",Georgia,1075,1627,5,5,1080,1632,29,12,1109,1620,919,119,139,160,0,,0,0.0,0.0,0.0,0.0,0.0
2024,5,6,1,2024-05-06,MQ,9865,HNL,IAH,"Honolulu, HI",Hawaii,"Houston, TX",Texas,1399,623,-8,-15,1391,608,26,7,1417,601,606,77,97,110,0,,0,0.0,0.0,0.0,0.0,0.0
2024,10,8,2,2024-10-08,NK,1859,EWR,SLC,"Newark, NJ",New Jersey,"Salt Lake City, UT",Utah,787,2326,-13,-20,774,2306,18,14,792,2292,1871,230,250,262,0,,0,0.0,0.0,0.0,0.0,0.0
2024,3,28,4,2024-03-28,DL,7614,TPA,CLT,"Tampa, FL",Florida,"Charlotte, NC",North Carolina,1636,1432,19,10,1655,1442,6,8,1661,1434,2235,280,300,294,0,,0,0.0,0.0,0.0,0.0,0.0
2024,7,22,1,2024-07-22,B6,7860,SFO,MSP,"San Francisco, CA",California,"Minneapolis, MN",Minnesota,1462,1945,-18,-15,1444,1930,14,16,1458,1914,388,54,74,84,0,,0,0.0,0.0,0.0,0.0,0.0
2024,1,16,2,2024-01-16,AS,3894,CLT,ORD,"Charlotte, NC",North Carolina,"Chicago, IL",Illinois,1219,1138,-11,-10,1208,1128,8,5,1216,1123,783,102,122,115,1,,0,0.0,0.0,0.0,0.0,0.0
2024,5,30,4,2024-05-30,YX,3690,DFW,BWI,"Dallas/Fort Worth, TX",Texas,"Baltimore, MD",Maryland,1455,971,6,0,1461,971,8,15,1469,956,1480,190,210,213,0,,0,0.0,0.0,0.0,0.0,0.0
2024,9,10,2,2024-09-10,9E,7070,STL,SEA,"St. Louis, MO",Missouri,"Seattle, WA",Washington,725,2216,8,10,733,2226,27,9,760,2217,978,121,141,157,0,,0,0.0,0.0,0.0,0.0,0.0
2024,7,6,6,2024-07-06,WN,9693,LAS,MIA,"Las Vegas, NV",Nevada,"Miami, FL",Florida,1856,2256,-8,-10,1848,2246,11,19,1859,2227,207,15,35,45,0,,0,0.0,0.0,0.0,0.0,0.0
2024,11,24,7,2024-11-24,MQ,9080,JFK,SEA,"New York, NY",New York,"Seattle, WA",Washington,1940,1988,-18,-15,1922,1973,24,11,1946,1962,2742,348,368,383,0,,0,0.0,0.0,0.0,0.0,0.0
2024,2,1,4,2024-02-01,9E,6385,MSP,TPA,"Minneapolis, MN",Minnesota,"Tampa, FL",Florida,777,1512,-9,-15,768,1497,9,8,777,1489,762,89,109,106,0,,0,0.0,0.0,0.0,0.0,0.0
2024,9,27,5,2024-09-27,B6,3429,DTW,SLC,"Detroit, MI",Michigan,"Salt Lake City, UT",Utah,1394,1692,-15,-20,1379,1672,16,8,1395,1664,2022,245,265,269,0,,0,0.0,0.0,0.0,0.0,0.0
2024,1,5,5,2024-01-05,OH,4112,MDW,PDX,"Chicago, IL",Illinois,"Portland, OR",Oregon,1291,2095,-10,-15,1281,2080,16,4,1297,2076,565,62,82,82,0,,0,0.0,0.0,0.0,0.0,0.0
2024,11,25,1,2024-11-25,G4,2192,PHX,PHL,"Phoenix, AZ",Arizona,"Philadelphia, PA",Pennsylvania,1526,2128,12,15,1538,2143,29,13,1567,2130,2447,295,315,337,0,,0,0.0,0.0,0.0,0.0,0.0
2024,11,3,7,2024-11-03,OO,3067,MDW,SAN,"Chicago, IL",Illinois,"San Diego, CA",California,1044,1936,-16,-15,1028,1921,10,4,1038,1917,2719,336,356,350,0,,0,0.0,0.0,0.0,0.0,0.0
2024,11,28,4,2024-11-28,NK,9361,SEA,MCO,"Seattle, WA",Washington,"Orlando, FL",Florida,977,1695,1,0,978,1695,22,17,1000,1678,2119,272,292,311,0,,0,0.0,0.0,0.0,0.0,0.0
2024,6,17,1,2024-06-17,DL,1775,LGA,IAH,"New York, NY",New York,"Houston, TX",Texas,1933,1869,22,15,1955,1884,6,4,1961,1880,947,111,131,121,0,,0,0.0,0.0,0.0,0.0,0.0
2024,6,29,6,2024-06-29,OO,4496,DFW,ORD,"Dallas/Fort Worth, TX",Texas,"Chicago, IL",Illinois,1830,1357,-2,0,1828,1357,23,9,1851,1348,2329,294,314,326,0,,0,0.0,0.0,0.0,0.0,0.0
2024,6,26,3,2024-06-26,AA,387,SAN,PHL,"San Diego, CA",California,"Philadelphia, PA",Pennsylvania,1737,1696,-27,-20,1710,1676,20,12,1730,1664,1424,187,207,219,0,,0,0.0,0.0,0.0,0.0,0.0
2024,5,22,3,2024-05-22,DL,885,PDX,IAD,"Portland, OR",Oregon,"Washington, DC",District of Columbia,1553,1385,-6,0,1547,1385,27,4,1574,1381,1899,227,247,258,0,,0,0.0,0.0,0.0,0.0,0.0
2024,12,27,5,2024-12-27,UA,2416,DFW,MDW,"Dallas/Fort Worth, TX",Texas,"Chicago, IL",Illinois,918,2151,20,15,938,2166,6,19,944,2147,2502,318,338,343,0,,0,0.0,0.0,0.0,0.0,0.0
2024,9,4,3,2024-09-04,OO,2938,JFK,LAS,"New York, NY",New York,"Las Vegas, NV",Nevada,2060,2314,-15,-5,2045,2309,21,19,2066,2290,237,22,42,62,0,,0,0.0,0.0,0.0,0.0,0.0
2024,5,6,1,2024-05-06,DL,7329,STL,DEN,"St. Louis, MO",Missouri,"Denver, CO",Colorado,1551,1613,2,-5,1553,1608,24,16,1577,1592,1019,122,142,162,0,,0,0.0,0.0,0.0,0.0,0.0
2024,9,19,4,2024-09-19,OO,8237,MIA,BWI,"Miami, FL",Florida,"Baltimore, MD",Maryland,1108,639,-3,-10,1105,629,11,5,1116,624,2015,254,274,270,0,,0,0.0,0.0,0.0,0.0,0.0
2024,2,9,5,2024-02-09,UA,8218,PHX,MCO,"Phoenix, AZ",Arizona,"Orlando, FL",Florida,586,1662,8,0,594,1662,25,19,619,1643,2478,311,331,355,0,,0,0.0,0.0,0.0,0.0,0.0
2024,12,20,5,2024-12-20,9E,1365,LGA,MDW,"New York, NY",New York,"Chicago, IL",Illinois,1549,1679,-12,-10,1537,1669,11,17,1548,1652,1875,227,247,255,0,,0,0.0,0.0,0.0,0.0,0.0
2024,9,11,3,2024-09-11,HA,3083,LAX,SFO,"Los Angeles, CA",California,"San Francisco, CA",California,619,1484,-5,5,614,1489,27,18,641,1471,2598,324,344,369,0,,0,0.0,0.0,0.0,0.0,0.0
2024,5,22,3,2024-05-22,OO,6001,EWR,TPA,"Newark, NJ",New Jersey,"Tampa, FL",Florida,1212,1344,-8,0,1204,1344,16,17,1220,1327,555,76,96,109,0,,0,0.0,0.0,0.0,0.0,0.0
2024,8,27,2,2024-08-27,OO,8031,TPA,PHL,"Tampa, FL",Florida,"Philadelphia, PA",Pennsylvania,891,1165,-14,-5,877,1160,27,7,904,1153,1611,206,226,240,0,,0,0.0,0.0,0.0,0.0,0.0
2024,8,15,4,2024-08-15,HA,8243,LAX,DFW,"Los Angeles, CA",California,"Dallas/Fort Worth, TX",Texas,1880,1795,-4,5,1876,1800,15,17,1891,1783,1919,232,252,264,0,,0,0.0,0.0,0.0,0.0,0.0
2024,12,6,5,2024-12-06,YX,8130,SAN,LAX,"San Diego, CA",California,"Los Angeles, CA",California,852,901,-9,-15,843,886,21,17,864,869,1457,191,211,229,0,,0,0.0,0.0,0.0,0.0,0.0
2024,7,16,2,2024-07-16,OH,8362,DFW,PHL,"Dallas/Fort Worth, TX",Texas,"Philadelphia, PA",Pennsylvania,514,2113,0,5,514,2118,15,7,529,2111,2732,340,360,362,0,,0,0.0,0.0,0.0,0.0,0.0
2024,3,5,2,2024-03-05,YX,711,LGA,IAH,"New York, NY",New York,"Houston, TX",Texas,804,2055,-6,0,798,2055,12,3,810,2052,2992,378,398,393,0,,0,0.0,0.0,0.0,0.0,0.0
2024,1,11,4,2024-01-11,G4,7328,DTW,ORD,"Detroit, MI",Michigan,"Chicago, IL",Illinois,1777,2324,0,0,1777,2324,10,3,1787,2321,718,92,112,105,1,,0,0.0,0.0,0.0,0.0,0.0
2024,4,17,3,2024-04-17,WN,3623,SLC,PDX,"Salt Lake City, UT",Utah,"Portland, OR",Oregon,1122,1561,-17,-15,1105,1546,10,5,1115,1541,1022,130,150,145,0,,0,0.0,0.0,0.0,0.0,0.0
2024,1,26,5,2024-01-26,YX,5612,DFW,MDW,"Dallas/Fort Worth, TX",Texas,"Chicago, IL",Illinois,1019,1533,-7,0,1012,1533,19,19,1031,1514,1349,172,192,210,0,,0,0.0,0.0,0.0,0.0,0.0
2024,5,30,4,2024-05-30,G4,3802,BOS,CLT,"Boston, MA",Massachusetts,"Charlotte, NC",North Carolina,1352,1154,-4,0,1348,1154,24,16,1372,1138,1670,214,234,254,0,,0,0.0,0.0,0.0,0.0,0.0
2024,8,8,4,2024-08-08,OO,5524,DTW,DCA,"Detroit, MI",Michigan,"Washington, DC",District of Columbia,1139,603,2,0,1141,603,16,11,1157,592,588,81,101,108,0,,0,0.0,0.0,0.0,0.0,0.0
2024,12,6,5,2024-12-06,UA,8482,EWR,DTW,"Newark, NJ",New Jersey,"Detroit, MI",Michigan,1709,1884,0,-5,1709,1879,13,6,1722,1873,2634,321,341,340,0,,0,0.0,0.0,0.0,0.0,0.0
2024,8,24,6,2024-08-24,YX,1728,SFO,DEN,"San Francisco, CA",California,"Denver, CO",Colorado,886,1480,-11,-20,875,1460,17,5,892,1455,443,64,84,86,0,,0,0.0,0.0,0.0,0.0,0.0
2024,8,24,6,2024-08-24,AA,8007,HNL,TPA,"Honolulu, HI",Hawaii,"Tampa, FL",Florida,1404,2193,1,-5,1405,2188,19,3,1424,2185,2055,248,268,270,0,,0,0.0,0.0,0.0,0.0,0.0
2024,8,6,2,2024-08-06,OO,3472,STL,SFO,"St. Louis, MO",Missouri,"San Francisco, CA",California,2023,2172,4,-5,2027,2167,19,6,2046,2161,1707,204,224,229,0,,0,0.0,0.0,0.0,0.0,0.0
2024,5,30,4,2024-05-30,B6,8308,SAN,DFW,"San Diego, CA",California,"Dallas/Fort Worth, TX",Texas,513,1009,-14,-5,499,1004,17,16,516,988,2131,260,280,293,0,,0,0.0,0.0,0.0,0.0,0.0
2024,5,2,4,2024-05-02,9E,9889,MSP,CLT,"Minneapolis, MN",Minnesota,"Charlotte, NC",North Carolina,1753,864,-6,0,1747,864,13,16,1760,848,1701,207,227,236,0,,0,0.0,0.0,0.0,0.0,0.0
2024,5,23,4,2024-05-23,9E,9358,MDW,EWR,"Chicago, IL",Illinois,"Newark, NJ",New Jersey,590,614,-3,-10,587,604,15,10,602,594,1384,171,191,196,0,,0,0.0,0.0,0.0,0.0,0.0
2024,7,7,7,2024-07-07,OH,3239,MIA,LAX,"Miami, FL",Florida,"Los Angeles, CA",California,1927,687,-8,-10,1919,677,26,18,1945,659,1354,168,188,212,0,,0,0.0,0.0,0.0,0.0,0.0
2024,9,11,3,2024-09-11,DL,2359,DTW,DCA,"Detroit, MI",Michigan,"Washington, DC",District of Columbia,2028,698,7,0,2035,698,15,5,2050,693,2401,290,310,310,0,,0,0.0,0.0,0.0,0.0,0.0
2024,3,8,5,2024-03-08,WN,2350,LAX,JFK,"Los Angeles, CA",California,"New York, NY",New York,503,1607,0,0,503,1607,13,9,516,1598,493,53,73,75,0,,0,0.0,0.0,0.0,0.0,0.0
2024,4,13,6,2024-04-13,DL,6221,PHL,DTW,"Philadelphia, PA",Pennsylvania,"Detroit, MI",Michigan,1521,2240,3,0,1524,2240,21,8,1545,2232,1467,177,197,206,0,,0,0.0,0.0,0.0,0.0,0.0
2024,12,1,7,2024-12-01,DL,8281,BOS,MIA,"Boston, MA",Massachusetts,"Miami, FL",Florida,2187,816,11,10,2198,826,27,15,2225,811,432,52,72,94,0,,0,0.0,0.0,0.0,0.0,0.0
2024,6,7,5,2024-06-07,MQ,383,JFK,TPA,"New York, NY",New York,"Tampa, FL",Florida,1742,1009,-2,5,1740,1014,29,4,1769,1010,2793,339,359,372,0,,0,0.0,0.0,0.0,0.0,0.0
2024,11,4,1,2024-11-04,UA,5825,MSP,BWI,"Minneapolis, MN",Minnesota,"Baltimore, MD",Maryland,2111,790,-19,-15,2092,775,25,13,2117,762,2442,311,331,349,0,,0,0.0,0.0,0.0,0.0,0.0
2024,12,27,5,2024-12-27,B6,8018,SFO,LGA,"San Francisco, CA",California,"New York, NY",New York,1295,1838,2,0,1297,1838,10,11,1307,1827,1813,223,243,244,0,,0,0.0,0.0,0.0,0.0,0.0
2024,10,26,6,2024-10-26,WN,5337,SFO,STL,"San Francisco, CA",California,"St. Louis, MO",Missouri,715,2333,3,-5,718,2328,26,9,744,2319,2484,313,333,348,0,,0,0.0,0.0,0.0,0.0,0.0
2024,3,30,6,2024-03-30,DL,8894,EWR,JFK,"Newark, NJ",New Jersey,"New York, NY",New York,1682,1216,-5,-5,1677,1211,9,14,1686,1197,2840,360,380,383,0,,0,0.0,0.0,0.0,0.0,0.0
2024,12,22,7,2024-12-22,HA,9655,ATL,SEA,"Atlanta, GA",Georgia,"Seattle, WA",Washington,2286,1650,16,20,2302,1670,29,13,2331,1657,1814,224,244,266,0,,0,3.0,5.0,3.0,0.0,9.0
2024,9,12,4,2024-09-12,OO,4175,PHX,MSP,"Phoenix, AZ",Arizona,"Minneapolis, MN",Minnesota,2102,1805,4,0,2106,1805,25,17,2131,1788,2030,258,278,300,0,,0,0.0,0.0,0.0,0.0,0.0
2024,12,18,3,2024-12-18,OH,6262,DCA,IAH,"Washington, DC",District of Columbia,"Houston, TX",Texas,2257,1194,13,5,2270,1199,7,14,2277,1185,2867,363,383,384,0,,0,0.0,0.0,0.0,0.0,0.0
2024,8,7,3,2024-08-07,OH,7736,MIA,EWR,"Miami, FL",Florida,"Newark, NJ",New Jersey,1203,1782,29,20,1232,1802,10,5,1242,1797,2085,265,285,280,0,,0,3.0,3.0,3.0,0.0,11.0
2024,1,9,2,2024-01-09,9E,5837,MIA,HNL,"Miami, FL",Florida,"Honolulu, HI",Hawaii,1230,829,-4,-10,1226,819,26,10,1252,809,1400,170,190,206,0,,0,0.0,0.0,0.0,0.0,0.0
2024,1,12,5,2024-01-12,DL,9092,MDW,DTW,"Chicago, IL",Illinois,"Detroit, MI",Michigan,1896,1858,-25,-15,1871,1843,21,17,1892,1826,1026,124,144,162,0,,0,0.0,0.0,0.0,0.0,0.0
2024,11,20,3,2024-11-20,OH,9051,MSP,TPA,"Minneapolis, MN",Minnesota,"Tampa, FL",Florida,516,1399,-4,-5,512,1394,15,18,527,1376,2554,313,333,346,0,,0,0.0,0.0,0.0,0.0,0.0
2024,8,31,6,2024-08-31,AS,8102,IAD,MDW,"Washington, DC",District of Columbia,"Chicago, IL",Illinois,994,2009,-12,-20,982,1989,8,19,990,1970,1166,138,158,165,0,,0,0.0,0.0,0.0,0.0,0.0
2024,6,30,7,2024-06-30,NK,7172,SAN,LAX,"San Diego, CA",California,"Los Angeles, CA",California,2142,1129,-21,-15,2121,1114,16,15,2137,1099,439,57,77,88,0,,0,0.0,0.0,0.0,0.0,0.0
2024,10,10,4,2024-10-10,YX,1593,DFW,HNL,"Dallas/Fort Worth, TX",Texas,"Honolulu, HI",Hawaii,1989,1907,44,45,2033,1952,14,18,2047,1934,1514,197,217,229,0,,0,4.0,6.0,4.0,0.0,31.0
2024,11,7,4,2024-11-07,9E,9106,MDW,DEN,"Chicago, IL",Illinois,"Denver, CO",Colorado,943,670,20,20,963,690,21,9,984,681,2426,303,323,333,0,,0,3.0,4.0,2.0,0.0,11.0
2024,4,8,1,2024-04-08,AS,472,DTW,MDW,"Detroit, MI",Michigan,"Chicago, IL",Illinois,2262,2127,10,5,2272,2132,10,7,2282,2125,2790,344,364,361,0,,0,0.0,0.0,0.0,0.0,0.0
2024,7,15,1,2024-07-15,NK,5687,STL,IAD,"St. Louis, MO",Missouri,"Washington, DC",District of Columbia,1604,1838,12,5,1616,1843,22,14,1638,1829,699,82,102,118,0,,0,0.0,0.0,0.0,0.0,0.0
2024,8,13,2,2024-08-13,AA,7171,SLC,MIA,"Salt Lake City, UT",Utah,"Miami, FL",Florida,1278,716,-17,-15,1261,701,25,11,1286,690,1007,124,144,160,0,,0,0.0,0.0,0.0,0.0,0.0
2024,11,28,4,2024-11-28,AS,2991,STL,IAH,"St. Louis, MO",Missouri,"Houston, TX",Texas,665,699,-2,0,663,699,23,3,686,696,1644,212,232,238,0,,0,0.0,0.0,0.0,0.0,0.0
2024,4,12,5,2024-04-12,OO,6686,SFO,DTW,"San Francisco, CA",California,"Detroit, MI",Michigan,856,1199,-7,-10,849,1189,26,5,875,1184,2389,292,312,323,0,,0,0.0,0.0,0.0,0.0,0.0
2024,4,15,1,2024-04-15,UA,7723,SAN,MSP,"San Diego, CA",California,"Minneapolis, MN",Minnesota,733,1459,4,-5,737,1454,29,12,766,1442,1665,201,221,242,0,,0,0.0,0.0,0.0,0.0,0.0
2024,12,30,1,2024-12-30,AA,3419,ORD,DEN,"Chicago, IL",Illinois,"Denver, CO",Colorado,1685,2288,-10,-5,1675,2283,19,13,1694,2270,1859,224,244,256,0,,0,0.0,0.0,0.0,0.0,0.0
2024,2,27,2,2024-02-27,F9,4067,SAN,SEA,"San Diego, CA",California,"Seattle, WA",Washington,674,894,1,0,675,894,16,19,691,875,444,49,69,84,0,,0,0.0,0.0,0.0,0.0,0.0
2024,3,18,1,2024-03-18,WN,922,MDW,IAD,"Chicago, IL",Illinois,"Washington, DC",District of Columbia,2195,1800,-15,-15,2180,1785,23,11,2203,1774,211,18,38,52,0,,0,0.0,0.0,0.0,0.0,0.0
2024,3,15,5,2024-03-15,9E,321,MCO,SFO,"Orlando, FL",Florida,"San Francisco, CA",California,1886,1755,-22,-15,1864,1740,29,15,1893,1725,2608,329,349,373,0,,0,0.0,0.0,0.0,0.0,0.0
2024,2,11,7,2024-02-11,F9,6980,IAH,ATL,"Houston, TX",Texas,"Atlanta, GA",Georgia,1899,1604,-5,0,1894,1604,9,12,1903,1592,1547,195,215,216,0,,0,0.0,0.0,0.0,0.0,0.0
2024,11,19,2,2024-11-19,9E,9679,STL,HNL,"St. Louis, MO",Missouri,"Honolulu, HI",Hawaii,1196,1233,7,0,1203,1233,22,3,1225,1230,1832,224,244,249,0,,0,0.0,0.0,0.0,0.0,0.0
2024,6,29,6,2024-06-29,OH,3988,MIA,DEN,"Miami, FL",Florida,"Denver, CO",Colorado,1697,2346,-10,-5,1687,2341,16,11,1703,2330,1791,225,245,252,0,,0,0.0,0.0,0.0,0.0,0.0
2024,2,2,5,2024-02-02,OO,5400,LAS,SLC,"Las Vegas, NV",Nevada,"Salt Lake City, UT",Utah,737,2203,-25,-15,712,2188,19,18,731,2170,1228,146,166,183,0,,0,0.0,0.0,0.0,0.0,0.0
2024,3,11,1,2024-03-11,WN,3370,HNL,PHX,"Honolulu, HI",Hawaii,"Phoenix, AZ",Arizona,1686,656,9,10,1695,666,14,16,1709,650,2640,320,340,350,0,,0,0.0,0.0,0.0,0.0,0.0
2024,2,25,7,2024-02-25,WN,4793,SLC,LAX,"Salt Lake City, UT",Utah,"Los Angeles, CA",California,1487,1636,-14,-15,1473,1621,29,10,1502,1611,2350,301,321,340,0,,0,0.0,0.0,0.0,0.0,0.0
2024,4,14,7,2024-04-14,YX,7666,ORD,PHX,"Chicago, IL",Illinois,"Phoenix, AZ",Arizona,1513,792,1,5,1514,797,23,10,1537,787,537,61,81,94,0,,0,0.0,0.0,0.0,0.0,0.0
2024,7,18,4,2024-07-18,OH,4093,HNL,PHL,"Honolulu, HI",Hawaii,"Philadelphia, PA",Pennsylvania,1411,2198,-15,-15,1396,2183,13,8,1409,2175,1191,150,170,171,0,,0,0.0,0.0,0.0,0.0,0.0
2024,4,10,3,2024-04-10,9E,2698,DEN,SAN,"Denver, CO",Colorado,"San Diego, CA",California,1761,1593,9,0,1770,1593,10,12,1780,1581,2214,267,287,289,0,,0,0.0,0.0,0.0,0.0,0.0
2024,9,12,4,2024-09-12,WN,1766,SAN,CLT,"San Diego, CA",California,"Charlotte, NC",North Carolina,2141,2133,-5,5,2136,2138,18,10,2154,2128,1001,123,143,151,0,,0,0.0,0.0,0.0,0.0,0.0
2024,11,2,6,2024-11-02,AS,4857,DCA,TPA,"Washington, DC",District of Columbia,"Tampa, FL",Florida,1129,1776,15,10,1144,1786,5,16,1149,1770,1859,231,251,252,0,,0,0.0,0.0,0.0,0.0,0.0
2024,3,14,4,2024-03-14,OH,1654,SFO,BWI,"San Francisco, CA",California,"Baltimore, MD",Maryland,1755,1646,-12,-5,1743,1641,5,16,1748,1625,1006,129,149,150,0,,0,0.0,0.0,0.0,0.0,0.0
2024,6,19,3,2024-06-19,G4,6215,EWR,LGA,"Newark, NJ",New Jersey,"New York, NY",New York,1087,629,-25,-20,1062,609,15,8,1077,601,587,79,99,102,0,,0,0.0,0.0,0.0,0.0,0.0
2024,5,22,3,2024-05-22,B6,5537,SLC,TPA,"Salt Lake City, UT",Utah,"Tampa, FL",Florida,2040,1992,9,10,2049,2002,7,4,2056,1998,1232,163,183,174,0,,0,0.0,0.0,0.0,0.0,0.0
2024,6,14,5,2024-06-14,YX,6341,MDW,ORD,"Chicago, IL",Illinois,"Chicago, IL",Illinois,2253,2324,-9,-5,2244,2319,25,19,2269,2300,911,122,142,166,0,,0,0.0,0.0,0.0,0.0,0.0
2024,9,17,2,2024-09-17,MQ,9372,EWR,DTW,"Newark, NJ",New Jersey,"Detroit, MI",Michigan,1293,2014,11,10,1304,2024,26,9,1330,2015,2125,272,292,307,0,,0,0.0,0.0,0.0,0.0,0.0
2024,8,8,4,2024-08-08,9E,187,EWR,MSP,"Newark, NJ",New Jersey,"Minneapolis, MN",Minnesota,1419,909,13,5,1432,914,9,8,1441,906,2189,277,297,294,0,,0,0.0,0.0,0.0,0.0,0.0
2024,3,23,6,2024-03-23,OH,7215,LAX,MDW,"Los Angeles, CA",California,"Chicago, IL",Illinois,1759,2244,-1,0,1758,2244,12,17,1770,2227,247,36,56,65,0,,0,0.0,0.0,0.0,0.0,0.0
2024,6,30,7,2024-06-30,HA,2803,PDX,LAX,"Portland, OR",Oregon,"Los Angeles, CA",California,1846,2024,111,120,1957,2144,26,6,1983,2138,1644,195,215,227,0,,0,42.0,35.0,17.0,3.0,23.0
2024,11,2,6,2024-11-02,F9,2518,SEA,SLC,"Seattle, WA",Washington,"Salt Lake City, UT",Utah,2067,1976,-2,0,2065,1976,22,6,2087,1970,2708,337,357,365,0,,0,0.0,0.0,0.0,0.0,0.0
2024,1,10,3,2024-01-10,F9,4247,PHX,DCA,"Phoenix, AZ",Arizona,"Washington, DC",District of Columbia,906,1171,-5,5,901,1176,9,11,910,1165,861,106,126,126,0,,0,0.0,0.0,0.0,0.0,0.0
2024,1,4,4,2024-01-04,WN,1847,SAN,MCO,"San Diego, CA",California,"Orlando, FL",Florida,676,665,4,5,680,670,16,14,696,656,2425,297,317,327,0,,0,0.0,0.0,0.0,0.0,0.0
2024,12,16,1,2024-12-16,HA,8332,SLC,IAD,"Salt Lake City, UT",Utah,"Washington, DC",District of Columbia,2023,765,-10,0,2013,765,27,5,2040,760,2010,250,270,282,0,,0,0.0,0.0,0.0,0.0,0.0
2024,12,1,7,2024-12-01,OO,138,SFO,LAX,"San Francisco, CA",California,"Los Angeles, CA",California,618,2115,-9,0,609,2115,22,15,631,2100,995,130,150,167,0,,0,0.0,0.0,0.0,0.0,0.0
2024,10,18,5,2024-10-18,9E,7143,IAH,LAX,"Houston, TX",Texas,"Los Angeles, CA",California,1713,2276,-1,5,1712,2281,25,19,1737,2262,2110,265,285,309,0,,0,0.0,0.0,0.0,0.0,0.0
2024,10,7,1,2024-10-07,G4,2251,IAD,TPA,"Washington, DC",District of Columbia,"Tampa, FL",Florida,1113,1163,6,0,1119,1163,16,6,1135,1157,1852,234,254,256,0,,0,0.0,0.0,0.0,0.0,0.0
2024,8,2,5,2024-08-02,G4,4037,SLC,MCO,"Salt Lake City, UT",Utah,"Orlando, FL",Florida,864,779,2,0,866,779,25,18,891,761,1671,201,221,244,0,,0,0.0,0.0,0.0,0.0,0.0
2024,4,7,7,2024-04-07,B6,6986,IAH,CLT,"Houston, TX",Texas,"Charlotte, NC",North Carolina,985,1143,0,5,985,1148,12,15,997,1133,897,121,141,148,0,,0,0.0,0.0,0.0,0.0,0.0
2024,4,10,3,2024-04-10,AS,308,LAS,ORD,"Las Vegas, NV",Nevada,"Chicago, IL",Illinois,1602,1325,-21,-20,1581,1305,13,13,1594,1292,562,79,99,105,0,,0,0.0,0.0,0.0,0.0,0.0
2024,1,9,2,2024-01-09,B6,699,DTW,LAS,"Detroit, MI",Michigan,"Las Vegas, NV",Nevada,821,1376,-24,-15,797,1361,19,13,816,1348,2355,288,308,320,0,,0,0.0,0.0,0.0,0.0,0.0
2024,3,1,5,2024-03-01,UA,8896,PHL,TPA,"Philadelphia, PA",Pennsylvania,"Tampa, FL",Florida,638,1640,-21,-15,617,1625,7,3,624,1622,2100,266,286,276,0,,0,0.0,0.0,0.0,0.0,0.0
2024,11,4,1,2024-11-04,OO,3809,MIA,ATL,"Miami, FL",Florida,"Atlanta, GA",Georgia,1859,725,3,-5,1862,720,19,10,1881,710,1665,215,235,244,1,,0,0.0,0.0,0.0,0.0,0.0
2024,5,25,6,2024-05-25,F9,7826,SAN,BWI,"San Diego, CA",California,"Baltimore, MD",Maryland,1925,681,1,10,1926,691,8,13,1934,678,2151,260,280,281,0,,0,0.0,0.0,0.0,0.0,0.0
2024,3,3,7,2024-03-03,G4,313,CLT,ORD,"Charlotte, NC",North Carolina,"Chicago, IL",Illinois,1749,1663,-10,0,1739,1663,20,9,1759,1654,2322,294,314,323,0,,0,0.0,0.0,0.0,0.0,0.0
2024,4,30,2,2024-04-30,HA,5823,EWR,TPA,"Newark, NJ",New Jersey,"Tampa, FL",Florida,1789,2239,17,20,1806,2259,29,14,1835,2245,2669,337,357,380,0,,0,5.0,3.0,1.0,0.0,11.0
2024,8,13,2,2024-08-13,WN,6652,CLT,SAN,"Charlotte, NC",North Carolina,"San Diego, CA",California,832,1842,-16,-20,816,1822,29,3,845,1819,1881,234,254,266,0,,0,0.0,0.0,0.0,0.0,0.0
2024,4,14,7,2024-04-14,G4,9868,PHL,SEA,"Philadelphia, PA",Pennsylvania,"Seattle, WA",Washington,723,1570,0,5,723,1575,23,13,746,1562,1719,215,235,251,0,,0,0.0,0.0,0.0,0.0,0.0
2024,9,16,1,2024-09-16,G4,6338,SAN,PHX,"San Diego, CA",California,"Phoenix, AZ",Arizona,1071,1805,-12,-5,1059,1800,22,5,1081,1795,738,93,113,120,0,,0,0.0,0.0,0.0,0.0,0.0
2024,12,14,6,2024-12-14,NK,8560,SFO,PHL,"San Francisco, CA",California,"Philadelphia, PA",Pennsylvania,1275,1037,-19,-20,1256,1017,20,15,1276,1002,1325,159,179,194,0,,0,0.0,0.0,0.0,0.0,0.0
2024,9,11,3,2024-09-11,F9,2508,MCO,BWI,"Orlando, FL",Florida,"Baltimore, MD",Maryland,1466,2291,15,10,1481,2301,16,7,1497,2294,241,24,44,47,0,,0,0.0,0.0,0.0,0.0,0.0
2024,7,25,4,2024-07-25,HA,8072,LAS,DTW,"Las Vegas, NV",Nevada,"Detroit, MI",Michigan,2083,1567,-19,-10,2064,1557,16,12,2080,1545,2608,323,343,351,0,,0,0.0,0.0,0.0,0.0,0.0
2024,1,28,7,2024-01-28,UA,4878,LAS,DEN,"Las Vegas, NV",Nevada,"Denver, CO",Colorado,1092,2313,-13,-10,1079,2303,27,9,1106,2294,2646,332,352,368,0,,0,0.0,0.0,0.0,0.0,0.0
2024,6,18,2,2024-06-18,HA,922,SAN,JFK,"San Diego, CA",California,"New York, NY",New York,1308,1129,-10,-5,1298,1124,8,4,1306,1120,2068,255,275,267,0,,0,0.0,0.0,0.0,0.0,0.0
2024,12,1,7,2024-12-01,B6,6200,JFK,LAX,"New York, NY",New York,"Los Angeles, CA",California,1486,2276,-3,5,1483,2281,19,14,1502,2267,811,94,114,127,0,,0,0.0,0.0,0.0,0.0,0.0
2024,3,16,6,2024-03-16,UA,2695,MSP,SAN,"Minneapolis, MN",Minnesota,"San Diego, CA",California,1523,1784,-10,0,1513,1784,23,9,1536,1775,2836,356,376,388,0,,0,0.0,0.0,0.0,0.0,0.0
2024,4,25,4,2024-04-25,NK,8217,IAH,DCA,"Houston, TX",Texas,"Washington, DC",District of Columbia,2043,2349,-13,-10,2030,2339,22,14,2052,2325,2638,337,357,373,0,,0,0.0,0.0,0.0,0.0,0.0
2024,3,9,6,2024-03-09,AS,4053,MSP,LGA,"Minneapolis, MN",Minnesota,"New York, NY",New York,1360,1533,-9,-10,1351,1523,15,6,1366,1517,1668,207,227,228,0,,0,0.0,0.0,0.0,0.0,0.0
2024,12,19,4,2024-12-19,OO,3931,LGA,PHX,"New York, NY",New York,"Phoenix, AZ",Arizona,1772,1333,-19,-15,1753,1318,28,13,1781,1305,2740,335,355,376,0,,0,0.0,0.0,0.0,0.0,0.0
2024,8,21,3,2024-08-21,UA,4683,BOS,SAN,"Boston, MA",Massachusetts,"San Diego, CA",California,2279,1156,-9,-15,2270,1141,27,10,2297,1131,1628,211,231,248,0,,0,0.0,0.0,0.0,0.0,0.0
2024,1,1,1,2024-01-01,G4,6335,MDW,SFO,"Chicago, IL",Illinois,"San Francisco, CA",California,2200,1810,12,10,2212,1820,19,4,2231,1816,2168,279,299,302,0,,0,0.0,0.0,0.0,0.0,0.0
2024,6,15,6,2024-06-15,YX,8942,BOS,PHL,"Boston, MA",Massachusetts,"Philadelphia, PA",Pennsylvania,1944,1977,22,15,1966,1992,20,4,1986,1988,1124,148,168,172,0,,0,0.0,0.0,0.0,0.0,0.0
2024,12,17,2,2024-12-17,AA,8083,PHX,JFK,"Phoenix, AZ",Arizona,"New York, NY",New York,686,1998,25,20,711,2018,15,6,726,2012,2842,361,381,382,0,,0,1.0,1.0,3.0,0.0,15.0
2024,8,5,1,2024-08-05,9E,6600,MCO,LGA,"Orlando, FL",Florida,"New York, NY",New York,748,2090,7,10,755,2100,15,10,770,2090,290,34,54,59,0,,0,0.0,0.0,0.0,0.0,0.0
2024,9,29,7,2024-09-29,UA,5951,BOS,SLC,"Boston, MA",Massachusetts,"Salt Lake City, UT",Utah,1650,840,11,10,1661,850,25,13,1686,837,1463,187,207,225,0,,0,0.0,0.0,0.0,0.0,0.0
2024,9,7,6,2024-09-07,HA,1734,MDW,CLT,"Chicago, IL",Illinois,"Charlotte, NC",North Carolina,1611,933,5,10,1616,943,17,10,1633,933,2376,296,316,323,0,,0,0.0,0.0,0.0,0.0,0.0
2024,12,12,4,2024-12-12,HA,4914,LAS,IAD,"Las Vegas, NV",Nevada,"Washington, DC",District of Columbia,1568,647,11,20,1579,667,11,7,1590,660,802,103,123,121,0,,0,7.0,0.0,1.0,0.0,12.0
2024,12,9,1,2024-12-09,HA,1267,SAN,IAD,"San Diego, CA",California,"Washington, DC",District of Columbia,1523,1734,6,10,1529,1744,19,10,1548,1734,1365,174,194,203,0,,0,0.0,0.0,0.0,0.0,0.0
2024,6,22,6,2024-06-22,OO,4176,PDX,LGA,"Portland, OR",Oregon,"New York, NY",New York,745,2218,-7,0,738,2218,21,3,759,2215,1310,169,189,193,0,,0,0.0,0.0,0.0,0.0,0.0
2024,6,18,2,2024-06-18,HA,8490,IAH,SAN,"Houston, TX",Texas,"San Diego, CA",California,1426,1727,4,-5,1430,1722,29,14,1459,1708,1526,199,219,242,0,,0,0.0,0.0,0.0,0.0,0.0
2024,9,2,1,2024-09-02,9E,7058,JFK,LGA,"New York, NY",New York,"New York, NY",New York,1934,1062,5,0,1939,1062,28,13,1967,1049,2947,360,380,401,0,,0,0.0,0.0,0.0,0.0,0.0
2024,3,30,6,2024-03-30,OO,5542,PHL,DEN,"Philadelphia, PA",Pennsylvania,"Denver, CO",Colorado,1741,1697,6,0,1747,1697,17,12,1764,1685,1819,223,243,252,0,,0,0.0,0.0,0.0,0.0,0.0
2024,2,18,7,2024-02-18,NK,9647,MSP,PHL,"Minneapolis, MN",Minnesota,"Philadelphia, PA",Pennsylvania,1950,2190,-8,0,1942,2190,8,4,1950,2186,363,40,60,52,0,,0,0.0,0.0,0.0,0.0,0.0
2024,10,20,7,2024-10-20,UA,6460,BOS,MSP,"Boston, MA",Massachusetts,"Minneapolis, MN",Minnesota,514,916,-3,5,511,921,5,15,516,906,636,76,96,96,0,,0,0.0,0.0,0.0,0.0,0.0
2024,5,29,3,2024-05-29,OH,6799,DFW,LAS,"Dallas/Fort Worth, TX",Texas,"Las Vegas, NV",Nevada,2291,601,8,5,2299,606,16,14,2315,592,2443,302,322,332,0,,0,0.0,0.0,0.0,0.0,0.0
2024,5,11,6,2024-05-11,UA,3605,ATL,TPA,"Atlanta, GA",Georgia,"Tampa, FL",Florida,1325,971,-12,-15,1313,956,8,12,1321,944,1562,203,223,223,0,,0,0.0,0.0,0.0,0.0,0.0
2024,2,28,3,2024-02-28,DL,902,EWR,PHX,"Newark, NJ",New Jersey,"Phoenix, AZ",Arizona,1188,2092,-14,-10,1174,2082,5,4,1179,2078,2185,282,302,291,0,,0,0.0,0.0,0.0,0.0,0.0
2024,11,19,2,2024-11-19,G4,7727,SLC,DFW,"Salt Lake City, UT",Utah,"Dallas/Fort Worth, TX",Texas,1858,1633,0,10,1858,1643,10,16,1868,1627,337,39,59,65,0,,0,0.0,0.0,0.0,0.0,0.0
2024,7,17,3,2024-07-17,OO,8992,STL,MCO,"St. Louis, MO",Missouri,"Orlando, FL",Florida,1226,1187,4,0,1230,1187,28,11,1258,1176,2040,253,273,292,0,,0,0.0,0.0,0.0,0.0,0.0
2024,8,2,5,2024-08-02,WN,602,SEA,MIA,"Seattle, WA",Washington,"Miami, FL",Florida,1036,1022,-2,-5,1034,1017,15,8,1049,1009,306,32,52,55,0,,0,0.0,0.0,0.0,0.0,0.0
2024,2,18,7,2024-02-18,9E,5925,MCO,LAX,"Orlando, FL",Florida,"Los Angeles, CA",California,991,1881,3,10,994,1891,25,19,1019,1872,1918,242,262,286,0,,0,0.0,0.0,0.0,0.0,0.0
2024,8,19,1,2024-08-19,MQ,8039,ORD,BOS,"Chicago, IL",Illinois,"Boston, MA",Massachusetts,791,2256,-17,-10,774,2246,29,9,803,2237,2290,295,315,333,0,,0,0.0,0.0,0.0,0.0,0.0
2024,9,3,2,2024-09-03,AS,6132,MCO,ORD,"Orlando, FL",Florida,"Chicago, IL",Illinois,616,1432,-5,-5,611,1427,22,4,633,1423,2322,289,309,315,0,,0,0.0,0.0,0.0,0.0,0.0
2024,8,26,1,2024-08-26,DL,7506,IAH,DCA,"Houston, TX",Texas,"Washington, DC",District of Columbia,1091,1561,-20,-10,1071,1551,22,12,1093,1539,2298,296,316,330,0,,0,0.0,0.0,0.0,0.0,0.0
2024,6,16,7,2024-06-16,G4,4819,TPA,LGA,"Tampa, FL",Florida,"New York, NY",New York,1186,1326,10,10,1196,1336,24,3,1220,1333,1885,236,256,263,0,,0,0.0,0.0,0.0,0.0,0.0
2024,2,17,6,2024-02-17,HA,7848,MDW,IAH,"Chicago, IL",Illinois,"Houston, TX",Texas,1243,1075,6,5,1249,1080,10,4,1259,1076,880,118,138,132,0,,0,0.0,0.0,0.0,0.0,0.0
2024,2,20,2,2024-02-20,NK,2970,LAX,SFO,"Los Angeles, CA",California,"San Francisco, CA",California,1992,844,4,0,1996,844,18,17,2014,827,2300,280,300,315,0,,0,0.0,0.0,0.0,0.0,0.0
2024,10,25,5,2024-10-25,9E,4858,EWR,BWI,"Newark, NJ",New Jersey,"Baltimore, MD",Maryland,1447,1960,19,15,1466,1975,10,19,1476,1956,2177,269,289,298,0,,0,0.0,0.0,0.0,0.0,0.0
2024,4,7,7,2024-04-07,B6,6068,ORD,PHX,"Chicago, IL",Illinois,"Phoenix, AZ",Arizona,2075,1291,8,15,2083,1306,26,5,2109,1301,2905,360,380,391,0,,0,0.0,0.0,0.0,0.0,0.0
2024,8,3,6,2024-08-03,NK,9710,CLT,MSP,"Charlotte, NC",North Carolina,"Minneapolis, MN",Minnesota,1182,1087,0,5,1182,1092,19,9,1201,1083,2553,328,348,356,0,,0,0.0,0.0,0.0,0.0,0.0
2024,6,25,2,2024-06-25,OH,1198,SAN,DEN,"San Diego, CA",California,"Denver, CO",Colorado,1128,1452,1,10,1129,1462,26,14,1155,1448,2205,267,287,307,0,,0,0.0,0.0,0.0,0.0,0.0
2024,3,20,3,2024-03-20,WN,3269,PHX,DEN,"Phoenix, AZ",Arizona,"Denver, CO",Colorado,2219,1696,3,5,2222,1701,5,16,2227,1685,2822,347,367,368,0,,0,0.0,0.0,0.0,0.0,0.0
2024,7,3,3,2024-07-03,MQ,482,LAS,LGA,"Las Vegas, NV",Nevada,"New York, NY",New York,1092,2344,-3,0,1089,2344,21,19,1110,2325,1338,174,194,214,0,,0,0.0,0.0,0.0,0.0,0.0
2024,1,27,6,2024-01-27,9E,7890,DFW,MDW,"Dallas/Fort Worth, TX",Texas,"Chicago, IL",Illinois,886,1352,3,-5,889,1347,16,7,905,1340,2966,377,397,400,0,,0,0.0,0.0,0.0,0.0,0.0
2024,7,13,6,2024-07-13,MQ,4040,SFO,BWI,"San Francisco, CA",California,"Baltimore, MD",Maryland,2106,2308,-13,-10,2093,2298,7,10,2100,2288,1871,227,247,244,0,,0,0.0,0.0,0.0,0.0,0.0
2024,8,1,4,2024-08-01,HA,9685,MSP,PHL,"Minneapolis, MN",Minnesota,"Philadelphia, PA",Pennsylvania,1151,1527,-6,-15,1145,1512,6,11,1151,1501,2842,347,367,364,0,,0,0.0,0.0,0.0,0.0,0.0
2024,12,7,6,2024-12-07,NK,7552,PHX,DCA,"Phoenix, AZ",Arizona,"Washington, DC",District of Columbia,692,1628,9,10,701,1638,27,4,728,1634,2828,356,376,387,0,,0,0.0,0.0,0.0,0.0,0.0
2024,4,23,2,2024-04-23,DL,6552,SLC,MCO,"Salt Lake City, UT",Utah,"Orlando, FL",Florida,2206,2085,-9,-15,2197,2070,10,17,2207,2053,2360,303,323,330,0,,0,0.0,0.0,0.0,0.0,0.0
2024,8,29,4,2024-08-29,NK,9944,IAH,MSP,"Houston, TX",Texas,"Minneapolis, MN",Minnesota,600,1989,3,-5,603,1984,9,18,612,1966,1238,152,172,179,0,,0,0.0,0.0,0.0,0.0,0.0
2024,5,3,5,2024-05-03,HA,4371,ATL,EWR,"Atlanta, GA",Georgia,"Newark, NJ",New Jersey,1593,2118,-20,-10,1573,2108,12,19,1585,2089,2134,256,276,287,0,,0,0.0,0.0,0.0,0.0,0.0
2024,10,31,4,2024-10-31,WN,4423,BWI,DEN,"Baltimore, MD",Maryland,"Denver, CO",Colorado,1697,816,4,0,1701,816,6,12,1707,804,1584,193,213,211,0,,0,0.0,0.0,0.0,0.0,0.0
2024,3,16,6,2024-03-16,WN,2138,BOS,DFW,"Boston, MA",Massachusetts,"Dallas/Fort Worth, TX",Texas,943,1837,-5,-5,938,1832,16,14,954,1818,1998,256,276,286,0,,0,0.0,0.0,0.0,0.0,0.0
2024,11,6,3,2024-11-06,AA,5561,DTW,LAX,"Detroit, MI",Michigan,"Los Angeles, CA",California,2224,1558,6,10,2230,1568,11,11,2241,1557,412,45,65,67,0,,0,0.0,0.0,0.0,0.0,0.0
2024,11,7,4,2024-11-07,YX,8163,IAD,SAN,"Washington, DC",District of Columbia,"San Diego, CA",California,932,1948,25,20,957,1968,18,15,975,1953,2357,299,319,332,0,,0,4.0,0.0,3.0,0.0,13.0
2024,7,14,7,2024-07-14,UA,2085,JFK,DTW,"New York, NY",New York,"Detroit, MI",Michigan,1738,909,7,15,1745,924,14,4,1759,920,609,76,96,94,0,,0,0.0,0.0,0.0,0.0,0.0
2024,12,16,1,2024-12-16,B6,1362,IAD,LAX,"Washington, DC",District of Columbia,"Los Angeles, CA",California,1036,637,1,0,1037,637,24,8,1061,629,2081,267,287,299,0,,0,0.0,0.0,0.0,0.0,0.0
2024,2,13,2,2024-02-13,B6,5831,DFW,PDX,"Dallas/Fort Worth, TX",Texas,"Portland, OR",Oregon,1100,1504,25,20,1125,1524,18,5,1143,1519,2373,298,318,321,0,,0,6.0,1.0,1.0,0.0,12.0
2024,7,4,4,2024-07-04,DL,5216,IAD,DEN,"Washington, DC",District of Columbia,"Denver, CO",Colorado,2166,1684,4,-5,2170,1679,15,19,2185,1660,1571,198,218,232,0,,0,0.0,0.0,0.0,0.0,0.0
2024,12,8,7,2024-12-08,WN,449,PHX,SLC,"Phoenix, AZ",Arizona,"Salt Lake City, UT",Utah,1207,1718,8,0,1215,1718,23,16,1238,1702,2768,348,368,387,0,,0,0.0,0.0,0.0,0.0,0.0
2024,9,2,1,2024-09-02,AA,540,DTW,LAS,"Detroit, MI",Michigan,"Las Vegas, NV",Nevada,818,832,-19,-10,799,822,5,13,804,809,353,44,64,62,0,,0,0.0,0.0,0.0,0.0,0.0
2024,3,24,7,2024-03-24,HA,2908,DCA,LAS,"Washington, DC",District of Columbia,"Las Vegas, NV",Nevada,1809,2171,7,10,1816,2181,6,8,1822,2173,2106,265,285,279,0,,0,0.0,0.0,0.0,0.0,0.0
2024,7,25,4,2024-07-25,G4,2662,EWR,LAS,"Newark, NJ",New Jersey,"Las Vegas, NV",Nevada,724,1112,-2,-10,722,1102,27,7,749,1095,1740,215,235,249,0,,0,0.0,0.0,0.0,0.0,0.0
2024,5,30,4,2024-05-30,AA,3252,DCA,DTW,"Washington, DC",District of Columbia,"Detroit, MI",Michigan,1872,749,0,0,1872,749,7,11,1879,738,2869,348,368,366,0,,0,0.0,0.0,0.0,0.0,0.0
2024,6,4,2,2024-06-04,AS,9676,SLC,SAN,"Salt Lake City, UT",Utah,"San Diego, CA",California,887,2094,5,5,892,2099,9,12,901,2087,606,70,90,91,0,,0,0.0,0.0,0.0,0.0,0.0
2024,1,16,2,2024-01-16,NK,8579,DTW,BOS,"Detroit, MI",Michigan,"Boston, MA",Massachusetts,1345,814,-9,0,1336,814,15,14,1351,800,1443,171,191,200,0,,0,0.0,0.0,0.0,0.0,0.0
2024,6,13,4,2024-06-13,UA,9289,PHL,LAS,"Philadelphia, PA",Pennsylvania,"Las Vegas, NV",Nevada,1864,998,-21,-15,1843,983,23,15,1866,968,2732,342,362,380,0,,0,0.0,0.0,0.0,0.0,0.0
2024,5,24,5,2024-05-24,YX,2433,MSP,BOS,"Minneapolis, MN",Minnesota,"Boston, MA",Massachusetts,2184,2181,-6,0,2178,2181,11,12,2189,2169,1932,244,264,267,0,,0,0.0,0.0,0.0,0.0,0.0
2024,2,6,2,2024-02-06,HA,9714,DTW,PHL,"Detroit, MI",Michigan,"Philadelphia, PA",Pennsylvania,2027,2200,4,5,2031,2205,20,3,2051,2202,2052,263,283,286,0,,0,0.0,0.0,0.0,0.0,0.0
2024,11,28,4,2024-11-28,AA,173,ATL,LAX,"Atlanta, GA",Georgia,"Los Angeles, CA",California,570,1629,-19,-10,551,1619,24,9,575,1610,290,37,57,70,0,,0,0.0,0.0,0.0,0.0,0.0
2024,2,14,3,2024-02-14,NK,9754,MSP,ORD,"Minneapolis, MN",Minnesota,"Chicago, IL",Illinois,1652,1704,9,5,1661,1709,12,15,1673,1694,667,91,111,118,0,,0,0.0,0.0,0.0,0.0,0.0
2024,7,24,3,2024-07-24,UA,7644,PHX,DCA,"Phoenix, AZ",Arizona,"Washington, DC",District of Columbia,943,788,17,10,960,798,28,17,988,781,1451,186,206,231,0,,0,0.0,0.0,0.0,0.0,0.0
2024,3,2,6,2024-03-02,MQ,7049,IAH,SFO,"Houston, TX",Texas,"San Francisco, CA",California,1813,2286,31,30,1844,2316,8,16,1852,2300,1196,158,178,182,0,,0,1.0,8.0,5.0,0.0,16.0
2024,12,21,6,2024-12-21,9E,2305,ATL,EWR,"Atlanta, GA",Georgia,"Newark, NJ",New Jersey,1098,1259,-6,-5,1092,1254,16,8,1108,1246,2325,293,313,317,0,,0,0.0,0.0,0.0,0.0,0.0
2024,11,3,7,2024-11-03,YX,8721,ORD,MIA,"Chicago, IL",Illinois,"Miami, FL",Florida,886,627,-24,-20,862,607,22,3,884,604,1398,182,202,207,0,,0,0.0,0.0,0.0,0.0,0.0
2024,1,19,5,2024-01-19,YX,1571,BOS,BWI,"Boston, MA",Massachusetts,"Baltimore, MD",Maryland,517,1276,-1,-5,516,1271,27,10,543,1261,1677,215,235,252,0,,0,0.0,0.0,0.0,0.0,0.0
2024,12,30,1,2024-12-30,AS,3581,LAX,MSP,"Los Angeles, CA",California,"Minneapolis, MN",Minnesota,2078,734,9,5,2087,739,18,6,2105,733,994,123,143,147,0,,0,0.0,0.0,0.0,0.0,0.0
2024,10,26,6,2024-10-26,MQ,7638,IAD,DTW,"Washington, DC",District of Columbia,"Detroit, MI",Michigan,1599,904,11,10,1610,914,21,15,1631,899,2256,275,295,311,0,,0,0.0,0.0,0.0,0.0,0.0
2024,1,7,7,2024-01-07,YX,3280,TPA,PHL,"Tampa, FL",Florida,"Philadelphia, PA",Pennsylvania,1052,1094,24,15,1076,1109,16,5,1092,1104,1426,183,203,204,0,,0,0.0,0.0,0.0,0.0,0.0
2024,9,5,4,2024-09-05,OH,1830,BWI,PHX,"Baltimore, MD",Maryland,"Phoenix, AZ",Arizona,1373,1323,19,15,1392,1338,13,4,1405,1334,509,53,73,70,0,,0,0.0,0.0,0.0,0.0,0.0
2024,4,26,5,2024-04-26,AS,135,BOS,PDX,"Boston, MA",Massachusetts,"Portland, OR",Oregon,1888,1903,-3,5,1885,1908,20,13,1905,1895,1868,224,244,257,0,,0,0.0,0.0,0.0,0.0,0.0
2024,3,8,5,2024-03-08,OH,1120,HNL,LAX,"Honolulu, HI",Hawaii,"Los Angeles, CA",California,1803,1703,10,5,1813,1708,25,8,1838,1700,402,52,72,85,0,,0,0.0,0.0,0.0,0.0,0.0
2024,2,3,6,2024-02-03,YX,5634,PHL,SLC,"Philadelphia, PA",Pennsylvania,"Salt Lake City, UT",Utah,779,1459,-12,-20,767,1439,14,15,781,1424,2762,344,364,373,0,,0,0.0,0.0,0.0,0.0,0.0
2024,7,12,5,2024-07-12,WN,7261,CLT,STL,"Charlotte, NC",North Carolina,"St. Louis, MO",Missouri,1270,990,-9,-5,1261,985,24,4,1285,981,1569,203,223,231,0,,0,0.0,0.0,0.0,0.0,0.0
2024,11,20,3,2024-11-20,YX,8109,LAX,TPA,"Los Angeles, CA",California,"Tampa, FL",Florida,1966,1638,21,15,1987,1653,24,16,2011,1637,1109,128,148,168,0,,0,0.0,0.0,0.0,0.0,0.0
2024,2,24,6,2024-02-24,OO,3217,DFW,SFO,"Dallas/Fort Worth, TX",Texas,"San Francisco, CA",California,1453,1198,-2,5,1451,1203,15,13,1466,1190,1215,146,166,174,0,,0,0.0,0.0,0.0,0.0,0.0
2024,9,22,7,2024-09-22,AS,2635,PHX,PDX,"Phoenix, AZ",Arizona,"Portland, OR",Oregon,828,1518,4,0,832,1518,13,10,845,1508,1946,236,256,259,0,,0,0.0,0.0,0.0,0.0,0.0
2024,2,11,7,2024-02-11,OO,4814,PHL,SFO,"Philadelphia, PA",Pennsylvania,"San Francisco, CA",California,2059,1491,-17,-15,2042,1476,5,12,2047,1464,1656,209,229,226,0,,0,0.0,0.0,0.0,0.0,0.0
2024,10,23,3,2024-10-23,9E,8437,BOS,HNL,"Boston, MA",Massachusetts,"Honolulu, HI",Hawaii,1007,822,-4,-10,1003,812,20,17,1023,795,1589,196,216,233,0,,0,0.0,0.0,0.0,0.0,0.0
2024,8,18,7,2024-08-18,WN,5063,JFK,MDW,"New York, NY",New York,"Chicago, IL",Illinois,949,2226,-10,0,939,2226,8,15,947,2211,2719,344,364,367,0,,0,0.0,0.0,0.0,0.0,0.0
2024,1,10,3,2024-01-10,HA,6191,SFO,BOS,"San Francisco, CA",California,"Boston, MA",Massachusetts,1898,1427,1,10,1899,1437,26,9,1925,1428,2069,253,273,288,0,,0,0.0,0.0,0.0,0.0,0.0
2024,12,23,1,2024-12-23,MQ,1126,CLT,MSP,"Charlotte, NC",North Carolina,"Minneapolis, MN",Minnesota,1819,865,-19,-15,1800,850,12,9,1812,841,337,33,53,54,0,,0,0.0,0.0,0.0,0.0,0.0
2024,5,7,2,2024-05-07,F9,3765,HNL,MSP,"Honolulu, HI",Hawaii,"Minneapolis, MN",Minnesota,1999,1943,-7,-10,1992,1933,6,6,1998,1927,1726,206,226,218,0,,0,0.0,0.0,0.0,0.0,0.0
2024,6,27,4,2024-06-27,G4,1386,DEN,MIA,"Denver, CO",Colorado,"Miami, FL",Florida,1338,1729,-1,5,1337,1734,18,6,1355,1728,2628,330,350,354,0,,0,0.0,0.0,0.0,0.0,0.0
2024,7,11,4,2024-07-11,DL,2946,MIA,ATL,"Miami, FL",Florida,"Atlanta, GA",Georgia,892,852,-17,-10,875,842,28,18,903,824,1102,136,156,182,0,,0,0.0,0.0,0.0,0.0,0.0
2024,4,1,1,2024-04-01,NK,8612,BWI,MDW,"Baltimore, MD",Maryland,"Chicago, IL",Illinois,608,798,-8,-10,600,788,13,15,613,773,2026,260,280,288,0,,0,0.0,0.0,0.0,0.0,0.0
2024,8,18,7,2024-08-18,G4,7874,LAS,HNL,"Las Vegas, NV",Nevada,"Honolulu, HI",Hawaii,858,1679,-11,-10,847,1669,28,4,875,1665,2948,361,381,393,0,,0,0.0,0.0,0.0,0.0,0.0
2024,3,18,1,2024-03-18,G4,2393,BOS,MIA,"Boston, MA",Massachusetts,"Miami, FL",Florida,1455,1527,2,0,1457,1527,18,17,1475,1510,1062,141,161,176,0,,0,0.0,0.0,0.0,0.0,0.0
2024,3,25,1,2024-03-25,YX,1712,DCA,LAS,"Washington, DC",District of Columbia,"Las Vegas, NV",Nevada,1434,1006,1,0,1435,1006,18,9,1453,997,945,121,141,148,0,,0,0.0,0.0,0.0,0.0,0.0
2024,1,30,2,2024-01-30,B6,576,MCO,JFK,"Orlando, FL",Florida,"New York, NY",New York,1812,2061,22,15,1834,2076,25,11,1859,2065,2924,359,379,395,0,,0,0.0,0.0,0.0,0.0,0.0
2024,7,31,3,2024-07-31,AA,7526,BOS,SAN,"Boston, MA",Massachusetts,"San Diego, CA",California,1941,2080,0,0,1941,2080,16,10,1957,2070,1700,213,233,239,0,,0,0.0,0.0,0.0,0.0,0.0
2024,2,18,7,2024-02-18,AS,9074,SAN,STL,"San Diego, CA",California,"St. Louis, MO",Missouri,817,2100,12,5,829,2105,15,12,844,2093,781,93,113,120,0,,0,0.0,0.0,0.0,0.0,0.0
2024,9,21,6,2024-09-21,HA,2047,SEA,DEN,"Seattle, WA",Washington,"Denver, CO",Colorado,840,1970,-9,-10,831,1960,5,6,836,1954,2767,344,364,355,0,,0,0.0,0.0,0.0,0.0,0.0
2024,5,24,5,2024-05-24,F9,3431,JFK,HNL,"New York, NY",New York,"Honolulu, HI",Hawaii,1840,1085,-5,5,1835,1090,26,14,1861,1076,2464,298,318,338,1,,0,0.0,0.0,0.0,0.0,0.0
2024,3,9,6,2024-03-09,AA,5360,PHX,IAH,"Phoenix, AZ",Arizona,"Houston, TX",Texas,848,1452,5,0,853,1452,5,10,858,1442,1292,157,177,172,0,,0,0.0,0.0,0.0,0.0,0.0
2024,2,27,2,2024-02-27,DL,6166,JFK,DFW,"New York, NY",New York,"Dallas/Fort Worth, TX",Texas,526,962,-7,-10,519,952,15,3,534,949,1553,186,206,204,0,,0,0.0,0.0,0.0,0.0,0.0
2024,7,3,3,2024-07-03,MQ,7747,MDW,IAD,"Chicago, IL",Illinois,"Washington, DC",District of Columbia,1137,2353,-5,5,1132,2358,24,11,1156,2347,478,60,80,95,0,,0,0.0,0.0,0.0,0.0,0.0
2024,3,2,6,2024-03-02,MQ,5569,JFK,PHL,"New York, NY",New York,"Philadelphia, PA",Pennsylvania,900,811,-14,-10,886,801,29,9,915,792,2632,337,357,375,0,,0,0.0,0.0,0.0,0.0,0.0
2024,11,3,7,2024-11-03,AA,1693,SLC,SFO,"Salt Lake City, UT",Utah,"San Francisco, CA",California,815,1300,8,0,823,1300,19,11,842,1289,2145,277,297,307,0,,0,0.0,0.0,0.0,0.0,0.0
2024,10,22,2,2024-10-22,B6,7804,IAD,JFK,"Washington, DC",District of Columbia,"New York, NY",New York,2205,1476,-1,5,2204,1481,25,9,2229,1472,794,90,110,124,0,,0,0.0,0.0,0.0,0.0,0.0
2024,6,14,5,2024-06-14,DL,6254,PHX,LGA,"Phoenix, AZ",Arizona,"New York, NY",New York,2082,1213,11,5,2093,1218,27,4,2120,1214,1667,202,222,233,0,,0,0.0,0.0,0.0,0.0,0.0
2024,6,19,3,2024-06-19,HA,356,PDX,IAD,"Portland, OR",Oregon,"Washington, DC",District of Columbia,867,1515,14,15,881,1530,13,18,894,1512,1079,130,150,161,0,,0,0.0,0.0,0.0,0.0,0.0
2024,3,3,7,2024-03-03,9E,6612,BOS,MDW,"Boston, MA",Massachusetts,"Chicago, IL",Illinois,842,2060,8,15,850,2075,24,12,874,2063,1273,166,186,202,0,,0,0.0,0.0,0.0,0.0,0.0
2024,5,26,7,2024-05-26,9E,3091,LGA,ATL,"New York, NY",New York,"Atlanta, GA",Georgia,1192,742,13,10,1205,752,25,12,1230,740,2304,282,302,319,0,,0,0.0,0.0,0.0,0.0,0.0
2024,11,1,5,2024-11-01,OH,1517,LAX,LAS,"Los Angeles, CA",California,"Las Vegas, NV",Nevada,1888,1908,5,10,1893,1918,26,16,1919,1902,1673,201,221,243,0,,0,0.0,0.0,0.0,0.0,0.0
2024,6,9,7,2024-06-09,WN,7860,DEN,CLT,"Denver, CO",Colorado,"Charlotte, NC",North Carolina,1403,1693,-19,-20,1384,1673,21,11,1405,1662,646,83,103,115,0,,0,0.0,0.0,0.0,0.0,0.0
2024,5,20,1,2024-05-20,AA,8065,DTW,SAN,"Detroit, MI",Michigan,"San Diego, CA",California,1596,2200,4,-5,1600,2195,14,4,1614,2191,531,60,80,78,0,,0,0.0,0.0,0.0,0.0,0.0
2024,11,29,5,2024-11-29,NK,4214,PHL,ORD,"Philadelphia, PA",Pennsylvania,"Chicago, IL",Illinois,1645,1557,-19,-20,1626,1537,19,13,1645,1524,2483,304,324,336,0,,0,0.0,0.0,0.0,0.0,0.0
2024,4,6,6,2024-04-06,F9,8401,CLT,IAH,"Charlotte, NC",North Carolina,"Houston, TX",Texas,685,2333,-20,-10,665,2323,16,8,681,2315,2282,289,309,313,0,,0,0.0,0.0,0.0,0.0,0.0
2024,8,8,4,2024-08-08,B6,2652,SEA,MDW,"Seattle, WA",Washington,"Chicago, IL",Illinois,1335,2151,-4,-5,1331,2146,9,19,1340,2127,1447,182,202,210,0,,0,0.0,0.0,0.0,0.0,0.0
2024,2,12,1,2024-02-12,DL,9349,LAX,PHL,"Los Angeles, CA",California,"Philadelphia, PA",Pennsylvania,818,1933,5,10,823,1943,18,7,841,1936,2024,253,273,278,0,,0,0.0,0.0,0.0,0.0,0.0
2024,10,18,5,2024-10-18,F9,5507,LAS,DEN,"Las Vegas, NV",Nevada,"Denver, CO",Colorado,1454,1464,-7,0,1447,1464,14,13,1461,1451,1916,245,265,272,0,,0,0.0,0.0,0.0,0.0,0.0
2024,4,17,3,2024-04-17,AA,4833,SEA,SLC,"Seattle, WA",Washington,"Salt Lake City, UT",Utah,1093,1886,6,0,1099,1886,24,6,1123,1880,1743,218,238,248,0,,0,0.0,0.0,0.0,0.0,0.0
2024,9,22,7,2024-09-22,HA,2142,DCA,PDX,"Washington, DC",District of Columbia,"Portland, OR",Oregon,1491,659,-6,-5,1485,654,5,3,1490,651,2525,306,326,314,0,,0,0.0,0.0,0.0,0.0,0.0
2024,4,4,4,2024-04-04,NK,2281,ORD,MIA,"Chicago, IL",Illinois,"Miami, FL",Florida,2065,1121,8,0,2073,1121,20,18,2093,1103,1937,250,270,288,0,,0,0.0,0.0,0.0,0.0,0.0
2024,9,18,3,2024-09-18,AA,4592,HNL,DCA,"Honolulu, HI",Hawaii,"Washington, DC",District of Columbia,1292,908,10,10,1302,918,8,6,1310,912,1808,229,249,243,0,,0,0.0,0.0,0.0,0.0,0.0
2024,11,8,5,2024-11-08,YX,3658,BWI,ATL,"Baltimore, MD",Maryland,"Atlanta, GA",Georgia,2156,2143,-15,-5,2141,2138,9,17,2150,2121,1090,133,153,159,0,,0,0.0,0.0,0.0,0.0,0.0
2024,3,11,1,2024-03-11,AS,9913,DTW,MIA,"Detroit, MI",Michigan,"Miami, FL",Florida,852,2005,9,15,861,2020,13,5,874,2015,1981,245,265,263,0,,0,0.0,0.0,0.0,0.0,0.0
2024,8,6,2,2024-08-06,MQ,3758,EWR,MCO,"Newark, NJ",New Jersey,"Orlando, FL",Florida,854,940,-7,-10,847,930,21,14,868,916,2702,343,363,378,0,,0,0.0,0.0,0.0,0.0,0.0
2024,1,21,7,2024-01-21,AS,2794,LAX,BWI,"Los Angeles, CA",California,"Baltimore, MD",Maryland,605,2225,17,15,622,2240,10,17,632,2223,431,54,74,81,0,,0,0.0,0.0,0.0,0.0,0.0
2024,4,1,1,2024-04-01,HA,3984,LAX,SEA,"Los Angeles, CA",California,"Seattle, WA",Washington,917,2172,-29,-20,888,2152,28,13,916,2139,580,79,99,120,0,,0,0.0,0.0,0.0,0.0,0.0
2024,5,6,1,2024-05-06,B6,4880,BWI,DEN,"Baltimore, MD",Maryland,"Denver, CO",Colorado,1141,1499,3,0,1144,1499,29,5,1173,1494,2456,301,321,335,0,,0,0.0,0.0,0.0,0.0,0.0
2024,3,20,3,2024-03-20,HA,3384,SAN,DCA,"San Diego, CA",California,"Washington, DC",District of Columbia,704,1707,25,30,729,1737,9,13,738,1724,1138,150,170,172,0,,0,4.0,4.0,3.0,0.0,19.0
2024,11,7,4,2024-11-07,DL,6052,SEA,LAX,"Seattle, WA",Washington,"Los Angeles, CA",California,1064,1857,-5,0,1059,1857,22,10,1081,1847,2430,298,318,330,0,,0,0.0,0.0,0.0,0.0,0.0
2024,8,25,7,2024-08-25,DL,7617,SEA,SLC,"Seattle, WA",Washington,"Salt Lake City, UT",Utah,1905,1361,-10,0,1895,1361,21,4,1916,1357,982,130,150,155,0,,0,0.0,0.0,0.0,0.0,0.0
2024,6,30,7,2024-06-30,G4,6262,LAS,JFK,"Las Vegas, NV",Nevada,"New York, NY",New York,1820,839,14,5,1834,844,25,4,1859,840,1550,201,221,230,0,,0,0.0,0.0,0.0,0.0,0.0
2024,1,25,4,2024-01-25,B6,5206,PHX,LGA,"Phoenix, AZ",Arizona,"New York, NY",New York,1802,1727,-10,-10,1792,1717,15,14,1807,1703,1034,123,143,152,0,,0,0.0,0.0,0.0,0.0,0.0
2024,6,4,2,2024-06-04,B6,2266,STL,LAX,"St. Louis, MO",Missouri,"Los Angeles, CA",California,688,2346,-22,-15,666,2331,7,10,673,2321,2018,256,276,273,0,,0,0.0,0.0,0.0,0.0,0.0
2024,1,5,5,2024-01-05,NK,4497,CLT,LGA,"Charlotte, NC",North Carolina,"New York, NY",New York,2250,824,-15,-10,2235,814,10,8,2245,806,2341,292,312,310,0,,0,0.0,0.0,0.0,0.0,0.0
2024,4,29,1,2024-04-29,AS,7768,LGA,DTW,"New York, NY",New York,"Detroit, MI",Michigan,1042,878,-19,-10,1023,868,13,5,1036,863,1143,141,161,159,0,,0,0.0,0.0,0.0,0.0,0.0
2024,10,3,4,2024-10-03,DL,3492,MSP,TPA,"Minneapolis, MN",Minnesota,"Tampa, FL",Florida,1973,2016,24,15,1997,2031,17,13,2014,2018,2180,273,293,303,0,,0,0.0,0.0,0.0,0.0,0.0
2024,1,18,4,2024-01-18,OO,3811,ORD,DEN,"Chicago, IL",Illinois,"Denver, CO",Colorado,757,2301,4,10,761,2311,5,18,766,2293,1751,214,234,237,0,,0,0.0,0.0,0.0,0.0,0.0
2024,7,16,2,2024-07-16,AA,5979,DEN,SEA,"Denver, CO",Colorado,"Seattle, WA",Washington,952,1028,-1,-5,951,1023,19,13,970,1010,853,102,122,134,0,,0,0.0,0.0,0.0,0.0,0.0
2024,2,26,1,2024-02-26,B6,1686,MCO,JFK,"Orlando, FL",Florida,"New York, NY",New York,2095,1001,7,10,2102,1011,24,12,2126,999,2171,276,296,312,0,,0,0.0,0.0,0.0,0.0,0.0
2024,4,2,2,2024-04-02,WN,9506,SAN,TPA,"San Diego, CA",California,"Tampa, FL",Florida,577,645,-4,-10,573,635,8,12,581,623,2845,346,366,366,0,,0,0.0,0.0,0.0,0.0,0.0
2024,1,19,5,2024-01-19,YX,7238,LAX,MCO,"Los Angeles, CA",California,"Orlando, FL",Florida,1546,1113,-11,-10,1535,1103,27,19,1562,1084,2139,272,292,318,0,,0,0.0,0.0,0.0,0.0,0.0
2024,12,18,3,2024-12-18,UA,7762,ATL,MDW,"Atlanta, GA",Georgia,"Chicago, IL",Illinois,1002,1799,3,5,1005,1804,6,13,1011,1791,2817,353,373,372,0,,0,0.0,0.0,0.0,0.0,0.0
2024,7,11,4,2024-07-11,DL,7504,MIA,IAH,"Miami, FL",Florida,"Houston, TX",Texas,684,1623,-14,-5,670,1618,20,16,690,1602,996,131,151,167,0,,0,0.0,0.0,0.0,0.0,0.0
2024,8,24,6,2024-08-24,9E,9937,LGA,IAD,"New York, NY",New York,"Washington, DC",District of Columbia,1046,2253,-15,-15,1031,2238,28,11,1059,2227,843,100,120,139,0,,0,0.0,0.0,0.0,0.0,0.0
2024,10,3,4,2024-10-03,DL,9642,MDW,DCA,"Chicago, IL",Illinois,"Washington, DC",District of Columbia,2036,1989,-4,5,2032,1994,10,18,2042,1976,1702,206,226,234,0,,0,0.0,0.0,0.0,0.0,0.0
2024,8,14,3,2024-08-14,OH,8656,DCA,ORD,"Washington, DC",District of Columbia,"Chicago, IL",Illinois,2140,1796,35,30,2175,1826,24,8,2199,1818,1429,184,204,216,0,,0,11.0,4.0,2.0,0.0,13.0
2024,8,20,2,2024-08-20,HA,4039,DFW,SAN,"Dallas/Fort Worth, TX",Texas,"San Diego, CA",California,2211,903,-7,0,2204,903,19,19,2223,884,2827,354,374,392,0,,0,0.0,0.0,0.0,0.0,0.0
2024,2,9,5,2024-02-09,WN,3299,ATL,IAH,"Atlanta, GA",Georgia,"Houston, TX",Texas,548,751,-4,-10,544,741,23,5,567,736,402,47,67,75,0,,0,0.0,0.0,0.0,0.0,0.0
2024,11,18,1,2024-11-18,DL,9918,DEN,SLC,"Denver, CO",Colorado,"Salt Lake City, UT",Utah,667,950,-7,-5,660,945,11,4,671,941,573,67,87,82,0,,0,0.0,0.0,0.0,0.0,0.0
2024,6,1,6,2024-06-01,WN,9937,MCO,PHL,"Orlando, FL",Florida,"Philadelphia, PA",Pennsylvania,2193,1304,1,0,2194,1304,29,13,2223,1291,2720,339,359,381,0,,0,0.0,0.0,0.0,0.0,0.0
2024,5,6,1,2024-05-06,UA,7041,PDX,IAD,"Portland, OR",Oregon,"Washington, DC",District of Columbia,520,691,-1,5,519,696,15,5,534,691,1747,217,237,237,0,,0,0.0,0.0,0.0,0.0,0.0
2024,8,24,6,2024-08-24,G4,1081,MSP,SLC,"Minneapolis, MN",Minnesota,"Salt Lake City, UT",Utah,891,1784,2,10,893,1794,22,17,915,1777,251,21,41,60,0,,0,0.0,0.0,0.0,0.0,0.0
2024,2,24,6,2024-02-24,NK,3652,LAS,PHX,"Las Vegas, NV",Nevada,"Phoenix, AZ",Arizona,1402,705,10,15,1412,720,12,7,1424,713,2598,330,350,349,0,,0,0.0,0.0,0.0,0.0,0.0
2024,6,20,4,2024-06-20,OH,1021,LAX,PHL,"Los Angeles, CA",California,"Philadelphia, PA",Pennsylvania,1628,1340,6,10,1634,1350,6,13,1640,1337,1966,235,255,254,0,,0,0.0,0.0,0.0,0.0,0.0
2024,4,18,4,2024-04-18,MQ,3758,EWR,LGA,"Newark, NJ",New Jersey,"New York, NY",New York,1813,1726,-7,0,1806,1726,16,5,1822,1721,2215,269,289,290,0,,0,0.0,0.0,0.0,0.0,0.0
2024,12,19,4,2024-12-19,OO,4095,MIA,STL,"Miami, FL",Florida,"St. Louis, MO",Missouri,2156,731,-2,-5,2154,726,26,17,2180,709,1042,133,153,176,0,,0,0.0,0.0,0.0,0.0,0.0
2024,7,2,2,2024-07-02,HA,7164,SFO,LAS,"San Francisco, CA",California,"Las Vegas, NV",Nevada,2227,1368,8,5,2235,1373,12,5,2247,1368,1294,159,179,176,0,,0,0.0,0.0,0.0,0.0,0.0
2024,7,16,2,2024-07-16,YX,5152,SLC,STL,"Salt Lake City, UT",Utah,"St. Louis, MO",Missouri,1949,1912,-4,5,1945,1917,5,9,1950,1908,1824,225,245,239,0,,0,0.0,0.0,0.0,0.0,0.0
2024,3,27,3,2024-03-27,UA,5506,DTW,LGA,"Detroit, MI",Michigan,"New York, NY",New York,728,1057,-6,-10,722,1047,11,9,733,1038,1040,123,143,143,0,,0,0.0,0.0,0.0,0.0,0.0
2024,7,19,5,2024-07-19,MQ,4377,DCA,PDX,"Washington, DC",District of Columbia,"Portland, OR",Oregon,1704,1498,1,0,1705,1498,13,13,1718,1485,245,34,54,60,0,,0,0.0,0.0,0.0,0.0,0.0
2024,12,2,1,2024-12-02,HA,1574,SEA,EWR,"Seattle, WA",Washington,"Newark, NJ",New Jersey,851,1724,-7,-10,844,1714,26,18,870,1696,827,111,131,155,0,,0,0.0,0.0,0.0,0.0,0.0
2024,11,17,7,2024-11-17,OH,7198,PHL,LAS,"Philadelphia, PA",Pennsylvania,"Las Vegas, NV",Nevada,724,1644,9,10,733,1654,26,6,759,1648,1067,129,149,161,0,,0,0.0,0.0,0.0,0.0,0.0
2024,10,1,2,2024-10-01,F9,3867,DCA,LAS,"Washington, DC",District of Columbia,"Las Vegas, NV",Nevada,733,848,-13,-5,720,843,13,13,733,830,548,67,87,93,0,,0,0.0,0.0,0.0,0.0,0.0
2024,7,29,1,2024-07-29,G4,6819,PHL,ATL,"Philadelphia, PA",Pennsylvania,"Atlanta, GA",Georgia,765,791,1,10,766,801,6,16,772,785,465,64,84,86,0,,0,0.0,0.0,0.0,0.0,0.0
2024,4,27,6,2024-04-27,MQ,8694,PHL,HNL,"Philadelphia, PA",Pennsylvania,"Honolulu, HI",Hawaii,1357,1184,-14,-5,1343,1179,8,10,1351,1169,1826,229,249,247,0,,0,0.0,0.0,0.0,0.0,0.0
2024,7,9,2,2024-07-09,NK,9439,LGA,CLT,"New York, NY",New York,"Charlotte, NC",North Carolina,813,1936,5,5,818,1941,18,19,836,1922,2266,292,312,329,0,,0,0.0,0.0,0.0,0.0,0.0
2024,2,11,7,2024-02-11,AS,712,LAX,MIA,"Los Angeles, CA",California,"Miami, FL",Florida,998,767,-9,-10,989,757,18,8,1007,749,2660,322,342,348,0,,0,0.0,0.0,0.0,0.0,0.0
2024,2,11,7,2024-02-11,WN,7386,IAD,SEA,"Washington, DC",District of Columbia,"Seattle, WA",Washington,1376,2197,9,5,1385,2202,12,12,1397,2190,1501,189,209,213,0,,0,0.0,0.0,0.0,0.0,0.0
2024,11,10,7,2024-11-10,B6,9905,HNL,DFW,"Honolulu, HI",Hawaii,"Dallas/Fort Worth, TX",Texas,1741,770,-9,-10,1732,760,25,8,1757,752,2717,348,368,381,0,,0,0.0,0.0,0.0,0.0,0.0
2024,10,2,3,2024-10-02,F9,3117,IAH,DFW,"Houston, TX",Texas,"Dallas/Fort Worth, TX",Texas,710,2256,0,0,710,2256,13,14,723,2242,676,93,113,120,0,,0,0.0,0.0,0.0,0.0,0.0
2024,11,24,7,2024-11-24,UA,4888,ORD,SFO,"Chicago, IL",Illinois,"San Francisco, CA",California,598,1839,-6,-15,592,1824,7,19,599,1805,1758,226,246,252,0,,0,0.0,0.0,0.0,0.0,0.0
2024,1,17,3,2024-01-17,DL,7202,TPA,EWR,"Tampa, FL",Florida,"Newark, NJ",New Jersey,2144,2132,9,0,2153,2132,26,15,2179,2117,2622,324,344,365,0,,0,0.0,0.0,0.0,0.0,0.0
2024,10,9,3,2024-10-09,UA,3301,DTW,PDX,"Detroit, MI",Michigan,"Portland, OR",Oregon,1911,1797,13,10,1924,1807,26,3,1950,1804,929,114,134,143,0,,0,0.0,0.0,0.0,0.0,0.0
2024,9,14,6,2024-09-14,YX,852,ORD,LAS,"Chicago, IL",Illinois,"Las Vegas, NV",Nevada,844,1135,-1,5,843,1140,23,6,866,1134,1142,145,165,174,0,,0,0.0,0.0,0.0,0.0,0.0
2024,3,3,7,2024-03-03,NK,7656,TPA,PDX,"Tampa, FL",Florida,"Portland, OR",Oregon,1776,1007,-7,-15,1769,992,10,18,1779,974,2876,353,373,381,1,,0,0.0,0.0,0.0,0.0,0.0
2024,3,2,6,2024-03-02,F9,1441,DCA,DFW,"Washington, DC",District of Columbia,"Dallas/Fort Worth, TX",Texas,1403,1100,6,0,1409,1100,5,7,1414,1093,1133,134,154,146,0,,0,0.0,0.0,0.0,0.0,0.0
2024,4,9,2,2024-04-09,AA,8796,DFW,STL,"Dallas/Fort Worth, TX",Texas,"St. Louis, MO",Missouri,1023,1761,14,10,1037,1771,25,15,1062,1756,2896,355,375,395,0,,0,0.0,0.0,0.0,0.0,0.0
2024,1,19,5,2024-01-19,MQ,7114,IAD,BOS,"Washington, DC",District of Columbia,"Boston, MA",Massachusetts,617,698,14,5,631,703,22,12,653,691,1913,233,253,267,0,,0,0.0,0.0,0.0,0.0,0.0
2024,1,17,3,2024-01-17,NK,6855,BWI,MCO,"Baltimore, MD",Maryland,"Orlando, FL",Florida,1099,1435,-9,-15,1090,1420,12,7,1102,1413,1924,243,263,262,0,,0,0.0,0.0,0.0,0.0,0.0
2024,11,20,3,2024-11-20,G4,3582,SAN,PHL,"San Diego, CA",California,"Philadelphia, PA",Pennsylvania,1355,1680,-4,-5,1351,1675,11,18,1362,1657,1719,221,241,250,0,,0,0.0,0.0,0.0,0.0,0.0
2024,9,2,1,2024-09-02,YX,7828,SAN,PHX,"San Diego, CA",California,"Phoenix, AZ",Arizona,708,846,-3,0,705,846,11,3,716,843,939,126,146,140,0,,0,0.0,0.0,0.0,0.0,0.0
2024,9,7,6,2024-09-07,MQ,5665,IAD,PHX,"Washington, DC",District of Columbia,"Phoenix, AZ",Arizona,1932,1283,-6,-10,1926,1273,14,14,1940,1259,2599,333,353,361,0,,0,0.0,0.0,0.0,0.0,0.0
2024,3,21,4,2024-03-21,OH,7711,HNL,IAH,"Honolulu, HI",Hawaii,"Houston, TX",Texas,980,1312,-4,5,976,1317,8,17,984,1300,325,42,62,67,0,,0,0.0,0.0,0.0,0.0,0.0
2024,2,8,4,2024-02-08,OH,8030,JFK,TPA,"New York, NY",New York,"Tampa, FL",Florida,1422,706,6,0,1428,706,22,7,1450,699,1449,171,191,200,0,,0,0.0,0.0,0.0,0.0,0.0
2024,2,5,1,2024-02-05,HA,6617,STL,MIA,"St. Louis, MO",Missouri,"Miami, FL",Florida,2165,1671,-11,-10,2154,1661,23,8,2177,1653,2142,268,288,299,0,,0,0.0,0.0,0.0,0.0,0.0
2024,7,15,1,2024-07-15,UA,2522,HNL,LGA,"Honolulu, HI",Hawaii,"New York, NY",New York,828,1444,7,0,835,1444,14,13,849,1431,737,89,109,116,0,,0,0.0,0.0,0.0,0.0,0.0
2024,6,6,4,2024-06-06,HA,8965,BOS,DTW,"Boston, MA",Massachusetts,"Detroit, MI",Michigan,1706,1909,11,10,1717,1919,24,16,1741,1903,317,43,63,83,0,,0,0.0,0.0,0.0,0.0,0.0
2024,7,22,1,2024-07-22,UA,6085,LAX,CLT,"Los Angeles, CA",California,"Charlotte, NC",North Carolina,916,645,-15,-5,901,640,23,4,924,636,2488,309,329,336,0,,0,0.0,0.0,0.0,0.0,0.0
2024,7,14,7,2024-07-14,F9,7047,SLC,IAD,"Salt Lake City, UT",Utah,"Washington, DC",District of Columbia,1606,995,-17,-10,1589,985,7,12,1596,973,202,16,36,35,0,,0,0.0,0.0,0.0,0.0,0.0
2024,8,3,6,2024-08-03,WN,8884,DTW,MIA,"Detroit, MI",Michigan,"Miami, FL",Florida,753,1743,-1,5,752,1748,21,14,773,1734,692,88,108,123,0,,0,0.0,0.0,0.0,0.0,0.0
2024,10,11,5,2024-10-11,OH,7735,SFO,DTW,"San Francisco, CA",California,"Detroit, MI",Michigan,1444,1683,-23,-15,1421,1668,5,11,1426,1657,2441,303,323,319,0,,0,0.0,0.0,0.0,0.0,0.0
2024,7,14,7,2024-07-14,F9,3768,ATL,HNL,"Atlanta, GA",Georgia,"Honolulu, HI",Hawaii,504,1770,0,10,504,1780,28,11,532,1769,2064,253,273,292,0,,0,0.0,0.0,0.0,0.0,0.0
2024,11,2,6,2024-11-02,B6,6562,SFO,PHX,"San Francisco, CA",California,"Phoenix, AZ",Arizona,802,1215,11,15,813,1230,12,12,825,1218,2463,311,331,335,0,,0,0.0,0.0,0.0,0.0,0.0
2024,5,31,5,2024-05-31,OH,3238,MCO,PDX,"Orlando, FL",Florida,"Portland, OR",Oregon,1479,2203,29,20,1508,2223,21,9,1529,2214,1720,208,228,238,0,,0,6.0,0.0,1.0,0.0,13.0
2024,1,14,7,2024-01-14,UA,4609,LAX,JFK,"Los Angeles, CA",California,"New York, NY",New York,2059,1549,-4,-5,2055,1544,8,4,2063,1540,1652,206,226,218,0,,0,0.0,0.0,0.0,0.0,0.0
2024,11,20,3,2024-11-20,HA,2600,HNL,MSP,"Honolulu, HI",Hawaii,"Minneapolis, MN",Minnesota,2156,2120,-5,0,2151,2120,6,3,2157,2117,2190,277,297,286,0,,0,0.0,0.0,0.0,0.0,0.0
2024,5,25,6,2024-05-25,WN,2893,DEN,PHL,"Denver, CO",Colorado,"Philadelphia, PA",Pennsylvania,1106,1273,19,10,1125,1283,21,3,1146,1280,2037,254,274,278,0,,0,0.0,0.0,0.0,0.0,0.0
2024,2,26,1,2024-02-26,OH,4393,HNL,PHL,"Honolulu, HI",Hawaii,"Philadelphia, PA",Pennsylvania,1951,2350,-4,-10,1947,2340,6,4,1953,2336,1544,188,208,198,0,,0,0.0,0.0,0.0,0.0,0.0
2024,7,29,1,2024-07-29,WN,5499,ATL,STL,"Atlanta, GA",Georgia,"St. Louis, MO",Missouri,1463,1741,-20,-20,1443,1721,5,6,1448,1715,2100,267,287,278,0,,0,0.0,0.0,0.0,0.0,0.0
2024,9,24,2,2024-09-24,F9,399,DFW,LGA,"Dallas/Fort Worth, TX",Texas,"New York, NY",New York,1235,836,-8,-5,1227,831,9,18,1236,813,1840,223,243,250,0,,0,0.0,0.0,0.0,0.0,0.0
2024,7,28,7,2024-07-28,AS,2006,STL,ATL,"St. Louis, MO",Missouri,"Atlanta, GA",Georgia,2274,1841,10,10,2284,1851,10,15,2294,1836,2154,278,298,303,0,,0,0.0,0.0,0.0,0.0,0.0
2024,1,17,3,2024-01-17,NK,2585,BWI,JFK,"Baltimore, MD",Maryland,"New York, NY",New York,1750,1747,2,0,1752,1747,16,14,1768,1733,1049,130,150,160,0,,0,0.0,0.0,0.0,0.0,0.0
2024,10,12,6,2024-10-12,G4,7559,MIA,IAH,"Miami, FL",Florida,"Houston, TX",Texas,2177,1228,-2,0,2175,1228,28,7,2203,1221,925,114,134,149,0,,0,0.0,0.0,0.0,0.0,0.0
2024,12,9,1,2024-12-09,HA,8498,MSP,TPA,"Minneapolis, MN",Minnesota,"Tampa, FL",Florida,2086,1886,13,5,2099,1891,14,5,2113,1886,2452,310,330,329,0,,0,0.0,0.0,0.0,0.0,0.0
2024,7,21,7,2024-07-21,AS,6220,MIA,DCA,"Miami, FL",Florida,"Washington, DC",District of Columbia,889,769,9,0,898,769,12,4,910,765,2647,320,340,336,0,,0,0.0,0.0,0.0,0.0,0.0
2024,4,8,1,2024-04-08,UA,8585,PHL,CLT,"Philadelphia, PA",Pennsylvania,"Charlotte, NC",North Carolina,2180,2331,-21,-15,2159,2316,18,7,2177,2309,758,95,115,120,0,,0,0.0,0.0,0.0,0.0,0.0
2024,10,5,6,2024-10-05,HA,1973,HNL,ORD,"Honolulu, HI",Hawaii,"Chicago, IL",Illinois,1349,1420,-1,0,1348,1420,8,3,1356,1417,314,48,68,59,0,,0,0.0,0.0,0.0,0.0,0.0
2024,7,27,6,2024-07-27,MQ,6202,CLT,MCO,"Charlotte, NC",North Carolina,"Orlando, FL",Florida,1318,991,2,0,1320,991,23,16,1343,975,2084,269,289,308,0,,0,0.0,0.0,0.0,0.0,0.0
2024,5,8,3,2024-05-08,UA,6272,SEA,MDW,"Seattle, WA",Washington,"Chicago, IL",Illinois,2087,1773,-6,0,2081,1773,9,17,2090,1756,2225,272,292,298,0,,0,0.0,0.0,0.0,0.0,0.0
2024,11,30,6,2024-11-30,OO,6422,HNL,DEN,"Honolulu, HI",Hawaii,"Denver, CO",Colorado,511,1869,-3,5,508,1874,28,6,536,1868,2212,278,298,312,0,,0,0.0,0.0,0.0,0.0,0.0
2024,10,14,1,2024-10-14,UA,2188,LAX,SEA,"Los Angeles, CA",California,"Seattle, WA",Washington,836,1100,6,0,842,1100,25,14,867,1086,463,65,85,104,0,,0,0.0,0.0,0.0,0.0,0.0
2024,9,8,7,2024-09-08,YX,7737,CLT,MIA,"Charlotte, NC",North Carolina,"Miami, FL",Florida,1106,1814,14,15,1120,1829,11,12,1131,1817,529,60,80,83,0,,0,0.0,0.0,0.0,0.0,0.0
2024,9,21,6,2024-09-21,9E,5411,IAD,SFO,"Washington, DC",District of Columbia,"San Francisco, CA",California,628,773,6,0,634,773,24,11,658,762,2422,303,323,338,0,,0,0.0,0.0,0.0,0.0,0.0
2024,9,27,5,2024-09-27,DL,6587,EWR,LAS,"Newark, NJ",New Jersey,"Las Vegas, NV",Nevada,510,1192,-5,0,505,1192,6,7,511,1185,1435,186,206,199,0,,0,0.0,0.0,0.0,0.0,0.0
2024,7,6,6,2024-07-06,AA,6980,STL,LGA,"St. Louis, MO",Missouri,"New York, NY",New York,989,771,8,5,997,776,29,11,1026,765,1943,249,269,289,0,,0,0.0,0.0,0.0,0.0,0.0
2024,8,1,4,2024-08-01,OO,4821,LGA,PHX,"New York, NY",New York,"Phoenix, AZ",Arizona,771,1557,8,10,779,1567,15,19,794,1548,564,71,91,105,0,,0,0.0,0.0,0.0,0.0,0.0
2024,10,9,3,2024-10-09,9E,3526,LAS,DTW,"Las Vegas, NV",Nevada,"Detroit, MI",Michigan,1880,1275,-6,0,1874,1275,14,17,1888,1258,2642,338,358,369,0,,0,0.0,0.0,0.0,0.0,0.0
2024,7,29,1,2024-07-29,AA,628,HNL,LGA,"Honolulu, HI",Hawaii,"New York, NY",New York,1380,1408,-6,-15,1374,1393,22,16,1396,1377,2816,358,378,396,0,,0,0.0,0.0,0.0,0.0,0.0
2024,12,30,1,2024-12-30,WN,2024,MSP,TPA,"Minneapolis, MN",Minnesota,"Tampa, FL",Florida,1615,1222,-8,-5,1607,1217,6,16,1613,1201,2709,334,354,356,0,,0,0.0,0.0,0.0,0.0,0.0
2024,3,16,6,2024-03-16,UA,6560,STL,HNL,"St. Louis, MO",Missouri,"Honolulu, HI",Hawaii,508,1318,-15,-20,493,1298,18,5,511,1293,2598,322,342,345,0,,0,0.0,0.0,0.0,0.0,0.0
2024,5,27,1,2024-05-27,B6,6076,PHX,BWI,"Phoenix, AZ",Arizona,"Baltimore, MD",Maryland,1386,937,-14,-10,1372,927,28,4,1400,923,2671,328,348,360,0,,0,0.0,0.0,0.0,0.0,0.0
2024,11,16,6,2024-11-16,YX,6121,CLT,SFO,"Charlotte, NC",North Carolina,"San Francisco, CA",California,1646,2034,-9,0,1637,2034,14,8,1651,2026,954,128,148,150,0,,0,0.0,0.0,0.0,0.0,0.0
2024,7,31,3,2024-07-31,G4,9652,TPA,SEA,"Tampa, FL",Florida,"Seattle, WA",Washington,1275,1693,8,10,1283,1703,10,11,1293,1692,2635,326,346,347,0,,0,0.0,0.0,0.0,0.0,0.0
2024,4,18,4,2024-04-18,YX,962,CLT,PDX,"Charlotte, NC",North Carolina,"Portland, OR",Oregon,780,1721,-1,0,779,1721,25,3,804,1718,2937,374,394,402,0,,0,0.0,0.0,0.0,0.0,0.0
2024,5,8,3,2024-05-08,MQ,4420,SAN,MDW,"San Diego, CA",California,"Chicago, IL",Illinois,957,1536,-12,-20,945,1516,7,17,952,1499,1015,133,153,157,0,,0,0.0,0.0,0.0,0.0,0.0
2024,1,10,3,2024-01-10,F9,3594,MIA,DCA,"Miami, FL",Florida,"Washington, DC",District of Columbia,1435,2140,-17,-10,1418,2130,27,3,1445,2127,2638,338,358,368,0,,0,0.0,0.0,0.0,0.0,0.0
2024,2,16,5,2024-02-16,YX,6152,SLC,BOS,"Salt Lake City, UT",Utah,"Boston, MA",Massachusetts,950,1808,2,0,952,1808,20,5,972,1803,583,62,82,87,0,,0,0.0,0.0,0.0,0.0,0.0
2024,11,10,7,2024-11-10,G4,8359,CLT,IAH,"Charlotte, NC",North Carolina,"Houston, TX",Texas,2154,2339,-4,5,2150,2344,12,18,2162,2326,1325,163,183,193,0,,0,0.0,0.0,0.0,0.0,0.0
2024,4,5,5,2024-04-05,MQ,1742,MDW,DEN,"Chicago, IL",Illinois,"Denver, CO",Colorado,1930,2036,18,10,1948,2046,13,17,1961,2029,1672,218,238,248,0,,1,0.0,0.0,0.0,0.0,0.0
2024,4,12,5,2024-04-12,B6,9312,SFO,PHL,"San Francisco, CA",California,"Philadelphia, PA",Pennsylvania,2225,977,15,20,2240,997,15,17,2255,980,1055,138,158,170,0,,0,7.0,0.0,3.0,0.0,10.0
2024,12,7,6,2024-12-07,F9,5296,BOS,IAH,"Boston, MA",Massachusetts,"Houston, TX",Texas,1290,1635,15,10,1305,1645,20,7,1325,1638,2289,283,303,310,0,,0,0.0,0.0,0.0,0.0,0.0
2024,5,25,6,2024-05-25,WN,7099,LAS,IAD,"Las Vegas, NV",Nevada,"Washington, DC",District of Columbia,1311,2032,4,0,1315,2032,6,12,1321,2020,2339,290,310,308,0,,0,0.0,0.0,0.0,0.0,0.0
2024,1,27,6,2024-01-27,B6,7422,EWR,SLC,"Newark, NJ",New Jersey,"Salt Lake City, UT",Utah,555,1017,8,5,563,1022,28,13,591,1009,479,54,74,95,0,,0,0.0,0.0,0.0,0.0,0.0
2024,8,7,3,2024-08-07,HA,3243,MIA,DTW,"Miami, FL",Florida,"Detroit, MI",Michigan,1207,930,-8,-10,1199,920,9,10,1208,910,2068,253,273,272,0,,0,0.0,0.0,0.0,0.0,0.0
2024,1,18,4,2024-01-18,YX,1570,LAS,DTW,"Las Vegas, NV",Nevada,"Detroit, MI",Michigan,878,1582,-9,-15,869,1567,5,17,874,1550,1965,236,256,258,0,,0,0.0,0.0,0.0,0.0,0.0
2024,6,15,6,2024-06-15,UA,5778,MIA,ORD,"Miami, FL",Florida,"Chicago, IL",Illinois,2025,879,-8,-15,2017,864,27,14,2044,850,337,36,56,77,0,,0,0.0,0.0,0.0,0.0,0.0
2024,3,22,5,2024-03-22,B6,1482,SFO,DCA,"San Francisco, CA",California,"Washington, DC",District of Columbia,1509,1738,-1,-10,1508,1728,19,6,1527,1722,2622,323,343,348,0,,0,0.0,0.0,0.0,0.0,0.0
2024,3,12,2,2024-03-12,YX,5496,DTW,JFK,"Detroit, MI",Michigan,"New York, NY",New York,522,1480,-30,-20,492,1460,11,12,503,1448,547,72,92,95,0,,0,0.0,0.0,0.0,0.0,0.0
2024,11,5,2,2024-11-05,UA,9628,MSP,IAD,"Minneapolis, MN",Minnesota,"Washington, DC",District of Columbia,1768,1833,3,10,1771,1843,20,18,1791,1825,2957,366,386,404,0,,0,0.0,0.0,0.0,0.0,0.0
2024,9,10,2,2024-09-10,B6,7214,ATL,SAN,"Atlanta, GA",Georgia,"San Diego, CA",California,1271,1046,5,0,1276,1046,16,17,1292,1029,900,106,126,139,0,,0,0.0,0.0,0.0,0.0,0.0
2024,6,10,1,2024-06-10,OO,9534,MCO,LAX,"Orlando, FL",Florida,"Los Angeles, CA",California,1941,1430,17,10,1958,1440,23,7,1981,1433,2689,345,365,375,0,,0,0.0,0.0,0.0,0.0,0.0
2024,11,22,5,2024-11-22,OH,1805,MCO,LAX,"Orlando, FL",Florida,"Los Angeles, CA",California,730,2017,14,15,744,2032,19,14,763,2018,2810,348,368,381,0,,0,0.0,0.0,0.0,0.0,0.0
2024,2,7,3,2024-02-07,B6,6097,PDX,SEA,"Portland, OR",Oregon,"Seattle, WA",Washington,709,2268,54,45,763,2313,7,13,770,2300,792,95,115,115,0,,0,5.0,6.0,4.0,0.0,30.0
2024,7,19,5,2024-07-19,AS,6163,TPA,LAS,"Tampa, FL",Florida,"Las Vegas, NV",Nevada,1685,1334,12,15,1697,1349,24,13,1721,1336,680,76,96,113,0,,0,0.0,0.0,0.0,0.0,0.0
2024,7,18,4,2024-07-18,G4,8062,CLT,LAX,"Charlotte, NC",North Carolina,"Los Angeles, CA",California,1900,1804,0,5,1900,1809,25,15,1925,1794,1046,125,145,165,0,,0,0.0,0.0,0.0,0.0,0.0
2024,9,11,3,2024-09-11,AA,8196,LGA,TPA,"New York, NY",New York,"Tampa, FL",Florida,1365,2088,1,-5,1366,2083,25,11,1391,2072,1397,175,195,211,0,,0,0.0,0.0,0.0,0.0,0.0
2024,6,27,4,2024-06-27,YX,2694,BOS,STL,"Boston, MA",Massachusetts,"St. Louis, MO",Missouri,1693,1651,-6,0,1687,1651,9,18,1696,1633,2762,354,374,381,0,,0,0.0,0.0,0.0,0.0,0.0
2024,2,4,7,2024-02-04,9E,9971,MSP,STL,"Minneapolis, MN",Minnesota,"St. Louis, MO",Missouri,1398,792,3,10,1401,802,19,18,1420,784,1806,224,244,261,0,,0,0.0,0.0,0.0,0.0,0.0
2024,3,22,5,2024-03-22,OH,1415,MIA,DEN,"Miami, FL",Florida,"Denver, CO",Colorado,1862,1412,3,10,1865,1422,26,3,1891,1419,1771,224,244,253,0,,0,0.0,0.0,0.0,0.0,0.0
2024,8,7,3,2024-08-07,AS,8239,TPA,DTW,"Tampa, FL",Florida,"Detroit, MI",Michigan,1997,1561,28,20,2025,1581,21,6,2046,1575,2939,365,385,392,0,,0,1.0,2.0,2.0,0.0,15.0
2024,6,6,4,2024-06-06,AA,8859,IAD,PHX,"Washington, DC",District of Columbia,"Phoenix, AZ",Arizona,1750,1879,3,5,1753,1884,20,7,1773,1877,1267,164,184,191,0,,0,0.0,0.0,0.0,0.0,0.0
2024,1,4,4,2024-01-04,AS,2804,MDW,SFO,"Chicago, IL",Illinois,"San Francisco, CA",California,1372,2246,2,0,1374,2246,20,5,1394,2241,2845,351,371,376,0,,0,0.0,0.0,0.0,0.0,0.0
2024,6,15,6,2024-06-15,DL,5825,DTW,MCO,"Detroit, MI",Michigan,"Orlando, FL",Florida,862,1023,16,20,878,1043,27,15,905,1028,678,93,113,135,0,,0,3.0,1.0,3.0,0.0,13.0
2024,7,22,1,2024-07-22,F9,4791,PDX,DEN,"Portland, OR",Oregon,"Denver, CO",Colorado,2002,1305,27,20,2029,1325,16,15,2045,1310,2517,305,325,336,0,,0,1.0,5.0,0.0,0.0,14.0
2024,7,12,5,2024-07-12,OO,8939,HNL,SAN,"Honolulu, HI",Hawaii,"San Diego, CA",California,2078,2259,7,0,2085,2259,8,15,2093,2244,1929,240,260,263,0,,0,0.0,0.0,0.0,0.0,0.0
2024,8,22,4,2024-08-22,UA,224,LGA,MIA,"New York, NY",New York,"Miami, FL",Florida,974,690,6,0,980,690,9,7,989,683,1912,231,251,247,0,,0,0.0,0.0,0.0,0.0,0.0
2024,7,24,3,2024-07-24,9E,9829,EWR,PHL,"Newark, NJ",New Jersey,"Philadelphia, PA",Pennsylvania,694,1247,7,10,701,1257,28,19,729,1238,1818,234,254,281,0,,0,0.0,0.0,0.0,0.0,0.0
2024,5,29,3,2024-05-29,OH,5197,PHX,SLC,"Phoenix, AZ",Arizona,"Salt Lake City, UT",Utah,1432,1394,-5,-5,1427,1389,12,14,1439,1375,1378,166,186,192,0,,0,0.0,0.0,0.0,0.0,0.0
2024,6,7,5,2024-06-07,AS,4907,BOS,DTW,"Boston, MA",Massachusetts,"Detroit, MI",Michigan,1535,1340,5,10,1540,1350,16,19,1556,1331,653,74,94,109,0,,0,0.0,0.0,0.0,0.0,0.0
2024,10,5,6,2024-10-05,AS,2070,MSP,DTW,"Minneapolis, MN",Minnesota,"Detroit, MI",Michigan,2018,744,-18,-15,2000,729,9,3,2009,726,201,27,47,39,0,,0,0.0,0.0,0.0,0.0,0.0
2024,10,30,3,2024-10-30,HA,2862,DEN,DTW,"Denver, CO",Colorado,"Detroit, MI",Michigan,1283,1051,-3,0,1280,1051,15,4,1295,1047,702,79,99,98,0,,0,0.0,0.0,0.0,0.0,0.0
2024,6,14,5,2024-06-14,WN,5617,IAH,PHX,"Houston, TX",Texas,"Phoenix, AZ",Arizona,1585,2051,8,0,1593,2051,23,15,1616,2036,2294,281,301,319,0,,0,0.0,0.0,0.0,0.0,0.0
2024,11,6,3,2024-11-06,B6,914,MDW,BOS,"Chicago, IL",Illinois,"Boston, MA",Massachusetts,1028,841,9,5,1037,846,14,12,1051,834,1411,172,192,198,0,,0,0.0,0.0,0.0,0.0,0.0
2024,3,8,5,2024-03-08,DL,3201,LAS,DFW,"Las Vegas, NV",Nevada,"Dallas/Fort Worth, TX",Texas,770,2109,-7,-15,763,2094,28,5,791,2089,849,102,122,135,0,,0,0.0,0.0,0.0,0.0,0.0
2024,3,28,4,2024-03-28,9E,1754,TPA,MCO,"Tampa, FL",Florida,"Orlando, FL",Florida,1037,1654,-20,-15,1017,1639,22,17,1039,1622,1412,167,187,206,0,,0,0.0,0.0,0.0,0.0,0.0
2024,8,4,7,2024-08-04,HA,231,DTW,ATL,"Detroit, MI",Michigan,"Atlanta, GA",Georgia,2080,1372,8,15,2088,1387,16,3,2104,1384,1519,187,207,206,0,,0,0.0,0.0,0.0,0.0,0.0
2024,1,1,1,2024-01-01,9E,8522,MSP,MIA,"Minneapolis, MN",Minnesota,"Miami, FL",Florida,1156,1683,-9,-5,1147,1678,13,14,1160,1664,1228,145,165,172,0,,0,0.0,0.0,0.0,0.0,0.0
2024,5,14,2,2024-05-14,F9,494,HNL,SLC,"Honolulu, HI",Hawaii,"Salt Lake City, UT",Utah,564,2224,-14,-5,550,2219,26,6,576,2213,422,57,77,89,0,,0,0.0,0.0,0.0,0.0,0.0
2024,7,3,3,2024-07-03,9E,7419,ORD,LAS,"Chicago, IL",Illinois,"Las Vegas, NV",Nevada,1361,1075,-4,5,1357,1080,14,4,1371,1076,909,117,137,135,0,,0,0.0,0.0,0.0,0.0,0.0
2024,12,16,1,2024-12-16,NK,3673,DTW,MDW,"Detroit, MI",Michigan,"Chicago, IL",Illinois,2003,700,-2,-5,2001,695,24,15,2025,680,1555,200,220,239,0,,0,0.0,0.0,0.0,0.0,0.0
2024,5,19,7,2024-05-19,9E,9273,MDW,LAX,"Chicago, IL",Illinois,"Los Angeles, CA",California,989,1409,8,10,997,1419,24,10,1021,1409,650,73,93,107,0,,0,0.0,0.0,0.0,0.0,0.0
2024,4,15,1,2024-04-15,AS,7206,DEN,SAN,"Denver, CO",Colorado,"San Diego, CA",California,1591,1390,-9,-5,1582,1385,23,13,1605,1372,2489,317,337,353,0,,0,0.0,0.0,0.0,0.0,0.0
2024,5,12,7,2024-05-12,NK,9224,SAN,MDW,"San Diego, CA",California,"Chicago, IL",Illinois,861,1232,-1,5,860,1237,25,10,885,1227,1374,166,186,201,0,,0,0.0,0.0,0.0,0.0,0.0
2024,4,17,3,2024-04-17,YX,5725,SFO,STL,"San Francisco, CA",California,"St. Louis, MO",Missouri,2131,1476,1,0,2132,1476,10,14,2142,1462,1302,166,186,190,0,,1,0.0,0.0,0.0,0.0,0.0
2024,6,26,3,2024-06-26,AA,9701,IAH,LGA,"Houston, TX",Texas,"New York, NY",New York,1071,1188,22,15,1093,1203,14,19,1107,1184,1976,248,268,281,0,,0,0.0,0.0,0.0,0.0,0.0
2024,10,24,4,2024-10-24,OH,4728,LAX,SLC,"Los Angeles, CA",California,"Salt Lake City, UT",Utah,1494,872,3,-5,1497,867,23,10,1520,857,1711,203,223,236,0,,0,0.0,0.0,0.0,0.0,0.0
2024,12,23,1,2024-12-23,OH,5160,LAX,EWR,"Los Angeles, CA",California,"Newark, NJ",New Jersey,1268,1481,0,-5,1268,1476,13,5,1281,1471,1812,225,245,243,0,,0,0.0,0.0,0.0,0.0,0.0
2024,12,24,2,2024-12-24,B6,7847,LAX,IAH,"Los Angeles, CA",California,"Houston, TX",Texas,1542,2101,21,20,1563,2121,20,9,1583,2112,621,72,92,101,0,,0,4.0,1.0,0.0,0.0,15.0
2024,5,25,6,2024-05-25,NK,6369,TPA,ORD,"Tampa, FL",Florida,"Chicago, IL",Illinois,1044,657,0,5,1044,662,12,15,1056,647,853,105,125,132,0,,0,0.0,0.0,0.0,0.0,0.0
2024,3,14,4,2024-03-14,AA,6732,LAX,IAH,"Los Angeles, CA",California,"Houston, TX",Texas,1478,1358,-5,5,1473,1363,16,12,1489,1351,1114,129,149,157,0,,0,0.0,0.0,0.0,0.0,0.0
2024,4,17,3,2024-04-17,DL,6855,DFW,CLT,"Dallas/Fort Worth, TX",Texas,"Charlotte, NC",North Carolina,1431,1582,-9,-10,1422,1572,26,8,1448,1564,2384,300,320,334,0,,0,0.0,0.0,0.0,0.0,0.0
2024,5,1,3,2024-05-01,G4,6689,PHX,MDW,"Phoenix, AZ",Arizona,"Chicago, IL",Illinois,590,1544,0,0,590,1544,9,6,599,1538,1000,116,136,131,0,,0,0.0,0.0,0.0,0.0,0.0
2024,1,17,3,2024-01-17,YX,5689,HNL,SAN,"Honolulu, HI",Hawaii,"San Diego, CA",California,1472,2128,-5,-5,1467,2123,15,15,1482,2108,2164,277,297,307,0,,0,0.0,0.0,0.0,0.0,0.0
2024,7,14,7,2024-07-14,UA,2604,ATL,SAN,"Atlanta, GA",Georgia,"San Diego, CA",California,737,986,-12,-10,725,976,23,17,748,959,2542,324,344,364,0,,0,0.0,0.0,0.0,0.0,0.0
2024,11,22,5,2024-11-22,AS,3133,IAH,PHL,"Houston, TX",Texas,"Philadelphia, PA",Pennsylvania,961,2084,-9,0,952,2084,7,19,959,2065,2024,259,279,285,0,,0,0.0,0.0,0.0,0.0,0.0
2024,11,13,3,2024-11-13,HA,9003,EWR,IAH,"Newark, NJ",New Jersey,"Houston, TX",Texas,1547,2231,27,30,1574,2261,28,15,1602,2246,537,58,78,101,0,,0,11.0,6.0,4.0,0.0,9.0
2024,10,23,3,2024-10-23,NK,3076,BWI,MCO,"Baltimore, MD",Maryland,"Orlando, FL",Florida,1750,644,-20,-10,1730,634,26,17,1756,617,1248,153,173,196,0,,0,0.0,0.0,0.0,0.0,0.0
2024,9,8,7,2024-09-08,G4,1571,PHX,MIA,"Phoenix, AZ",Arizona,"Miami, FL",Florida,1350,890,-20,-10,1330,880,19,8,1349,872,2474,304,324,331,0,,0,0.0,0.0,0.0,0.0,0.0
2024,4,28,7,2024-04-28,B6,6695,JFK,SEA,"New York, NY",New York,"Seattle, WA",Washington,1904,1881,-9,-10,1895,1871,26,14,1921,1857,2493,315,335,355,0,,0,0.0,0.0,0.0,0.0,0.0
2024,6,10,1,2024-06-10,WN,1242,JFK,ORD,"New York, NY",New York,"Chicago, IL",Illinois,1420,1414,-2,5,1418,1419,24,9,1442,1410,558,71,91,104,0,,0,0.0,0.0,0.0,0.0,0.0
2024,7,16,2,2024-07-16,OO,2668,MSP,CLT,"Minneapolis, MN",Minnesota,"Charlotte, NC",North Carolina,1406,1869,-10,0,1396,1869,7,11,1403,1858,1433,188,208,206,0,,0,0.0,0.0,0.0,0.0,0.0
2024,2,14,3,2024-02-14,YX,1708,IAH,DFW,"Houston, TX",Texas,"Dallas/Fort Worth, TX",Texas,1276,839,-4,-5,1272,834,26,13,1298,821,2664,342,362,381,0,,0,0.0,0.0,0.0,0.0,0.0
2024,11,9,6,2024-11-09,HA,5652,HNL,ATL,"Honolulu, HI",Hawaii,"Atlanta, GA",Georgia,1529,2036,13,10,1542,2046,5,18,1547,2028,2111,260,280,283,0,,0,0.0,0.0,0.0,0.0,0.0
2024,6,27,4,2024-06-27,DL,1997,DTW,JFK,"Detroit, MI",Michigan,"New York, NY",New York,1069,1751,-20,-10,1049,1741,15,9,1064,1732,1124,145,165,169,0,,0,0.0,0.0,0.0,0.0,0.0
2024,2,13,2,2024-02-13,UA,2292,IAH,TPA,"Houston, TX",Texas,"Tampa, FL",Florida,1111,2337,-4,-5,1107,2332,17,16,1124,2316,944,123,143,156,0,,0,0.0,0.0,0.0,0.0,0.0
2024,9,27,5,2024-09-27,HA,1191,BOS,DCA,"Boston, MA",Massachusetts,"Washington, DC",District of Columbia,1133,875,-21,-15,1112,860,9,3,1121,857,591,66,86,78,0,,0,0.0,0.0,0.0,0.0,0.0
2024,3,18,1,2024-03-18,B6,799,SAN,ATL,"San Diego, CA",California,"Atlanta, GA",Georgia,1880,1017,-24,-15,1856,1002,11,19,1867,983,1675,200,220,230,0,,0,0.0,0.0,0.0,0.0,0.0
2024,11,21,4,2024-11-21,OO,4192,CLT,LAX,"Charlotte, NC",North Carolina,"Los Angeles, CA",California,1680,806,-22,-15,1658,791,5,8,1663,783,2447,297,317,310,0,,0,0.0,0.0,0.0,0.0,0.0
2024,6,26,3,2024-06-26,HA,2278,ATL,BOS,"Atlanta, GA",Georgia,"Boston, MA",Massachusetts,1724,2175,-5,-5,1719,2170,17,4,1736,2166,502,54,74,75,0,,0,0.0,0.0,0.0,0.0,0.0
2024,12,22,7,2024-12-22,MQ,832,MCO,PHX,"Orlando, FL",Florida,"Phoenix, AZ",Arizona,1748,964,7,0,1755,964,14,11,1769,953,2880,355,375,380,0,,0,0.0,0.0,0.0,0.0,0.0
2024,1,3,3,2024-01-03,DL,8804,DTW,MCO,"Detroit, MI",Michigan,"Orlando, FL",Florida,1482,1432,-12,-20,1470,1412,24,18,1494,1394,415,57,77,99,0,,0,0.0,0.0,0.0,0.0,0.0
2024,8,1,4,2024-08-01,MQ,2787,BWI,DCA,"Baltimore, MD",Maryland,"Washington, DC",District of Columbia,962,1969,-3,-10,959,1959,22,13,981,1946,2096,252,272,287,0,,0,0.0,0.0,0.0,0.0,0.0
2024,12,7,6,2024-12-07,WN,3856,MDW,SFO,"Chicago, IL",Illinois,"San Francisco, CA",California,1162,1167,-1,-10,1161,1157,17,8,1178,1149,2951,369,389,394,0,,0,0.0,0.0,0.0,0.0,0.0
2024,3,14,4,2024-03-14,AA,6161,ATL,LAX,"Atlanta, GA",Georgia,"Los Angeles, CA",California,1780,759,-6,-10,1774,749,5,15,1779,734,1467,191,211,211,0,,0,0.0,0.0,0.0,0.0,0.0
2024,2,20,2,2024-02-20,WN,8723,MCO,ATL,"Orlando, FL",Florida,"Atlanta, GA",Georgia,1489,695,-6,-10,1483,685,21,14,1504,671,2226,270,290,305,0,,0,0.0,0.0,0.0,0.0,0.0
2024,3,7,4,2024-03-07,NK,6634,SFO,PHX,"San Francisco, CA",California,"Phoenix, AZ",Arizona,2116,1024,-12,-10,2104,1014,16,17,2120,997,1703,219,239,252,0,,0,0.0,0.0,0.0,0.0,0.0
2024,11,27,3,2024-11-27,HA,5485,IAD,LAS,"Washington, DC",District of Columbia,"Las Vegas, NV",Nevada,930,1739,27,30,957,1769,27,8,984,1761,382,56,76,91,0,,0,10.0,6.0,2.0,0.0,12.0
2024,4,2,2,2024-04-02,OH,4594,LAX,SLC,"Los Angeles, CA",California,"Salt Lake City, UT",Utah,1377,1835,-1,0,1376,1835,10,18,1386,1817,533,60,80,88,0,,0,0.0,0.0,0.0,0.0,0.0
2024,6,24,1,2024-06-24,YX,9099,PHX,LAS,"Phoenix, AZ",Arizona,"Las Vegas, NV",Nevada,924,1198,2,5,926,1203,11,11,937,1192,2403,300,320,322,0,,0,0.0,0.0,0.0,0.0,0.0
2024,5,24,5,2024-05-24,UA,1379,LAX,TPA,"Los Angeles, CA",California,"Tampa, FL",Florida,1930,1930,10,10,1940,1940,5,12,1945,1928,2802,358,378,375,0,,0,0.0,0.0,0.0,0.0,0.0
2024,1,7,7,2024-01-07,9E,6638,DEN,MDW,"Denver, CO",Colorado,"Chicago, IL",Illinois,2135,867,13,5,2148,872,14,8,2162,864,1620,198,218,220,0,,0,0.0,0.0,0.0,0.0,0.0
2024,9,25,3,2024-09-25,F9,2321,PDX,ATL,"Portland, OR",Oregon,"Atlanta, GA",Georgia,604,643,6,5,610,648,7,15,617,633,373,45,65,67,0,,0,0.0,0.0,0.0,0.0,0.0
2024,11,17,7,2024-11-17,AS,5264,MSP,IAH,"Minneapolis, MN",Minnesota,"Houston, TX",Texas,751,1194,-4,0,747,1194,11,7,758,1187,1304,162,182,180,0,,0,0.0,0.0,0.0,0.0,0.0
2024,1,4,4,2024-01-04,AS,954,MSP,SEA,"Minneapolis, MN",Minnesota,"Seattle, WA",Washington,1144,1611,-10,0,1134,1611,14,17,1148,1594,229,22,42,53,0,,0,0.0,0.0,0.0,0.0,0.0
2024,5,17,5,2024-05-17,OH,3312,CLT,HNL,"Charlotte, NC",North Carolina,"Honolulu, HI",Hawaii,1622,2081,7,15,1629,2096,14,14,1643,2082,631,71,91,99,0,,0,0.0,0.0,0.0,0.0,0.0
2024,8,18,7,2024-08-18,HA,2686,SFO,MIA,"San Francisco, CA",California,"Miami, FL",Florida,677,2346,-8,-10,669,2336,13,11,682,2325,1191,155,175,179,0,,0,0.0,0.0,0.0,0.0,0.0
2024,3,28,4,2024-03-28,AA,4940,EWR,ORD,"Newark, NJ",New Jersey,"Chicago, IL",Illinois,1788,2095,-17,-10,1771,2085,10,7,1781,2078,1011,118,138,135,1,,0,0.0,0.0,0.0,0.0,0.0
2024,1,17,3,2024-01-17,B6,2868,PDX,ORD,"Portland, OR",Oregon,"Chicago, IL",Illinois,1655,608,-16,-15,1639,593,28,14,1667,579,835,110,130,152,0,,0,0.0,0.0,0.0,0.0,0.0
2024,2,21,3,2024-02-21,UA,7328,DEN,MDW,"Denver, CO",Colorado,"Chicago, IL",Illinois,1722,1268,5,10,1727,1278,13,17,1740,1261,1818,235,255,265,0,,0,0.0,0.0,0.0,0.0,0.0
2024,5,13,1,2024-05-13,HA,3440,SFO,ORD,"San Francisco, CA",California,"Chicago, IL",Illinois,2228,1812,-12,-5,2216,1807,27,14,2243,1793,2418,303,323,344,0,,0,0.0,0.0,0.0,0.0,0.0
2024,7,29,1,2024-07-29,9E,5359,SAN,IAH,"San Diego, CA",California,"Houston, TX",Texas,1219,980,12,15,1231,995,13,14,1244,981,835,97,117,124,0,,0,0.0,0.0,0.0,0.0,0.0
2024,11,20,3,2024-11-20,HA,6840,IAD,PHL,"Washington, DC",District of Columbia,"Philadelphia, PA",Pennsylvania,1580,2266,-2,-5,1578,2261,14,17,1592,2244,2376,305,325,336,0,,0,0.0,0.0,0.0,0.0,0.0
2024,8,6,2,2024-08-06,AA,9911,IAD,SAN,"Washington, DC",District of Columbia,"San Diego, CA",California,1391,1326,2,-5,1393,1321,8,12,1401,1309,308,34,54,54,0,,0,0.0,0.0,0.0,0.0,0.0
2024,7,23,2,2024-07-23,F9,375,MCO,SAN,"Orlando, FL",Florida,"San Diego, CA",California,908,714,-8,-5,900,709,29,5,929,704,467,56,76,90,1,,0,0.0,0.0,0.0,0.0,0.0
2024,7,29,1,2024-07-29,NK,7298,DFW,MDW,"Dallas/Fort Worth, TX",Texas,"Chicago, IL",Illinois,1453,2125,-6,0,1447,2125,20,14,1467,2111,2366,297,317,331,0,,0,0.0,0.0,0.0,0.0,0.0
2024,10,3,4,2024-10-03,NK,3963,CLT,SAN,"Charlotte, NC",North Carolina,"San Diego, CA",California,761,2258,8,5,769,2263,29,14,798,2249,2483,309,329,352,0,,0,0.0,0.0,0.0,0.0,0.0
2024,1,24,3,2024-01-24,YX,814,BOS,LAS,"Boston, MA",Massachusetts,"Las Vegas, NV",Nevada,1241,987,-1,-5,1240,982,6,10,1246,972,227,28,48,44,0,,0,0.0,0.0,0.0,0.0,0.0
2024,1,4,4,2024-01-04,9E,6154,IAD,MSP,"Washington, DC",District of Columbia,"Minneapolis, MN",Minnesota,1153,1038,9,0,1162,1038,15,13,1177,1025,308,30,50,58,0,,0,0.0,0.0,0.0,0.0,0.0
2024,5,31,5,2024-05-31,OH,909,LGA,MDW,"New York, NY",New York,"Chicago, IL",Illinois,1074,1509,-4,-10,1070,1499,13,9,1083,1490,515,55,75,77,0,,0,0.0,0.0,0.0,0.0,0.0
2024,9,15,7,2024-09-15,9E,3826,ORD,DCA,"Chicago, IL",Illinois,"Washington, DC",District of Columbia,617,1444,-7,0,610,1444,7,17,617,1427,404,52,72,76,0,,0,0.0,0.0,0.0,0.0,0.0
2024,11,19,2,2024-11-19,9E,4078,ORD,CLT,"Chicago, IL",Illinois,"Charlotte, NC",North Carolina,2008,1942,9,0,2017,1942,11,16,2028,1926,2747,347,367,374,0,,0,0.0,0.0,0.0,0.0,0.0
2024,12,22,7,2024-12-22,WN,9153,MCO,DTW,"Orlando, FL",Florida,"Detroit, MI",Michigan,1470,1534,12,10,1482,1544,17,12,1499,1532,1788,223,243,252,0,,0,0.0,0.0,0.0,0.0,0.0
2024,6,16,7,2024-06-16,MQ,136,DEN,ORD,"Denver, CO",Colorado,"Chicago, IL",Illinois,1844,1475,14,10,1858,1485,17,18,1875,1467,2770,355,375,390,0,,0,0.0,0.0,0.0,0.0,0.0
2024,6,24,1,2024-06-24,HA,8214,LAX,DFW,"Los Angeles, CA",California,"Dallas/Fort Worth, TX",Texas,807,2327,-2,0,805,2327,23,17,828,2310,2131,274,294,314,0,,0,0.0,0.0,0.0,0.0,0.0
2024,11,5,2,2024-11-05,OO,8746,ORD,DFW,"Chicago, IL",Illinois,"Dallas/Fort Worth, TX",Texas,989,2067,-14,-20,975,2047,15,19,990,2028,414,56,76,90,0,,0,0.0,0.0,0.0,0.0,0.0
2024,10,17,4,2024-10-17,AS,3408,MDW,SLC,"Chicago, IL",Illinois,"Salt Lake City, UT",Utah,1844,2283,2,10,1846,2293,9,19,1855,2274,1853,236,256,264,0,,0,0.0,0.0,0.0,0.0,0.0
2024,2,25,7,2024-02-25,MQ,2755,LAS,BWI,"Las Vegas, NV",Nevada,"Baltimore, MD",Maryland,1256,627,-22,-20,1234,607,20,14,1254,593,804,95,115,129,0,,0,0.0,0.0,0.0,0.0,0.0
2024,4,17,3,2024-04-17,G4,1081,LGA,PDX,"New York, NY",New York,"Portland, OR",Oregon,1879,1235,0,0,1879,1235,6,3,1885,1232,1286,163,183,172,0,,0,0.0,0.0,0.0,0.0,0.0
2024,10,22,2,2024-10-22,HA,6547,PHX,JFK,"Phoenix, AZ",Arizona,"New York, NY",New York,1147,2021,-11,-20,1136,2001,14,16,1150,1985,2261,278,298,308,0,,0,0.0,0.0,0.0,0.0,0.0
2024,11,19,2,2024-11-19,OH,251,DCA,BWI,"Washington, DC",District of Columbia,"Baltimore, MD",Maryland,1107,676,-11,-5,1096,671,14,19,1110,652,1191,138,158,171,0,,0,0.0,0.0,0.0,0.0,0.0
2024,10,28,1,2024-10-28,UA,8891,MSP,SLC,"Minneapolis, MN",Minnesota,"Salt Lake City, UT",Utah,1236,1186,7,0,1243,1186,23,7,1266,1179,2698,327,347,357,0,,0,0.0,0.0,0.0,0.0,0.0
2024,11,29,5,2024-11-29,HA,9614,SFO,SEA,"San Francisco, CA",California,"Seattle, WA",Washington,2043,1981,-4,-5,2039,1976,24,6,2063,1970,1095,141,161,171,0,,0,0.0,0.0,0.0,0.0,0.0
2024,5,20,1,2024-05-20,G4,5748,SEA,MIA,"Seattle, WA",Washington,"Miami, FL",Florida,2049,1809,23,15,2072,1824,10,4,2082,1820,2766,346,366,360,0,,0,0.0,0.0,0.0,0.0,0.0
2024,6,3,1,2024-06-03,WN,1611,PHX,PHL,"Phoenix, AZ",Arizona,"Philadelphia, PA",Pennsylvania,523,2174,-6,0,517,2174,26,7,543,2167,2637,319,339,352,0,,0,0.0,0.0,0.0,0.0,0.0
2024,9,18,3,2024-09-18,B6,2358,SAN,SLC,"San Diego, CA",California,"Salt Lake City, UT",Utah,1715,833,1,0,1716,833,20,5,1736,828,618,67,87,92,0,,0,0.0,0.0,0.0,0.0,0.0
2024,9,29,7,2024-09-29,NK,331,TPA,LGA,"Tampa, FL",Florida,"New York, NY",New York,1252,1871,-10,-5,1242,1866,17,15,1259,1851,2659,340,360,372,0,,0,0.0,0.0,0.0,0.0,0.0
2024,8,19,1,2024-08-19,AS,2842,SAN,TPA,"San Diego, CA",California,"Tampa, FL",Florida,1500,2022,-14,-20,1486,2002,23,15,1509,1987,990,118,138,156,0,,0,0.0,0.0,0.0,0.0,0.0
2024,8,28,3,2024-08-28,9E,7941,SLC,PHX,"Salt Lake City, UT",Utah,"Phoenix, AZ",Arizona,848,928,8,5,856,933,7,14,863,919,1105,140,160,161,1,,1,0.0,0.0,0.0,0.0,0.0
2024,12,20,5,2024-12-20,F9,4562,EWR,CLT,"Newark, NJ",New Jersey,"Charlotte, NC",North Carolina,524,2266,-3,5,521,2271,13,6,534,2265,982,131,151,150,0,,0,0.0,0.0,0.0,0.0,0.0
2024,12,2,1,2024-12-02,F9,7849,BOS,SFO,"Boston, MA",Massachusetts,"San Francisco, CA",California,1913,1628,-10,0,1903,1628,14,9,1917,1619,978,127,147,150,0,,0,0.0,0.0,0.0,0.0,0.0
2024,9,14,6,2024-09-14,F9,671,IAD,ATL,"Washington, DC",District of Columbia,"Atlanta, GA",Georgia,2164,947,-3,-5,2161,942,20,8,2181,934,2046,245,265,273,0,,0,0.0,0.0,0.0,0.0,0.0
2024,9,5,4,2024-09-05,UA,1302,SFO,MSP,"San Francisco, CA",California,"Minneapolis, MN",Minnesota,1514,2022,7,0,1521,2022,22,10,1543,2012,2340,292,312,324,0,,0,0.0,0.0,0.0,0.0,0.0
2024,3,17,7,2024-03-17,HA,9799,IAH,PHX,"Houston, TX",Texas,"Phoenix, AZ",Arizona,1098,1882,4,5,1102,1887,8,7,1110,1880,2137,258,278,273,0,,0,0.0,0.0,0.0,0.0,0.0
2024,6,28,5,2024-06-28,OH,9904,PHL,EWR,"Philadelphia, PA",Pennsylvania,"Newark, NJ",New Jersey,2268,1356,13,5,2281,1361,25,8,2306,1353,1249,150,170,183,0,,0,0.0,0.0,0.0,0.0,0.0
2024,3,6,3,2024-03-06,9E,9862,HNL,IAD,"Honolulu, HI",Hawaii,"Washington, DC",District of Columbia,1300,1018,13,5,1313,1023,28,7,1341,1016,928,110,130,145,0,,0,0.0,0.0,0.0,0.0,0.0
2024,11,3,7,2024-11-03,AS,9331,BWI,TPA,"Baltimore, MD",Maryland,"Tampa, FL",Florida,1409,990,21,15,1430,1005,28,11,1458,994,1135,136,156,175,0,,0,0.0,0.0,0.0,0.0,0.0
2024,12,13,5,2024-12-13,NK,6709,MIA,BOS,"Miami, FL",Florida,"Boston, MA",Massachusetts,1458,1189,-4,0,1454,1189,26,10,1480,1179,2674,335,355,371,0,,0,0.0,0.0,0.0,0.0,0.0
2024,6,19,3,2024-06-19,G4,9717,PHL,EWR,"Philadelphia, PA",Pennsylvania,"Newark, NJ",New Jersey,2091,714,-23,-20,2068,694,20,3,2088,691,2522,305,325,328,0,,0,0.0,0.0,0.0,0.0,0.0
2024,1,22,1,2024-01-22,9E,270,MCO,MDW,"Orlando, FL",Florida,"Chicago, IL",Illinois,1713,603,5,0,1718,603,22,16,1740,587,2642,324,344,362,0,,0,0.0,0.0,0.0,0.0,0.0
2024,4,16,2,2024-04-16,9E,5251,SEA,DTW,"Seattle, WA",Washington,"Detroit, MI",Michigan,1551,1242,5,0,1556,1242,14,11,1570,1231,547,58,78,83,0,,0,0.0,0.0,0.0,0.0,0.0
2024,11,18,1,2024-11-18,OH,6506,SAN,ATL,"San Diego, CA",California,"Atlanta, GA",Georgia,1040,1751,-10,-15,1030,1736,5,9,1035,1727,1095,143,163,157,0,,0,0.0,0.0,0.0,0.0,0.0
2024,8,14,3,2024-08-14,YX,288,PHX,BOS,"Phoenix, AZ",Arizona,"Boston, MA",Massachusetts,990,608,4,-5,994,603,27,12,1021,591,570,66,86,105,0,,0,0.0,0.0,0.0,0.0,0.0
2024,8,3,6,2024-08-03,HA,4778,LGA,EWR,"New York, NY",New York,"Newark, NJ",New Jersey,987,1947,3,5,990,1952,14,19,1004,1933,1404,171,191,204,0,,0,0.0,0.0,0.0,0.0,0.0
2024,3,9,6,2024-03-09,WN,7245,DFW,IAD,"Dallas/Fort Worth, TX",Texas,"Washington, DC",District of Columbia,1290,717,7,5,1297,722,21,13,1318,709,597,65,85,99,0,,0,0.0,0.0,0.0,0.0,0.0
2024,3,24,7,2024-03-24,B6,6027,HNL,CLT,"Honolulu, HI",Hawaii,"Charlotte, NC",North Carolina,671,2090,3,10,674,2100,23,19,697,2081,1812,216,236,258,0,,0,0.0,0.0,0.0,0.0,0.0
2024,4,12,5,2024-04-12,F9,699,ATL,MIA,"Atlanta, GA",Georgia,"Miami, FL",Florida,537,1455,9,10,546,1465,20,16,566,1449,2682,330,350,366,0,,0,0.0,0.0,0.0,0.0,0.0
2024,2,8,4,2024-02-08,AA,5401,BOS,STL,"Boston, MA",Massachusetts,"St. Louis, MO",Missouri,798,1299,-17,-15,781,1284,29,16,810,1268,231,33,53,78,0,,0,0.0,0.0,0.0,0.0,0.0
2024,1,13,6,2024-01-13,YX,3676,BOS,DEN,"Boston, MA",Massachusetts,"Denver, CO",Colorado,1789,2274,7,0,1796,2274,10,10,1806,2264,1010,125,145,145,0,,0,0.0,0.0,0.0,0.0,0.0
2024,10,23,3,2024-10-23,AS,9245,LAX,BOS,"Los Angeles, CA",California,"Boston, MA",Massachusetts,1550,2086,1,0,1551,2086,12,19,1563,2067,1640,209,229,240,0,,0,0.0,0.0,0.0,0.0,0.0
2024,11,8,5,2024-11-08,HA,5293,SLC,SEA,"Salt Lake City, UT",Utah,"Seattle, WA",Washington,1147,1531,-6,-5,1141,1526,20,16,1161,1510,717,92,112,128,0,,0,0.0,0.0,0.0,0.0,0.0
2024,6,29,6,2024-06-29,WN,9917,IAD,SLC,"Washington, DC",District of Columbia,"Salt Lake City, UT",Utah,1247,724,-4,-10,1243,714,16,10,1259,704,1381,172,192,198,0,,0,0.0,0.0,0.0,0.0,0.0
2024,9,24,2,2024-09-24,B6,1970,MIA,PHX,"Miami, FL",Florida,"Phoenix, AZ",Arizona,2280,822,-9,-10,2271,812,13,11,2284,801,2833,348,368,372,0,,0,0.0,0.0,0.0,0.0,0.0
2024,1,13,6,2024-01-13,OO,4361,MDW,BOS,"Chicago, IL",Illinois,"Boston, MA",Massachusetts,1975,927,-19,-10,1956,917,20,3,1976,914,869,116,136,139,0,,0,0.0,0.0,0.0,0.0,0.0
2024,4,29,1,2024-04-29,B6,2124,DCA,LAX,"Washington, DC",District of Columbia,"Los Angeles, CA",California,1992,1616,13,10,2005,1626,11,8,2016,1618,2320,293,313,312,0,,0,0.0,0.0,0.0,0.0,0.0
2024,12,18,3,2024-12-18,DL,5594,ATL,MIA,"Atlanta, GA",Georgia,"Miami, FL",Florida,1608,1417,-20,-15,1588,1402,12,8,1600,1394,1357,159,179,179,0,,0,0.0,0.0,0.0,0.0,0.0
2024,2,26,1,2024-02-26,F9,8932,DCA,MCO,"Washington, DC",District of Columbia,"Orlando, FL",Florida,1425,858,-10,-10,1415,848,24,8,1439,840,2375,300,320,332,0,,0,0.0,0.0,0.0,0.0,0.0
2024,2,9,5,2024-02-09,HA,5553,CLT,PDX,"Charlotte, NC",North Carolina,"Portland, OR",Oregon,512,666,-7,-10,505,656,9,9,514,647,1947,241,261,259,0,,0,0.0,0.0,0.0,0.0,0.0
2024,12,1,7,2024-12-01,DL,1927,MDW,CLT,"Chicago, IL",Illinois,"Charlotte, NC",North Carolina,2093,2220,8,5,2101,2225,27,19,2128,2206,920,105,125,151,0,,0,0.0,0.0,0.0,0.0,0.0
2024,5,7,2,2024-05-07,WN,4802,BWI,MDW,"Baltimore, MD",Maryland,"Chicago, IL",Illinois,758,1482,-15,-10,743,1472,13,11,756,1461,2761,341,361,365,0,,0,0.0,0.0,0.0,0.0,0.0
2024,6,21,5,2024-06-21,YX,639,MIA,EWR,"Miami, FL",Florida,"Newark, NJ",New Jersey,1479,1685,-30,-20,1449,1665,12,13,1461,1652,1284,150,170,175,0,,0,0.0,0.0,0.0,0.0,0.0
2024,2,4,7,2024-02-04,MQ,7302,PDX,SLC,"Portland, OR",Oregon,"Salt Lake City, UT",Utah,1623,1571,1,-5,1624,1566,27,15,1651,1551,712,91,111,133,0,,0,0.0,0.0,0.0,0.0,0.0
2024,9,15,7,2024-09-15,B6,4538,LAS,DEN,"Las Vegas, NV",Nevada,"Denver, CO",Colorado,1115,2149,1,-5,1116,2144,24,16,1140,2128,2537,315,335,355,0,,0,0.0,0.0,0.0,0.0,0.0
2024,1,5,5,2024-01-05,OH,3601,MDW,HNL,"Chicago, IL",Illinois,"Honolulu, HI",Hawaii,1784,2257,1,-5,1785,2252,20,7,1805,2245,950,114,134,141,0,,0,0.0,0.0,0.0,0.0,0.0
2024,8,5,1,2024-08-05,AA,3637,DTW,DEN,"Detroit, MI",Michigan,"Denver, CO",Colorado,777,878,4,5,781,883,15,9,796,874,1003,125,145,149,0,,0,0.0,0.0,0.0,0.0,0.0
2024,1,11,4,2024-01-11,AS,6816,SEA,SFO,"Seattle, WA",Washington,"San Francisco, CA",California,1453,1746,-21,-20,1432,1726,5,5,1437,1721,367,45,65,55,0,,0,0.0,0.0,0.0,0.0,0.0
2024,11,22,5,2024-11-22,DL,6918,SAN,MDW,"San Diego, CA",California,"Chicago, IL",Illinois,1589,1188,-17,-20,1572,1168,21,14,1593,1154,1594,194,214,229,0,,0,0.0,0.0,0.0,0.0,0.0
2024,4,26,5,2024-04-26,OH,6300,MDW,SFO,"Chicago, IL",Illinois,"San Francisco, CA",California,2124,871,-20,-10,2104,861,16,9,2120,852,1115,141,161,166,0,,0,0.0,0.0,0.0,0.0,0.0
2024,7,2,2,2024-07-02,B6,4386,DEN,EWR,"Denver, CO",Colorado,"Newark, NJ",New Jersey,1307,1101,1,10,1308,1111,9,9,1317,1102,1447,172,192,190,0,,0,0.0,0.0,0.0,0.0,0.0
2024,12,27,5,2024-12-27,HA,4839,SEA,SFO,"Seattle, WA",Washington,"San Francisco, CA",California,2123,1257,-3,-10,2120,1247,18,13,2138,1234,1791,223,243,254,0,,0,0.0,0.0,0.0,0.0,0.0
2024,4,25,4,2024-04-25,AS,2189,IAD,BWI,"Washington, DC",District of Columbia,"Baltimore, MD",Maryland,1901,1892,69,60,1970,1952,11,12,1981,1940,216,18,38,41,0,,0,17.0,4.0,7.0,1.0,31.0
2024,6,10,1,2024-06-10,OO,5705,DFW,SFO,"Dallas/Fort Worth, TX",Texas,"San Francisco, CA",California,2040,1492,2,10,2042,1502,28,4,2070,1498,2563,327,347,359,0,,0,0.0,0.0,0.0,0.0,0.0
2024,3,7,4,2024-03-07,F9,7440,JFK,IAD,"New York, NY",New York,"Washington, DC",District of Columbia,1155,1167,-7,0,1148,1167,11,14,1159,1153,1693,209,229,234,0,,0,0.0,0.0,0.0,0.0,0.0
2024,7,18,4,2024-07-18,G4,6922,STL,SLC,"St. Louis, MO",Missouri,"Salt Lake City, UT",Utah,1640,817,-1,5,1639,822,8,11,1647,811,332,49,69,68,0,,0,0.0,0.0,0.0,0.0,0.0
2024,1,31,3,2024-01-31,MQ,3421,SEA,ORD,"Seattle, WA",Washington,"Chicago, IL",Illinois,1282,1284,9,0,1291,1284,19,8,1310,1276,2982,368,388,395,0,,0,0.0,0.0,0.0,0.0,0.0
2024,3,15,5,2024-03-15,HA,2649,IAD,PHL,"Washington, DC",District of Columbia,"Philadelphia, PA",Pennsylvania,998,2175,-8,0,990,2175,11,16,1001,2159,1241,158,178,185,0,,0,0.0,0.0,0.0,0.0,0.0
2024,8,24,6,2024-08-24,YX,1316,IAD,LGA,"Washington, DC",District of Columbia,"New York, NY",New York,704,758,-8,0,696,758,26,10,722,748,2316,294,314,330,0,,0,0.0,0.0,0.0,0.0,0.0
2024,11,22,5,2024-11-22,AS,4985,LGA,MCO,"New York, NY",New York,"Orlando, FL",Florida,1086,959,-7,0,1079,959,28,18,1107,941,261,41,61,87,0,,0,0.0,0.0,0.0,0.0,0.0
2024,3,6,3,2024-03-06,B6,6993,EWR,CLT,"Newark, NJ",New Jersey,"Charlotte, NC",North Carolina,1603,2088,-20,-15,1583,2073,13,18,1596,2055,1550,196,216,227,0,,0,0.0,0.0,0.0,0.0,0.0
2024,3,10,7,2024-03-10,YX,9033,MSP,JFK,"Minneapolis, MN",Minnesota,"New York, NY",New York,1541,1143,-4,0,1537,1143,5,3,1542,1140,2645,334,354,342,0,,0,0.0,0.0,0.0,0.0,0.0
2024,10,23,3,2024-10-23,WN,6408,IAH,MIA,"Houston, TX",Texas,"Miami, FL",Florida,2252,1871,-2,5,2250,1876,6,12,2256,1864,600,79,99,97,0,,0,0.0,0.0,0.0,0.0,0.0
2024,1,20,6,2024-01-20,DL,5182,TPA,BWI,"Tampa, FL",Florida,"Baltimore, MD",Maryland,1113,2264,-1,-5,1112,2259,12,9,1124,2250,596,74,94,95,0,,0,0.0,0.0,0.0,0.0,0.0
2024,8,13,2,2024-08-13,DL,7325,TPA,EWR,"Tampa, FL",Florida,"Newark, NJ",New Jersey,1499,890,15,20,1514,910,11,8,1525,902,2655,334,354,353,0,,0,0.0,4.0,0.0,0.0,16.0
2024,7,17,3,2024-07-17,NK,7530,PHX,PHL,"Phoenix, AZ",Arizona,"Philadelphia, PA",Pennsylvania,1143,635,-21,-15,1122,620,27,6,1149,614,683,78,98,111,0,,0,0.0,0.0,0.0,0.0,0.0
2024,2,8,4,2024-02-08,B6,8939,CLT,SAN,"Charlotte, NC",North Carolina,"San Diego, CA",California,1320,1578,12,15,1332,1593,7,11,1339,1582,1030,120,140,138,0,,0,0.0,0.0,0.0,0.0,0.0
2024,5,24,5,2024-05-24,NK,2897,MDW,ATL,"Chicago, IL",Illinois,"Atlanta, GA",Georgia,557,1459,0,5,557,1464,11,6,568,1458,2653,324,344,341,0,,0,0.0,0.0,0.0,0.0,0.0
2024,2,14,3,2024-02-14,MQ,918,CLT,ORD,"Charlotte, NC",North Carolina,"Chicago, IL",Illinois,1635,665,11,5,1646,670,24,13,1670,657,1760,227,247,264,0,,0,0.0,0.0,0.0,0.0,0.0
2024,11,21,4,2024-11-21,OO,8534,STL,DTW,"St. Louis, MO",Missouri,"Detroit, MI",Michigan,1096,1396,15,10,1111,1406,20,5,1131,1401,2528,319,339,344,0,,0,0.0,0.0,0.0,0.0,0.0
2024,3,31,7,2024-03-31,AA,6906,PHX,SFO,"Phoenix, AZ",Arizona,"San Francisco, CA",California,2151,2050,10,10,2161,2060,6,14,2167,2046,1116,130,150,150,0,,0,0.0,0.0,0.0,0.0,0.0
2024,8,25,7,2024-08-25,AA,7101,IAH,JFK,"Houston, TX",Texas,"New York, NY",New York,814,756,-15,-5,799,751,5,5,804,746,996,133,153,143,0,,0,0.0,0.0,0.0,0.0,0.0
2024,3,10,7,2024-03-10,B6,8026,JFK,STL,"New York, NY",New York,"St. Louis, MO",Missouri,661,2178,8,5,669,2183,12,9,681,2174,1724,207,227,228,0,,0,0.0,0.0,0.0,0.0,0.0
2024,6,14,5,2024-06-14,DL,4204,DTW,EWR,"Detroit, MI",Michigan,"Newark, NJ",New Jersey,823,720,-13,-15,810,705,9,5,819,700,2757,338,358,352,0,,0,0.0,0.0,0.0,0.0,0.0
2024,5,9,4,2024-05-09,F9,8146,SAN,DTW,"San Diego, CA",California,"Detroit, MI",Michigan,1217,791,-1,0,1216,791,14,6,1230,785,317,45,65,65,0,,0,0.0,0.0,0.0,0.0,0.0
2024,8,1,4,2024-08-01,OH,112,CLT,BWI,"Charlotte, NC",North Carolina,"Baltimore, MD",Maryland,1854,2099,14,15,1868,2114,8,7,1876,2107,2764,338,358,353,0,,0,0.0,0.0,0.0,0.0,0.0
2024,12,5,4,2024-12-05,HA,5994,ORD,PDX,"Chicago, IL",Illinois,"Portland, OR",Oregon,1079,1977,-13,-10,1066,1967,13,6,1079,1961,905,120,140,139,0,,0,0.0,0.0,0.0,0.0,0.0
2024,3,29,5,2024-03-29,UA,7150,SEA,BOS,"Seattle, WA",Washington,"Boston, MA",Massachusetts,1398,2166,-22,-20,1376,2146,18,7,1394,2139,379,56,76,81,0,,0,0.0,0.0,0.0,0.0,0.0
2024,11,30,6,2024-11-30,AA,3117,BWI,PHL,"Baltimore, MD",Maryland,"Philadelphia, PA",Pennsylvania,1259,956,-7,0,1252,956,25,6,1277,950,2654,336,356,367,0,,0,0.0,0.0,0.0,0.0,0.0
2024,9,8,7,2024-09-08,MQ,7492,CLT,MIA,"Charlotte, NC",North Carolina,"Miami, FL",Florida,1001,1130,-5,-5,996,1125,14,14,1010,1111,585,74,94,102,0,,0,0.0,0.0,0.0,0.0,0.0
2024,12,14,6,2024-12-14,DL,789,MCO,ORD,"Orlando, FL",Florida,"Chicago, IL",Illinois,556,1079,-7,-5,549,1074,22,16,571,1058,1437,169,189,207,0,,0,0.0,0.0,0.0,0.0,0.0
2024,3,12,2,2024-03-12,9E,5978,MSP,SFO,"Minneapolis, MN",Minnesota,"San Francisco, CA",California,1688,1396,1,0,1689,1396,29,14,1718,1382,1052,124,144,167,0,,0,0.0,0.0,0.0,0.0,0.0
2024,6,13,4,2024-06-13,9E,3238,LAS,JFK,"Las Vegas, NV",Nevada,"New York, NY",New York,1689,1696,2,0,1691,1696,27,15,1718,1681,2355,301,321,343,0,,0,0.0,0.0,0.0,0.0,0.0
2024,2,18,7,2024-02-18,NK,8076,MCO,LAX,"Orlando, FL",Florida,"Los Angeles, CA",California,796,2014,-8,-5,788,2009,13,7,801,2002,1859,235,255,255,0,,0,0.0,0.0,0.0,0.0,0.0
2024,2,21,3,2024-02-21,AS,8968,MDW,SLC,"Chicago, IL",Illinois,"Salt Lake City, UT",Utah,1527,1553,2,0,1529,1553,9,3,1538,1550,1656,213,233,225,0,,0,0.0,0.0,0.0,0.0,0.0
2024,10,15,2,2024-10-15,YX,6427,MDW,JFK,"Chicago, IL",Illinois,"New York, NY",New York,909,1699,35,45,944,1744,27,16,971,1728,2415,305,325,348,0,,0,6.0,2.0,6.0,1.0,30.0
2024,10,4,5,2024-10-04,F9,4403,IAD,DFW,"Washington, DC",District of Columbia,"Dallas/Fort Worth, TX",Texas,1306,787,20,20,1326,807,12,11,1338,796,1412,180,200,203,0,,0,0.0,4.0,1.0,0.0,15.0
2024,4,23,2,2024-04-23,NK,9615,PHX,DTW,"Phoenix, AZ",Arizona,"Detroit, MI",Michigan,1629,2314,-4,5,1625,2319,16,11,1641,2308,2022,258,278,285,0,,0,0.0,0.0,0.0,0.0,0.0
2024,8,26,1,2024-08-26,OH,1102,HNL,SAN,"Honolulu, HI",Hawaii,"San Diego, CA",California,1119,1961,-16,-10,1103,1951,24,16,1127,1935,288,27,47,67,0,,0,0.0,0.0,0.0,0.0,0.0
2024,5,12,7,2024-05-12,9E,7508,TPA,LGA,"Tampa, FL",Florida,"New York, NY",New York,2205,1075,-5,-5,2200,1070,28,3,2228,1067,224,25,45,56,0,,0,0.0,0.0,0.0,0.0,0.0
2024,9,30,1,2024-09-30,MQ,8242,CLT,LGA,"Charlotte, NC",North Carolina,"New York, NY",New York,1278,1929,3,10,1281,1939,27,17,1308,1922,2343,291,311,335,0,,0,0.0,0.0,0.0,0.0,0.0
2024,6,14,5,2024-06-14,F9,1865,LAS,PHL,"Las Vegas, NV",Nevada,"Philadelphia, PA",Pennsylvania,1278,1516,-8,-5,1270,1511,23,13,1293,1498,2369,289,309,325,0,,0,0.0,0.0,0.0,0.0,0.0
2024,10,19,6,2024-10-19,UA,9845,JFK,LAX,"New York, NY",New York,"Los Angeles, CA",California,1065,1248,21,20,1086,1268,18,11,1104,1257,2945,375,395,404,0,,0,3.0,1.0,2.0,0.0,14.0
2024,8,30,5,2024-08-30,AS,5878,MIA,IAH,"Miami, FL",Florida,"Houston, TX",Texas,1497,761,-8,0,1489,761,15,7,1504,754,1796,221,241,243,0,,0,0.0,0.0,0.0,0.0,0.0
2024,11,15,5,2024-11-15,MQ,2391,ATL,LAS,"Atlanta, GA",Georgia,"Las Vegas, NV",Nevada,665,1401,16,10,681,1411,15,17,696,1394,1551,185,205,217,0,,0,0.0,0.0,0.0,0.0,0.0
2024,5,17,5,2024-05-17,NK,7830,STL,BOS,"St. Louis, MO",Missouri,"Boston, MA",Massachusetts,1777,646,-23,-20,1754,626,28,17,1782,609,2230,283,303,328,0,,0,0.0,0.0,0.0,0.0,0.0
2024,3,19,2,2024-03-19,HA,4966,PHL,SAN,"Philadelphia, PA",Pennsylvania,"San Diego, CA",California,1287,623,-10,-5,1277,618,8,4,1285,614,1237,160,180,172,0,,0,0.0,0.0,0.0,0.0,0.0
2024,6,18,2,2024-06-18,9E,8529,IAD,DFW,"Washington, DC",District of Columbia,"Dallas/Fort Worth, TX",Texas,1165,1959,-2,5,1163,1964,22,3,1185,1961,333,48,68,73,1,,0,0.0,0.0,0.0,0.0,0.0
2024,5,2,4,2024-05-02,OO,6553,LGA,TPA,"New York, NY",New York,"Tampa, FL",Florida,627,1907,3,10,630,1917,13,4,643,1913,1758,228,248,245,0,,0,0.0,0.0,0.0,0.0,0.0
2024,6,24,1,2024-06-24,AA,1684,DCA,MCO,"Washington, DC",District of Columbia,"Orlando, FL",Florida,2009,773,-4,0,2005,773,12,3,2017,770,2205,265,285,280,0,,0,0.0,0.0,0.0,0.0,0.0
2024,10,26,6,2024-10-26,AA,1407,LAX,PDX,"Los Angeles, CA",California,"Portland, OR",Oregon,575,1930,-11,-10,564,1920,8,17,572,1903,875,102,122,127,0,,0,0.0,0.0,0.0,0.0,0.0
2024,3,22,5,2024-03-22,NK,2185,PDX,MIA,"Portland, OR",Oregon,"Miami, FL",Florida,1386,1478,5,10,1391,1488,23,14,1414,1474,1162,140,160,177,0,,0,0.0,0.0,0.0,0.0,0.0
2024,3,27,3,2024-03-27,MQ,131,SAN,BWI,"San Diego, CA",California,"Baltimore, MD",Maryland,1744,1373,-7,0,1737,1373,23,9,1760,1364,2676,334,354,366,0,,0,0.0,0.0,0.0,0.0,0.0
2024,8,12,1,2024-08-12,OO,7820,STL,IAD,"St. Louis, MO",Missouri,"Washington, DC",District of Columbia,1281,829,-16,-15,1265,814,26,15,1291,799,2675,327,347,368,0,,0,0.0,0.0,0.0,0.0,0.0
2024,1,16,2,2024-01-16,MQ,391,IAD,TPA,"Washington, DC",District of Columbia,"Tampa, FL",Florida,933,1302,9,0,942,1302,6,3,948,1299,592,75,95,84,0,,0,0.0,0.0,0.0,0.0,0.0
2024,11,5,2,2024-11-05,UA,3786,PHX,IAD,"Phoenix, AZ",Arizona,"Washington, DC",District of Columbia,1134,717,11,5,1145,722,15,12,1160,710,652,77,97,104,0,,0,0.0,0.0,0.0,0.0,0.0
2024,12,23,1,2024-12-23,UA,1742,SLC,SFO,"Salt Lake City, UT",Utah,"San Francisco, CA",California,2060,652,9,0,2069,652,7,7,2076,645,1351,161,181,175,0,,0,0.0,0.0,0.0,0.0,0.0
2024,6,11,2,2024-06-11,HA,7866,LAS,IAD,"Las Vegas, NV",Nevada,"Washington, DC",District of Columbia,1962,1815,5,10,1967,1825,5,8,1972,1817,211,35,55,48,0,,0,0.0,0.0,0.0,0.0,0.0
2024,4,7,7,2024-04-07,B6,8869,DCA,MCO,"Washington, DC",District of Columbia,"Orlando, FL",Florida,1958,1547,-5,-5,1953,1542,14,7,1967,1535,264,42,62,63,1,,0,0.0,0.0,0.0,0.0,0.0
2024,6,4,2,2024-06-04,HA,4009,DEN,MIA,"Denver, CO",Colorado,"Miami, FL",Florida,2141,1171,7,0,2148,1171,25,19,2173,1152,732,91,111,135,0,,0,0.0,0.0,0.0,0.0,0.0
2024,1,2,2,2024-01-02,OO,1323,SAN,BOS,"San Diego, CA",California,"Boston, MA",Massachusetts,2141,1122,-12,-10,2129,1112,17,9,2146,1103,1925,234,254,260,0,,0,0.0,0.0,0.0,0.0,0.0
2024,12,15,7,2024-12-15,AS,8738,MSP,LGA,"Minneapolis, MN",Minnesota,"New York, NY",New York,1114,1371,1,0,1115,1371,7,5,1122,1366,1244,156,176,168,0,,0,0.0,0.0,0.0,0.0,0.0
2024,6,17,1,2024-06-17,DL,4473,PDX,PHL,"Portland, OR",Oregon,"Philadelphia, PA",Pennsylvania,1485,1381,-10,-10,1475,1371,11,6,1486,1365,2850,354,374,371,0,,0,0.0,0.0,0.0,0.0,0.0
2024,11,10,7,2024-11-10,UA,2679,CLT,BWI,"Charlotte, NC",North Carolina,"Baltimore, MD",Maryland,1025,1764,-3,-10,1022,1754,29,10,1051,1744,713,88,108,127,0,,0,0.0,0.0,0.0,0.0,0.0
2024,11,20,3,2024-11-20,AS,1522,SAN,LAS,"San Diego, CA",California,"Las Vegas, NV",Nevada,1656,1254,-19,-10,1637,1244,9,15,1646,1229,2643,323,343,347,0,,0,0.0,0.0,0.0,0.0,0.0
2024,4,1,1,2024-04-01,UA,7658,BOS,BWI,"Boston, MA",Massachusetts,"Baltimore, MD",Maryland,940,712,-15,-20,925,692,6,5,931,687,1885,239,259,250,0,,0,0.0,0.0,0.0,0.0,0.0
2024,6,29,6,2024-06-29,OH,6845,EWR,LAX,"Newark, NJ",New Jersey,"Los Angeles, CA",California,2057,1887,-12,-10,2045,1877,22,11,2067,1866,2256,278,298,311,0,,0,0.0,0.0,0.0,0.0,0.0
2024,8,18,7,2024-08-18,B6,2709,IAH,SLC,"Houston, TX",Texas,"Salt Lake City, UT",Utah,1086,2114,0,-5,1086,2109,18,11,1104,2098,1053,128,148,157,0,,0,0.0,0.0,0.0,0.0,0.0
2024,10,27,7,2024-10-27,G4,3181,SLC,JFK,"Salt Lake City, UT",Utah,"New York, NY",New York,890,1967,-14,-15,876,1952,24,12,900,1940,2059,261,281,297,1,,0,0.0,0.0,0.0,0.0,0.0
2024,5,27,1,2024-05-27,YX,6834,TPA,PDX,"Tampa, FL",Florida,"Portland, OR",Oregon,743,2146,-9,-15,734,2131,29,5,763,2126,2212,272,292,306,0,,0,0.0,0.0,0.0,0.0,0.0
2024,10,6,7,2024-10-06,UA,8350,EWR,ATL,"Newark, NJ",New Jersey,"Atlanta, GA",Georgia,1267,698,22,20,1289,718,6,14,1295,704,1200,145,165,165,0,,0,1.0,5.0,1.0,0.0,13.0
2024,7,7,7,2024-07-07,YX,8750,IAD,SEA,"Washington, DC",District of Columbia,"Seattle, WA",Washington,1669,1072,-12,-5,1657,1067,9,4,1666,1063,2708,339,359,352,0,,0,0.0,0.0,0.0,0.0,0.0
2024,12,12,4,2024-12-12,OO,203,LAS,PHX,"Las Vegas, NV",Nevada,"Phoenix, AZ",Arizona,914,1646,-3,-5,911,1641,17,14,928,1627,927,116,136,147,0,,0,0.0,0.0,0.0,0.0,0.0
2024,12,15,7,2024-12-15,MQ,5026,DTW,EWR,"Detroit, MI",Michigan,"Newark, NJ",New Jersey,926,838,-9,-10,917,828,11,11,928,817,1353,173,193,195,0,,0,0.0,0.0,0.0,0.0,0.0
2024,11,9,6,2024-11-09,MQ,9080,DEN,JFK,"Denver, CO",Colorado,"New York, NY",New York,1735,1220,-9,0,1726,1220,14,4,1740,1216,1610,192,212,210,0,,0,0.0,0.0,0.0,0.0,0.0
2024,5,7,2,2024-05-07,AS,841,LAS,CLT,"Las Vegas, NV",Nevada,"Charlotte, NC",North Carolina,748,1886,6,0,754,1886,24,17,778,1869,1878,239,259,280,0,,0,0.0,0.0,0.0,0.0,0.0
2024,1,7,7,2024-01-07,OO,9864,MSP,TPA,"Minneapolis, MN",Minnesota,"Tampa, FL",Florida,1558,1948,-1,-5,1557,1943,11,9,1568,1934,1951,237,257,257,0,,0,0.0,0.0,0.0,0.0,0.0
2024,2,16,5,2024-02-16,B6,6544,MDW,PHL,"Chicago, IL",Illinois,"Philadelphia, PA",Pennsylvania,1338,1271,-3,-5,1335,1266,27,9,1362,1257,2657,327,347,363,0,,0,0.0,0.0,0.0,0.0,0.0
2024,2,22,4,2024-02-22,B6,4823,ORD,ATL,"Chicago, IL",Illinois,"Atlanta, GA",Georgia,752,2355,-4,5,748,2360,22,10,770,2350,2383,304,324,336,1,,0,0.0,0.0,0.0,0.0,0.0
2024,7,5,5,2024-07-05,OO,7759,PHL,SEA,"Philadelphia, PA",Pennsylvania,"Seattle, WA",Washington,1361,2307,10,15,1371,2322,22,17,1393,2305,892,109,129,148,0,,0,0.0,0.0,0.0,0.0,0.0
2024,2,7,3,2024-02-07,OH,5303,MDW,IAD,"Chicago, IL",Illinois,"Washington, DC",District of Columbia,2295,986,11,10,2306,996,6,14,2312,982,2764,344,364,364,0,,0,0.0,0.0,0.0,0.0,0.0
2024,8,13,2,2024-08-13,OH,3076,MDW,ATL,"Chicago, IL",Illinois,"Atlanta, GA",Georgia,1318,1205,-25,-15,1293,1190,29,8,1322,1182,2959,362,382,399,0,,0,0.0,0.0,0.0,0.0,0.0
2024,2,22,4,2024-02-22,AS,7526,SLC,DEN,"Salt Lake City, UT",Utah,"Denver, CO",Colorado,1361,721,9,5,1370,726,20,8,1390,718,373,50,70,78,0,,0,0.0,0.0,0.0,0.0,0.0
2024,8,11,7,2024-08-11,AS,6603,DCA,LAS,"Washington, DC",District of Columbia,"Las Vegas, NV",Nevada,1809,1923,-28,-20,1781,1903,17,18,1798,1885,999,129,149,164,0,,0,0.0,0.0,0.0,0.0,0.0
2024,6,2,7,2024-06-02,AA,8719,MDW,BWI,"Chicago, IL",Illinois,"Baltimore, MD",Maryland,2216,2332,-1,0,2215,2332,21,7,2236,2325,1062,136,156,164,0,,0,0.0,0.0,0.0,0.0,0.0
2024,2,17,6,2024-02-17,OO,6586,SFO,STL,"San Francisco, CA",California,"St. Louis, MO",Missouri,709,1162,-5,0,704,1162,10,5,714,1157,2373,294,314,309,0,,0,0.0,0.0,0.0,0.0,0.0
2024,12,16,1,2024-12-16,HA,6590,SFO,LAX,"San Francisco, CA",California,"Los Angeles, CA",California,609,916,-6,0,603,916,27,16,630,900,2191,282,302,325,0,,0,0.0,0.0,0.0,0.0,0.0
2024,5,26,7,2024-05-26,G4,2044,SAN,DCA,"San Diego, CA",California,"Washington, DC",District of Columbia,829,619,-3,0,826,619,13,3,839,616,1351,170,190,186,0,,0,0.0,0.0,0.0,0.0,0.0
2024,3,4,1,2024-03-04,B6,6339,IAH,PHL,"Houston, TX",Texas,"Philadelphia, PA",Pennsylvania,641,1141,0,5,641,1146,7,19,648,1127,2142,261,281,287,0,,0,0.0,0.0,0.0,0.0,0.0
2024,12,14,6,2024-12-14,AA,7522,HNL,LAX,"Honolulu, HI",Hawaii,"Los Angeles, CA",California,1175,1923,5,5,1180,1928,29,14,1209,1914,2734,335,355,378,0,,0,0.0,0.0,0.0,0.0,0.0
2024,6,30,7,2024-06-30,F9,6073,SAN,LAS,"San Diego, CA",California,"Las Vegas, NV",Nevada,586,2093,-17,-20,569,2073,11,7,580,2066,953,109,129,127,0,,0,0.0,0.0,0.0,0.0,0.0
2024,5,4,6,2024-05-04,NK,9563,PHX,JFK,"Phoenix, AZ",Arizona,"New York, NY",New York,639,1709,14,5,653,1714,9,4,662,1710,1684,206,226,219,0,,0,0.0,0.0,0.0,0.0,0.0
2024,6,27,4,2024-06-27,NK,5621,SLC,SEA,"Salt Lake City, UT",Utah,"Seattle, WA",Washington,1855,2292,4,10,1859,2302,25,9,1884,2293,1395,169,189,203,0,,0,0.0,0.0,0.0,0.0,0.0
2024,2,8,4,2024-02-08,HA,511,LAS,MSP,"Las Vegas, NV",Nevada,"Minneapolis, MN",Minnesota,1173,1004,-13,-15,1160,989,11,19,1171,970,534,74,94,104,0,,0,0.0,0.0,0.0,0.0,0.0
2024,9,16,1,2024-09-16,OH,6190,LAS,DFW,"Las Vegas, NV",Nevada,"Dallas/Fort Worth, TX",Texas,525,1577,-7,-5,518,1572,14,6,532,1566,2548,315,335,335,0,,0,0.0,0.0,0.0,0.0,0.0
2024,1,3,3,2024-01-03,B6,346,ORD,JFK,"Chicago, IL",Illinois,"New York, NY",New York,1145,1292,4,5,1149,1297,26,4,1175,1293,803,103,123,133,0,,0,0.0,0.0,0.0,0.0,0.0
2024,3,4,1,2024-03-04,AA,6942,MDW,SFO,"Chicago, IL",Illinois,"San Francisco, CA",California,2150,711,0,0,2150,711,28,15,2178,696,375,41,61,84,0,,0,0.0,0.0,0.0,0.0,0.0
2024,1,29,1,2024-01-29,G4,6664,DEN,MSP,"Denver, CO",Colorado,"Minneapolis, MN",Minnesota,2216,1762,0,5,2216,1767,14,9,2230,1758,1750,216,236,239,0,,0,0.0,0.0,0.0,0.0,0.0
2024,1,11,4,2024-01-11,OO,2271,EWR,MSP,"Newark, NJ",New Jersey,"Minneapolis, MN",Minnesota,1410,1633,-6,0,1404,1633,14,3,1418,1630,2925,362,382,379,0,,0,0.0,0.0,0.0,0.0,0.0
2024,4,6,6,2024-04-06,G4,7378,STL,BOS,"St. Louis, MO",Missouri,"Boston, MA",Massachusetts,861,1914,14,20,875,1934,29,11,904,1923,2127,263,283,303,0,,0,0.0,1.0,3.0,0.0,16.0
2024,12,23,1,2024-12-23,F9,7557,CLT,BWI,"Charlotte, NC",North Carolina,"Baltimore, MD",Maryland,2182,978,20,15,2202,993,10,4,2212,989,708,85,105,99,0,,0,0.0,0.0,0.0,0.0,0.0
2024,7,21,7,2024-07-21,B6,5818,MCO,SEA,"Orlando, FL",Florida,"Seattle, WA",Washington,859,1539,-13,-10,846,1529,23,10,869,1519,2582,323,343,356,0,,0,0.0,0.0,0.0,0.0,0.0
2024,1,21,7,2024-01-21,OH,2160,BOS,LGA,"Boston, MA",Massachusetts,"New York, NY",New York,1738,837,-1,-5,1737,832,29,10,1766,822,890,102,122,141,0,,0,0.0,0.0,0.0,0.0,0.0
2024,2,8,4,2024-02-08,UA,3434,SEA,SLC,"Seattle, WA",Washington,"Salt Lake City, UT",Utah,1495,1243,-1,-5,1494,1238,22,4,1516,1234,1897,243,263,269,0,,0,0.0,0.0,0.0,0.0,0.0
2024,8,10,6,2024-08-10,F9,7290,TPA,CLT,"Tampa, FL",Florida,"Charlotte, NC",North Carolina,576,929,-17,-15,559,914,25,4,584,910,1515,187,207,216,0,,0,0.0,0.0,0.0,0.0,0.0
2024,4,11,4,2024-04-11,AA,1044,CLT,SLC,"Charlotte, NC",North Carolina,"Salt Lake City, UT",Utah,594,784,-1,-5,593,779,19,3,612,776,1243,154,174,176,0,,0,0.0,0.0,0.0,0.0,0.0
2024,2,15,4,2024-02-15,UA,5461,LGA,TPA,"New York, NY",New York,"Tampa, FL",Florida,1456,2343,2,5,1458,2348,17,4,1475,2344,2099,264,284,285,0,,0,0.0,0.0,0.0,0.0,0.0
2024,3,6,3,2024-03-06,YX,9554,PHL,MCO,"Philadelphia, PA",Pennsylvania,"Orlando, FL",Florida,1496,2048,13,10,1509,2058,24,5,1533,2053,2772,345,365,374,0,,0,0.0,0.0,0.0,0.0,0.0
2024,3,31,7,2024-03-31,OO,5384,LAX,MDW,"Los Angeles, CA",California,"Chicago, IL",Illinois,717,1946,6,10,723,1956,6,14,729,1942,1780,230,250,250,0,,0,0.0,0.0,0.0,0.0,0.0
2024,6,12,3,2024-06-12,NK,6981,LAS,DFW,"Las Vegas, NV",Nevada,"Dallas/Fort Worth, TX",Texas,867,1081,-19,-20,848,1061,26,10,874,1051,2780,339,359,375,0,,0,0.0,0.0,0.0,0.0,0.0
2024,4,20,6,2024-04-20,OH,8467,PDX,ATL,"Portland, OR",Oregon,"Atlanta, GA",Georgia,551,1200,-5,5,546,1205,14,19,560,1186,2102,259,279,292,0,,0,0.0,0.0,0.0,0.0,0.0
2024,12,3,2,2024-12-03,HA,9344,BWI,SLC,"Baltimore, MD",Maryland,"Salt Lake City, UT",Utah,1797,1981,4,0,1801,1981,27,15,1828,1966,606,77,97,119,0,,0,0.0,0.0,0.0,0.0,0.0
2024,5,2,4,2024-05-02,WN,9609,MIA,SEA,"Miami, FL",Florida,"Seattle, WA",Washington,1967,961,-14,-10,1953,951,6,3,1959,948,757,86,106,95,0,,0,0.0,0.0,0.0,0.0,0.0
2024,7,11,4,2024-07-11,NK,8040,MSP,DTW,"Minneapolis, MN",Minnesota,"Detroit, MI",Michigan,1186,1659,4,0,1190,1659,7,13,1197,1646,970,120,140,140,0,,0,0.0,0.0,0.0,0.0,0.0
2024,4,8,1,2024-04-08,YX,9966,EWR,DFW,"Newark, NJ",New Jersey,"Dallas/Fort Worth, TX",Texas,1324,1115,9,10,1333,1125,9,11,1342,1114,2973,366,386,386,0,,0,0.0,0.0,0.0,0.0,0.0
2024,10,17,4,2024-10-17,OO,433,PDX,PHL,"Portland, OR",Oregon,"Philadelphia, PA",Pennsylvania,532,929,-10,-5,522,924,29,4,551,920,1828,223,243,256,0,,0,0.0,0.0,0.0,0.0,0.0
2024,6,7,5,2024-06-07,MQ,9556,DEN,CLT,"Denver, CO",Colorado,"Charlotte, NC",North Carolina,1371,868,50,45,1421,913,19,14,1440,899,2695,330,350,363,0,,0,5.0,7.0,5.0,0.0,28.0
2024,4,12,5,2024-04-12,OH,3045,MSP,MIA,"Minneapolis, MN",Minnesota,"Miami, FL",Florida,1939,1693,3,0,1942,1693,11,13,1953,1680,2592,320,340,344,0,,0,0.0,0.0,0.0,0.0,0.0
2024,10,7,1,2024-10-07,B6,4880,EWR,JFK,"Newark, NJ",New Jersey,"New York, NY",New York,1143,2142,1,0,1144,2142,19,9,1163,2133,633,79,99,107,0,,0,0.0,0.0,0.0,0.0,0.0
2024,2,12,1,2024-02-12,AS,4756,STL,ATL,"St. Louis, MO",Missouri,"Atlanta, GA",Georgia,924,2291,-4,-10,920,2281,16,18,936,2263,1371,180,200,214,0,,0,0.0,0.0,0.0,0.0,0.0
2024,3,24,7,2024-03-24,OH,2765,ATL,CLT,"Atlanta, GA",Georgia,"Charlotte, NC",North Carolina,1286,1554,-21,-20,1265,1534,7,17,1272,1517,572,75,95,99,0,,0,0.0,0.0,0.0,0.0,0.0
2024,7,9,2,2024-07-09,NK,7231,SLC,DFW,"Salt Lake City, UT",Utah,"Dallas/Fort Worth, TX",Texas,1530,977,-1,0,1529,977,14,7,1543,970,1249,157,177,178,0,,0,0.0,0.0,0.0,0.0,0.0
2024,2,20,2,2024-02-20,HA,5035,DEN,STL,"Denver, CO",Colorado,"St. Louis, MO",Missouri,994,892,-3,0,991,892,8,19,999,873,499,57,77,84,0,,0,0.0,0.0,0.0,0.0,0.0
2024,7,28,7,2024-07-28,MQ,515,TPA,CLT,"Tampa, FL",Florida,"Charlotte, NC",North Carolina,1238,1909,0,0,1238,1909,11,10,1249,1899,463,47,67,68,0,,0,0.0,0.0,0.0,0.0,0.0
2024,5,5,7,2024-05-05,9E,807,BOS,LAX,"Boston, MA",Massachusetts,"Los Angeles, CA",California,1266,959,7,0,1273,959,15,9,1288,950,2946,360,380,384,0,,0,0.0,0.0,0.0,0.0,0.0
2024,3,9,6,2024-03-09,YX,7888,SAN,MDW,"San Diego, CA",California,"Chicago, IL",Illinois,2271,2209,12,10,2283,2219,21,9,2304,2210,2247,281,301,311,0,,0,0.0,0.0,0.0,0.0,0.0
2024,9,21,6,2024-09-21,NK,2784,SAN,MIA,"San Diego, CA",California,"Miami, FL",Florida,1877,1123,4,-5,1881,1118,24,15,1905,1103,2991,378,398,417,0,,0,0.0,0.0,0.0,0.0,0.0
2024,9,14,6,2024-09-14,NK,7594,PHL,LAX,"Philadelphia, PA",Pennsylvania,"Los Angeles, CA",California,1195,1960,5,0,1200,1960,19,5,1219,1955,727,80,100,104,0,,0,0.0,0.0,0.0,0.0,0.0
2024,7,6,6,2024-07-06,NK,3466,HNL,SEA,"Honolulu, HI",Hawaii,"Seattle, WA",Washington,698,1223,8,5,706,1228,21,8,727,1220,1072,138,158,167,0,,0,0.0,0.0,0.0,0.0,0.0
2024,8,17,6,2024-08-17,OO,3603,TPA,SFO,"Tampa, FL",Florida,"San Francisco, CA",California,1214,2165,-9,-10,1205,2155,18,18,1223,2137,2962,363,383,399,0,,0,0.0,0.0,0.0,0.0,0.0
2024,7,7,7,2024-07-07,MQ,4542,MDW,SEA,"Chicago, IL",Illinois,"Seattle, WA",Washington,934,1659,17,15,951,1674,25,12,976,1662,2812,353,373,390,0,,1,0.0,0.0,0.0,0.0,0.0
2024,1,10,3,2024-01-10,MQ,6280,MSP,BWI,"Minneapolis, MN",Minnesota,"Baltimore, MD",Maryland,1659,2111,7,5,1666,2116,16,4,1682,2112,2800,351,371,371,0,,0,0.0,0.0,0.0,0.0,0.0
2024,4,23,2,2024-04-23,NK,2659,DEN,CLT,"Denver, CO",Colorado,"Charlotte, NC",North Carolina,787,2002,-10,-15,777,1987,22,15,799,1972,2764,344,364,381,0,,0,0.0,0.0,0.0,0.0,0.0
2024,3,16,6,2024-03-16,UA,8237,DTW,STL,"Detroit, MI",Michigan,"St. Louis, MO",Missouri,2181,943,0,10,2181,953,29,9,2210,944,202,16,36,54,0,,0,0.0,0.0,0.0,0.0,0.0
2024,6,12,3,2024-06-12,HA,4071,MIA,LAS,"Miami, FL",Florida,"Las Vegas, NV",Nevada,1218,1853,16,15,1234,1868,17,15,1251,1853,2708,345,365,377,0,,0,0.0,0.0,0.0,0.0,0.0
2024,3,25,1,2024-03-25,YX,3057,MDW,MSP,"Chicago, IL",Illinois,"Minneapolis, MN",Minnesota,1066,1217,3,5,1069,1222,23,11,1092,1211,1807,223,243,257,0,,0,0.0,0.0,0.0,0.0,0.0
2024,2,18,7,2024-02-18,UA,7016,LAX,STL,"Los Angeles, CA",California,"St. Louis, MO",Missouri,1310,1174,-3,-5,1307,1169,9,4,1316,1165,1507,189,209,202,0,,0,0.0,0.0,0.0,0.0,0.0
2024,11,21,4,2024-11-21,NK,1829,SAN,STL,"San Diego, CA",California,"St. Louis, MO",Missouri,907,996,47,45,954,1041,16,10,970,1031,365,52,72,78,0,,0,1.0,10.0,6.0,0.0,28.0
2024,6,25,2,2024-06-25,OH,9333,EWR,LAS,"Newark, NJ",New Jersey,"Las Vegas, NV",Nevada,1416,1020,-18,-15,1398,1005,12,10,1410,995,777,100,120,122,0,,0,0.0,0.0,0.0,0.0,0.0
2024,8,5,1,2024-08-05,DL,126,SEA,BOS,"Seattle, WA",Washington,"Boston, MA",Massachusetts,1409,2179,7,0,1416,2179,12,10,1428,2169,2565,316,336,338,0,,1,0.0,0.0,0.0,0.0,0.0
2024,7,7,7,2024-07-07,OH,2683,STL,IAH,"St. Louis, MO",Missouri,"Houston, TX",Texas,2285,1260,-3,-10,2282,1250,13,4,2295,1246,986,124,144,141,0,,0,0.0,0.0,0.0,0.0,0.0
2024,12,11,3,2024-12-11,DL,9344,TPA,PDX,"Tampa, FL",Florida,"Portland, OR",Oregon,1216,1001,-7,-5,1209,996,23,17,1232,979,2905,360,380,400,0,,0,0.0,0.0,0.0,0.0,0.0
2024,8,17,6,2024-08-17,UA,9966,DCA,PHL,"Washington, DC",District of Columbia,"Philadelphia, PA",Pennsylvania,1324,2111,5,15,1329,2126,23,5,1352,2121,261,36,56,64,0,,0,0.0,0.0,0.0,0.0,0.0
2024,9,11,3,2024-09-11,OH,3155,DFW,LGA,"Dallas/Fort Worth, TX",Texas,"New York, NY",New York,2227,645,1,5,2228,650,8,16,2236,634,2285,285,305,309,0,,0,0.0,0.0,0.0,0.0,0.0
2024,8,23,5,2024-08-23,WN,6901,DEN,PDX,"Denver, CO",Colorado,"Portland, OR",Oregon,1859,1286,7,5,1866,1291,10,4,1876,1287,671,74,94,88,0,,0,0.0,0.0,0.0,0.0,0.0
2024,1,26,5,2024-01-26,AS,1758,PDX,MDW,"Portland, OR",Oregon,"Chicago, IL",Illinois,1525,753,-1,-5,1524,748,27,7,1551,741,1518,185,205,219,0,,0,0.0,0.0,0.0,0.0,0.0
2024,3,12,2,2024-03-12,MQ,4051,CLT,DFW,"Charlotte, NC",North Carolina,"Dallas/Fort Worth, TX",Texas,684,860,6,15,690,875,16,11,706,864,927,119,139,146,0,,0,0.0,0.0,0.0,0.0,0.0
2024,9,17,2,2024-09-17,F9,7399,MCO,PDX,"Orlando, FL",Florida,"Portland, OR",Oregon,1173,1244,-8,-5,1165,1239,5,10,1170,1229,2815,353,373,368,0,,0,0.0,0.0,0.0,0.0,0.0
2024,9,10,2,2024-09-10,9E,7556,CLT,ORD,"Charlotte, NC",North Carolina,"Chicago, IL",Illinois,2084,886,-11,-20,2073,866,22,4,2095,862,2686,337,357,363,0,,0,0.0,0.0,0.0,0.0,0.0
2024,9,27,5,2024-09-27,9E,4237,EWR,TPA,"Newark, NJ",New Jersey,"Tampa, FL",Florida,1101,2291,-6,0,1095,2291,23,6,1118,2285,1602,196,216,225,0,,0,0.0,0.0,0.0,0.0,0.0
2024,5,2,4,2024-05-02,NK,8031,ATL,TPA,"Atlanta, GA",Georgia,"Tampa, FL",Florida,1961,1444,-7,-5,1954,1439,21,4,1975,1435,2987,372,392,397,0,,0,0.0,0.0,0.0,0.0,0.0
2024,5,23,4,2024-05-23,WN,1814,SEA,LAX,"Seattle, WA",Washington,"Los Angeles, CA",California,1262,1954,-4,-10,1258,1944,7,14,1265,1930,2391,301,321,322,0,,0,0.0,0.0,0.0,0.0,0.0
2024,9,13,5,2024-09-13,DL,3431,MIA,IAH,"Miami, FL",Florida,"Houston, TX",Texas,521,1238,18,15,539,1253,8,8,547,1245,2858,361,381,377,0,,0,0.0,0.0,0.0,0.0,0.0
2024,5,23,4,2024-05-23,DL,3447,PHL,LGA,"Philadelphia, PA",Pennsylvania,"New York, NY",New York,711,1304,-2,0,709,1304,18,4,727,1300,334,40,60,62,0,,0,0.0,0.0,0.0,0.0,0.0
2024,9,15,7,2024-09-15,HA,2086,IAH,DCA,"Houston, TX",Texas,"Washington, DC",District of Columbia,976,2095,19,15,995,2110,10,14,1005,2096,1155,142,162,166,0,,0,0.0,0.0,0.0,0.0,0.0
2024,2,16,5,2024-02-16,WN,3644,SAN,MCO,"San Diego, CA",California,"Orlando, FL",Florida,965,1892,9,0,974,1892,9,5,983,1887,234,26,46,40,0,,0,0.0,0.0,0.0,0.0,0.0
2024,12,16,1,2024-12-16,AS,7079,DCA,ORD,"Washington, DC",District of Columbia,"Chicago, IL",Illinois,1488,2257,-25,-15,1463,2242,10,17,1473,2225,1518,188,208,215,0,,0,0.0,0.0,0.0,0.0,0.0
2024,1,13,6,2024-01-13,UA,801,SFO,MSP,"San Francisco, CA",California,"Minneapolis, MN",Minnesota,1757,2281,-18,-20,1739,2261,17,19,1756,2242,1111,143,163,179,0,,0,0.0,0.0,0.0,0.0,0.0
2024,7,26,5,2024-07-26,AS,7837,SFO,IAH,"San Francisco, CA",California,"Houston, TX",Texas,671,2287,14,15,685,2302,13,16,698,2286,855,104,124,133,0,,0,0.0,0.0,0.0,0.0,0.0
2024,11,6,3,2024-11-06,B6,9746,BWI,CLT,"Baltimore, MD",Maryland,"Charlotte, NC",North Carolina,2126,756,-19,-20,2107,736,21,4,2128,732,2143,257,277,282,0,,0,0.0,0.0,0.0,0.0,0.0
2024,8,22,4,2024-08-22,B6,3886,DCA,LAS,"Washington, DC",District of Columbia,"Las Vegas, NV",Nevada,1174,2291,3,0,1177,2291,19,16,1196,2275,597,74,94,109,0,,0,0.0,0.0,0.0,0.0,0.0
2024,5,28,2,2024-05-28,DL,7362,DTW,BWI,"Detroit, MI",Michigan,"Baltimore, MD",Maryland,1296,1213,-15,-10,1281,1203,19,6,1300,1197,1239,145,165,170,0,,0,0.0,0.0,0.0,0.0,0.0
2024,11,17,7,2024-11-17,F9,2571,SLC,ATL,"Salt Lake City, UT",Utah,"Atlanta, GA",Georgia,2041,1028,5,5,2046,1033,23,16,2069,1017,1511,185,205,224,0,,0,0.0,0.0,0.0,0.0,0.0
2024,6,3,1,2024-06-03,B6,5114,MDW,SLC,"Chicago, IL",Illinois,"Salt Lake City, UT",Utah,743,1581,-14,-10,729,1571,12,13,741,1558,1659,202,222,227,0,,0,0.0,0.0,0.0,0.0,0.0
2024,6,14,5,2024-06-14,OO,6759,LGA,ORD,"New York, NY",New York,"Chicago, IL",Illinois,920,1451,-11,-20,909,1431,13,14,922,1417,2062,247,267,274,0,,0,0.0,0.0,0.0,0.0,0.0
2024,3,30,6,2024-03-30,DL,4360,BWI,DFW,"Baltimore, MD",Maryland,"Dallas/Fort Worth, TX",Texas,878,1875,-2,5,876,1880,6,15,882,1865,1310,163,183,184,0,,0,0.0,0.0,0.0,0.0,0.0
2024,7,4,4,2024-07-04,NK,5645,IAD,STL,"Washington, DC",District of Columbia,"St. Louis, MO",Missouri,1996,866,-4,-5,1992,861,18,13,2010,848,2505,312,332,343,0,,0,0.0,0.0,0.0,0.0,0.0
2024,11,13,3,2024-11-13,MQ,3144,PDX,SFO,"Portland, OR",Oregon,"San Francisco, CA",California,840,658,-9,0,831,658,18,19,849,639,1639,210,230,247,0,,0,0.0,0.0,0.0,0.0,0.0
2024,12,23,1,2024-12-23,HA,3983,PHL,BOS,"Philadelphia, PA",Pennsylvania,"Boston, MA",Massachusetts,1453,1216,14,5,1467,1221,9,6,1476,1215,1266,164,184,179,0,,0,0.0,0.0,0.0,0.0,0.0
2024,6,22,6,2024-06-22,G4,3040,PHL,SLC,"Philadelphia, PA",Pennsylvania,"Salt Lake City, UT",Utah,1170,2182,8,5,1178,2187,7,18,1185,2169,925,123,143,148,0,,0,0.0,0.0,0.0,0.0,0.0
2024,8,4,7,2024-08-04,G4,5261,DTW,SFO,"Detroit, MI",Michigan,"San Francisco, CA",California,622,2223,-7,-5,615,2218,14,8,629,2210,2265,278,298,300,0,,0,0.0,0.0,0.0,0.0,0.0
2024,9,20,5,2024-09-20,AA,1920,PHX,PDX,"Phoenix, AZ",Arizona,"Portland, OR",Oregon,1371,770,8,5,1379,775,6,8,1385,767,2357,301,321,315,0,,0,0.0,0.0,0.0,0.0,0.0
2024,4,6,6,2024-04-06,NK,6984,SFO,IAH,"San Francisco, CA",California,"Houston, TX",Texas,933,2287,10,15,943,2302,17,9,960,2293,286,35,55,61,0,,0,0.0,0.0,0.0,0.0,0.0
2024,4,26,5,2024-04-26,G4,2902,JFK,LGA,"New York, NY",New York,"New York, NY",New York,687,2311,-6,0,681,2311,15,17,696,2294,418,51,71,83,0,,0,0.0,0.0,0.0,0.0,0.0
2024,7,17,3,2024-07-17,AS,2563,DTW,DCA,"Detroit, MI",Michigan,"Washington, DC",District of Columbia,1537,1942,14,5,1551,1947,15,11,1566,1936,597,66,86,92,0,,0,0.0,0.0,0.0,0.0,0.0
2024,11,15,5,2024-11-15,AA,3471,PHX,JFK,"Phoenix, AZ",Arizona,"New York, NY",New York,569,1256,18,10,587,1266,13,7,600,1259,921,121,141,141,0,,0,0.0,0.0,0.0,0.0,0.0
2024,1,21,7,2024-01-21,DL,7322,LAX,IAH,"Los Angeles, CA",California,"Houston, TX",Texas,1150,1436,17,10,1167,1446,25,4,1192,1442,2911,367,387,396,0,,0,0.0,0.0,0.0,0.0,0.0
2024,7,18,4,2024-07-18,WN,8627,EWR,PHL,"Newark, NJ",New Jersey,"Philadelphia, PA",Pennsylvania,1934,1623,-9,-5,1925,1618,13,4,1938,1614,570,70,90,87,0,,0,0.0,0.0,0.0,0.0,0.0
2024,12,6,5,2024-12-06,OH,5076,MSP,ATL,"Minneapolis, MN",Minnesota,"Atlanta, GA",Georgia,1336,1421,35,45,1371,1466,16,10,1387,1456,870,112,132,138,0,,0,10.0,11.0,0.0,0.0,24.0
2024,9,4,3,2024-09-04,WN,5167,PHL,MCO,"Philadelphia, PA",Pennsylvania,"Orlando, FL",Florida,1090,1333,-11,-20,1079,1313,5,10,1084,1303,1564,200,220,215,0,,0,0.0,0.0,0.0,0.0,0.0
2024,10,2,3,2024-10-02,DL,7601,MCO,CLT,"Orlando, FL",Florida,"Charlotte, NC",North Carolina,817,997,28,30,845,1027,24,7,869,1020,682,94,114,125,0,,0,2.0,4.0,0.0,0.0,24.0
2024,9,20,5,2024-09-20,F9,2888,SEA,MIA,"Seattle, WA",Washington,"Miami, FL",Florida,936,1638,-13,-10,923,1628,21,18,944,1610,902,107,127,146,0,,0,0.0,0.0,0.0,0.0,0.0
2024,2,27,2,2024-02-27,DL,4225,CLT,BWI,"Charlotte, NC",North Carolina,"Baltimore, MD",Maryland,2115,1568,-5,-5,2110,1563,9,13,2119,1550,1735,217,237,239,0,,0,0.0,0.0,0.0,0.0,0.0
2024,10,28,1,2024-10-28,UA,3706,SAN,PHX,"San Diego, CA",California,"Phoenix, AZ",Arizona,1669,1061,6,10,1675,1071,16,16,1691,1055,984,120,140,152,0,,0,0.0,0.0,0.0,0.0,0.0
2024,1,31,3,2024-01-31,OH,1640,EWR,LAS,"Newark, NJ",New Jersey,"Las Vegas, NV",Nevada,2260,737,-4,-10,2256,727,15,10,2271,717,459,60,80,85,0,,0,0.0,0.0,0.0,0.0,0.0
2024,9,5,4,2024-09-05,WN,8866,LGA,HNL,"New York, NY",New York,"Honolulu, HI",Hawaii,726,1361,-6,-10,720,1351,25,12,745,1339,1358,162,182,199,0,,0,0.0,0.0,0.0,0.0,0.0
2024,4,2,2,2024-04-02,G4,320,MSP,BOS,"Minneapolis, MN",Minnesota,"Boston, MA",Massachusetts,1905,749,-3,0,1902,749,20,13,1922,736,1116,148,168,181,0,,0,0.0,0.0,0.0,0.0,0.0
2024,9,21,6,2024-09-21,9E,5022,DTW,PHL,"Detroit, MI",Michigan,"Philadelphia, PA",Pennsylvania,679,1462,14,5,693,1467,11,9,704,1458,1283,151,171,171,0,,0,0.0,0.0,0.0,0.0,0.0
2024,9,27,5,2024-09-27,AA,5713,MSP,PHX,"Minneapolis, MN",Minnesota,"Phoenix, AZ",Arizona,1035,1380,-19,-20,1016,1360,27,10,1043,1350,2242,272,292,309,0,,0,0.0,0.0,0.0,0.0,0.0
2024,4,3,3,2024-04-03,F9,853,HNL,MCO,"Honolulu, HI",Hawaii,"Orlando, FL",Florida,1622,1192,-6,0,1616,1192,12,17,1628,1175,2501,319,339,348,0,,0,0.0,0.0,0.0,0.0,0.0
2024,6,2,7,2024-06-02,YX,7588,SFO,MSP,"San Francisco, CA",California,"Minneapolis, MN",Minnesota,1914,2200,-3,0,1911,2200,26,18,1937,2182,1045,131,151,175,0,,0,0.0,0.0,0.0,0.0,0.0
2024,10,11,5,2024-10-11,HA,7306,MSP,TPA,"Minneapolis, MN",Minnesota,"Tampa, FL",Florida,769,2277,-16,-10,753,2267,23,13,776,2254,1779,220,240,256,0,,0,0.0,0.0,0.0,0.0,0.0
2024,3,20,3,2024-03-20,OH,9312,IAD,SLC,"Washington, DC",District of Columbia,"Salt Lake City, UT",Utah,1445,899,3,0,1448,899,29,9,1477,890,930,125,145,163,0,,0,0.0,0.0,0.0,0.0,0.0
2024,10,18,5,2024-10-18,B6,9780,BOS,IAD,"Boston, MA",Massachusetts,"Washington, DC",District of Columbia,1617,2046,-17,-10,1600,2036,19,18,1619,2018,1645,206,226,243,0,,0,0.0,0.0,0.0,0.0,0.0
2024,3,24,7,2024-03-24,NK,8038,SEA,PHX,"Seattle, WA",Washington,"Phoenix, AZ",Arizona,1986,2042,-1,-5,1985,2037,9,10,1994,2027,222,29,49,48,0,,0,0.0,0.0,0.0,0.0,0.0
2024,12,30,1,2024-12-30,F9,2061,LAX,IAH,"Los Angeles, CA",California,"Houston, TX",Texas,1158,1358,14,5,1172,1363,13,10,1185,1353,657,74,94,97,0,,0,0.0,0.0,0.0,0.0,0.0
2024,2,6,2,2024-02-06,HA,6058,MIA,JFK,"Miami, FL",Florida,"New York, NY",New York,784,1484,9,10,793,1494,25,15,818,1479,2613,333,353,373,0,,0,0.0,0.0,0.0,0.0,0.0
2024,12,7,6,2024-12-07,B6,3583,LAX,LAS,"Los Angeles, CA",California,"Las Vegas, NV",Nevada,1545,1816,6,0,1551,1816,23,12,1574,1804,388,51,71,86,0,,0,0.0,0.0,0.0,0.0,0.0
2024,11,22,5,2024-11-22,F9,6735,IAD,STL,"Washington, DC",District of Columbia,"St. Louis, MO",Missouri,501,1906,-22,-15,479,1891,17,12,496,1879,348,49,69,78,0,,0,0.0,0.0,0.0,0.0,0.0
2024,8,19,1,2024-08-19,9E,8729,IAD,MCO,"Washington, DC",District of Columbia,"Orlando, FL",Florida,602,1877,-5,5,597,1882,11,3,608,1879,1721,206,226,220,0,,0,0.0,0.0,0.0,0.0,0.0
2024,4,2,2,2024-04-02,OO,8770,MIA,PDX,"Miami, FL",Florida,"Portland, OR",Oregon,1559,1103,5,10,1564,1113,29,7,1593,1106,2378,306,326,342,0,,0,0.0,0.0,0.0,0.0,0.0
2024,12,1,7,2024-12-01,F9,882,ORD,DEN,"Chicago, IL",Illinois,"Denver, CO",Colorado,773,2308,-3,0,770,2308,5,5,775,2303,759,94,114,104,0,,0,0.0,0.0,0.0,0.0,0.0
2024,4,11,4,2024-04-11,G4,5203,LGA,SFO,"New York, NY",New York,"San Francisco, CA",California,1574,1936,-7,0,1567,1936,7,11,1574,1925,1360,171,191,189,0,,0,0.0,0.0,0.0,0.0,0.0
2024,6,14,5,2024-06-14,DL,4267,SAN,PHX,"San Diego, CA",California,"Phoenix, AZ",Arizona,1666,1901,48,45,1714,1946,11,10,1725,1936,2741,351,371,372,0,,0,5.0,4.0,1.0,1.0,34.0
2024,6,7,5,2024-06-07,UA,319,SAN,DEN,"San Diego, CA",California,"Denver, CO",Colorado,1395,1401,-9,0,1386,1401,13,18,1399,1383,2966,366,386,397,0,,0,0.0,0.0,0.0,0.0,0.0
2024,1,14,7,2024-01-14,AA,9319,DTW,MSP,"Detroit, MI",Michigan,"Minneapolis, MN",Minnesota,2006,1417,4,10,2010,1427,8,12,2018,1415,890,114,134,134,0,,0,0.0,0.0,0.0,0.0,0.0
2024,8,12,1,2024-08-12,WN,8129,LGA,IAD,"New York, NY",New York,"Washington, DC",District of Columbia,516,909,4,0,520,909,25,16,545,893,1673,214,234,255,0,,0,0.0,0.0,0.0,0.0,0.0
2024,3,13,3,2024-03-13,HA,7246,SEA,DTW,"Seattle, WA",Washington,"Detroit, MI",Michigan,2112,1809,-2,-10,2110,1799,12,7,2122,1792,1439,187,207,206,0,,0,0.0,0.0,0.0,0.0,0.0
2024,9,5,4,2024-09-05,HA,389,BWI,IAD,"Baltimore, MD",Maryland,"Washington, DC",District of Columbia,1801,1847,-7,-10,1794,1837,24,8,1818,1829,2196,277,297,309,0,,0,0.0,0.0,0.0,0.0,0.0
2024,3,31,7,2024-03-31,B6,479,TPA,HNL,"Tampa, FL",Florida,"Honolulu, HI",Hawaii,2158,1173,1,5,2159,1178,22,10,2181,1168,2079,252,272,284,0,,0,0.0,0.0,0.0,0.0,0.0
2024,8,3,6,2024-08-03,OO,9670,DCA,MCO,"Washington, DC",District of Columbia,"Orlando, FL",Florida,1961,2045,-2,0,1959,2045,27,13,1986,2032,1721,213,233,253,0,,0,0.0,0.0,0.0,0.0,0.0
2024,3,30,6,2024-03-30,AA,6986,MDW,DEN,"Chicago, IL",Illinois,"Denver, CO",Colorado,935,1195,-15,-5,920,1190,6,10,926,1180,906,109,129,125,0,,0,0.0,0.0,0.0,0.0,0.0
2024,1,29,1,2024-01-29,F9,2058,PDX,IAH,"Portland, OR",Oregon,"Houston, TX",Texas,1907,626,-11,-20,1896,606,18,15,1914,591,2453,313,333,346,0,,0,0.0,0.0,0.0,0.0,0.0
2024,10,31,4,2024-10-31,DL,8357,LAX,MDW,"Los Angeles, CA",California,"Chicago, IL",Illinois,1357,980,9,10,1366,990,10,3,1376,987,1889,234,254,247,0,,0,0.0,0.0,0.0,0.0,0.0
2024,8,7,3,2024-08-07,AA,2283,SEA,IAH,"Seattle, WA",Washington,"Houston, TX",Texas,1185,1943,10,10,1195,1953,11,19,1206,1934,2564,318,338,348,0,,0,0.0,0.0,0.0,0.0,0.0
2024,11,23,6,2024-11-23,DL,3874,MSP,MDW,"Minneapolis, MN",Minnesota,"Chicago, IL",Illinois,1655,730,1,0,1656,730,28,18,1684,712,904,104,124,150,0,,0,0.0,0.0,0.0,0.0,0.0
2024,8,2,5,2024-08-02,HA,4019,ATL,LAS,"Atlanta, GA",Georgia,"Las Vegas, NV",Nevada,762,1238,-5,5,757,1243,25,11,782,1232,292,42,62,78,0,,0,0.0,0.0,0.0,0.0,0.0
2024,8,8,4,2024-08-08,MQ,6302,ORD,MCO,"Chicago, IL",Illinois,"Orlando, FL",Florida,893,1619,-13,-10,880,1609,5,10,885,1599,723,94,114,109,0,,0,0.0,0.0,0.0,0.0,0.0
2024,2,11,7,2024-02-11,B6,877,CLT,PHX,"Charlotte, NC",North Carolina,"Phoenix, AZ",Arizona,707,2146,-5,0,702,2146,20,3,722,2143,1484,186,206,209,0,,0,0.0,0.0,0.0,0.0,0.0
2024,5,14,2,2024-05-14,G4,2666,ORD,TPA,"Chicago, IL",Illinois,"Tampa, FL",Florida,1307,1903,-4,-5,1303,1898,7,10,1310,1888,1539,196,216,213,0,,0,0.0,0.0,0.0,0.0,0.0
2024,2,11,7,2024-02-11,G4,7504,MDW,SFO,"Chicago, IL",Illinois,"San Francisco, CA",California,1749,884,3,5,1752,889,29,7,1781,882,1018,133,153,169,0,,0,0.0,0.0,0.0,0.0,0.0
2024,6,12,3,2024-06-12,DL,178,CLT,BOS,"Charlotte, NC",North Carolina,"Boston, MA",Massachusetts,2224,1820,-7,0,2217,1820,19,9,2236,1811,432,56,76,84,0,,0,0.0,0.0,0.0,0.0,0.0
2024,12,26,4,2024-12-26,DL,1681,DCA,JFK,"Washington, DC",District of Columbia,"New York, NY",New York,964,1336,-5,0,959,1336,26,18,985,1318,1806,224,244,268,0,,0,0.0,0.0,0.0,0.0,0.0
2024,10,9,3,2024-10-09,UA,8067,JFK,EWR,"New York, NY",New York,"Newark, NJ",New Jersey,857,1898,-18,-10,839,1888,15,14,854,1874,1038,137,157,166,0,,0,0.0,0.0,0.0,0.0,0.0
2024,2,27,2,2024-02-27,NK,7939,ATL,MSP,"Atlanta, GA",Georgia,"Minneapolis, MN",Minnesota,1667,1691,-29,-20,1638,1671,9,6,1647,1665,2343,297,317,312,0,,0,0.0,0.0,0.0,0.0,0.0
2024,10,28,1,2024-10-28,OO,2262,LAX,DFW,"Los Angeles, CA",California,"Dallas/Fort Worth, TX",Texas,853,832,22,15,875,847,21,15,896,832,1350,160,180,196,0,,0,0.0,0.0,0.0,0.0,0.0
2024,11,17,7,2024-11-17,UA,9277,SEA,PHX,"Seattle, WA",Washington,"Phoenix, AZ",Arizona,1774,1210,-26,-20,1748,1190,20,13,1768,1177,1123,143,163,176,0,,0,0.0,0.0,0.0,0.0,0.0
2024,1,25,4,2024-01-25,AA,1585,DTW,IAD,"Detroit, MI",Michigan,"Washington, DC",District of Columbia,875,821,-9,-10,866,811,24,18,890,793,1219,142,162,184,0,,0,0.0,0.0,0.0,0.0,0.0
2024,3,13,3,2024-03-13,OH,5845,MDW,BWI,"Chicago, IL",Illinois,"Baltimore, MD",Maryland,1488,1052,-14,-5,1474,1047,25,14,1499,1033,2209,283,303,322,0,,0,0.0,0.0,0.0,0.0,0.0
2024,5,8,3,2024-05-08,OH,2720,LGA,DTW,"New York, NY",New York,"Detroit, MI",Michigan,1768,2259,-11,-5,1757,2254,22,16,1779,2238,424,49,69,87,0,,0,0.0,0.0,0.0,0.0,0.0
2024,3,27,3,2024-03-27,OH,1064,JFK,PHL,"New York, NY",New York,"Philadelphia, PA",Pennsylvania,517,903,7,0,524,903,9,18,533,885,2832,354,374,381,0,,0,0.0,0.0,0.0,0.0,0.0
2024,11,25,1,2024-11-25,AS,9120,HNL,MSP,"Honolulu, HI",Hawaii,"Minneapolis, MN",Minnesota,2238,1535,-5,0,2233,1535,23,10,2256,1525,1642,198,218,231,0,,0,0.0,0.0,0.0,0.0,0.0
2024,6,1,6,2024-06-01,UA,2773,EWR,PHX,"Newark, NJ",New Jersey,"Phoenix, AZ",Arizona,1215,2237,-10,-10,1205,2227,12,5,1217,2222,2957,361,381,378,0,,0,0.0,0.0,0.0,0.0,0.0
2024,6,30,7,2024-06-30,AA,5393,SLC,IAH,"Salt Lake City, UT",Utah,"Houston, TX",Texas,984,2023,-19,-15,965,2008,18,9,983,1999,2187,263,283,290,0,,0,0.0,0.0,0.0,0.0,0.0
2024,5,4,6,2024-05-04,OH,7359,DFW,HNL,"Dallas/Fort Worth, TX",Texas,"Honolulu, HI",Hawaii,1525,1943,-10,-15,1515,1928,15,12,1530,1916,1050,132,152,159,0,,0,0.0,0.0,0.0,0.0,0.0
2024,3,7,4,2024-03-07,MQ,1818,PHL,STL,"Philadelphia, PA",Pennsylvania,"St. Louis, MO",Missouri,1449,863,-3,0,1446,863,19,13,1465,850,2445,304,324,336,0,,0,0.0,0.0,0.0,0.0,0.0
2024,1,6,6,2024-01-06,WN,1328,CLT,SFO,"Charlotte, NC",North Carolina,"San Francisco, CA",California,875,964,2,10,877,974,5,3,882,971,296,33,53,41,0,,0,0.0,0.0,0.0,0.0,0.0
2024,5,4,6,2024-05-04,MQ,3878,SFO,HNL,"San Francisco, CA",California,"Honolulu, HI",Hawaii,1413,2012,-15,-15,1398,1997,24,13,1422,1984,2984,368,388,405,0,,0,0.0,0.0,0.0,0.0,0.0
2024,11,9,6,2024-11-09,AA,1940,IAH,SFO,"Houston, TX",Texas,"San Francisco, CA",California,1065,1341,14,5,1079,1346,16,7,1095,1339,2552,328,348,351,0,,0,0.0,0.0,0.0,0.0,0.0
2024,11,21,4,2024-11-21,AA,597,CLT,PHL,"Charlotte, NC",North Carolina,"Philadelphia, PA",Pennsylvania,1689,2258,13,5,1702,2263,15,15,1717,2248,2251,287,307,317,0,,0,0.0,0.0,0.0,0.0,0.0
2024,2,22,4,2024-02-22,YX,636,ORD,TPA,"Chicago, IL",Illinois,"Tampa, FL",Florida,1364,1850,-10,-10,1354,1840,19,18,1373,1822,1948,250,270,287,0,,0,0.0,0.0,0.0,0.0,0.0
2024,3,6,3,2024-03-06,DL,3405,PDX,DTW,"Portland, OR",Oregon,"Detroit, MI",Michigan,1852,1055,3,5,1855,1060,13,13,1868,1047,2275,286,306,312,0,,0,0.0,0.0,0.0,0.0,0.0
2024,11,9,6,2024-11-09,9E,7224,EWR,SLC,"Newark, NJ",New Jersey,"Salt Lake City, UT",Utah,2178,2288,6,5,2184,2293,16,7,2200,2286,2311,286,306,309,0,,0,0.0,0.0,0.0,0.0,0.0
2024,3,22,5,2024-03-22,F9,9456,LAX,IAD,"Los Angeles, CA",California,"Washington, DC",District of Columbia,1971,1928,10,5,1981,1933,5,8,1986,1925,783,87,107,100,0,,0,0.0,0.0,0.0,0.0,0.0
2024,3,27,3,2024-03-27,DL,2071,MIA,DCA,"Miami, FL",Florida,"Washington, DC",District of Columbia,1615,1104,4,10,1619,1114,26,5,1645,1109,1363,163,183,194,0,,0,0.0,0.0,0.0,0.0,0.0
2024,1,2,2,2024-01-02,OO,7687,IAD,DFW,"Washington, DC",District of Columbia,"Dallas/Fort Worth, TX",Texas,2043,927,-14,-5,2029,922,26,4,2055,918,1393,177,197,207,0,,0,0.0,0.0,0.0,0.0,0.0
2024,7,22,1,2024-07-22,DL,3627,ATL,SFO,"Atlanta, GA",Georgia,"San Francisco, CA",California,1775,2284,-11,-10,1764,2274,6,8,1770,2266,1467,191,211,205,0,,0,0.0,0.0,0.0,0.0,0.0
2024,5,29,3,2024-05-29,HA,399,SAN,LAS,"San Diego, CA",California,"Las Vegas, NV",Nevada,1111,1418,-9,0,1102,1418,21,12,1123,1406,2019,250,270,283,0,,0,0.0,0.0,0.0,0.0,0.0
2024,10,19,6,2024-10-19,OO,2486,CLT,PHL,"Charlotte, NC",North Carolina,"Philadelphia, PA",Pennsylvania,1562,2144,-22,-15,1540,2129,5,8,1545,2121,1927,238,258,251,0,,0,0.0,0.0,0.0,0.0,0.0
2024,4,12,5,2024-04-12,OO,4063,HNL,LAX,"Honolulu, HI",Hawaii,"Los Angeles, CA",California,935,1943,0,-5,935,1938,14,4,949,1934,2029,256,276,274,0,,0,0.0,0.0,0.0,0.0,0.0
2024,1,24,3,2024-01-24,9E,4787,TPA,MIA,"Tampa, FL",Florida,"Miami, FL",Florida,1147,1335,5,10,1152,1345,17,19,1169,1326,295,40,60,76,0,,0,0.0,0.0,0.0,0.0,0.0
2024,7,30,2,2024-07-30,9E,4271,STL,DCA,"St. Louis, MO",Missouri,"Washington, DC",District of Columbia,861,1091,-1,0,860,1091,19,3,879,1088,1794,215,235,237,0,,0,0.0,0.0,0.0,0.0,0.0
2024,3,5,2,2024-03-05,F9,3959,PDX,JFK,"Portland, OR",Oregon,"New York, NY",New York,1061,1060,-9,-5,1052,1055,9,3,1061,1052,2845,359,379,371,0,,0,0.0,0.0,0.0,0.0,0.0
2024,7,27,6,2024-07-27,YX,9205,EWR,DEN,"Newark, NJ",New Jersey,"Denver, CO",Colorado,582,2158,-16,-10,566,2148,15,8,581,2140,1785,231,251,254,0,,0,0.0,0.0,0.0,0.0,0.0
2024,9,7,6,2024-09-07,AS,3795,PDX,BWI,"Portland, OR",Oregon,"Baltimore, MD",Maryland,2289,2067,-8,-10,2281,2057,25,19,2306,2038,1932,244,264,288,0,,0,0.0,0.0,0.0,0.0,0.0
2024,4,26,5,2024-04-26,YX,9212,DEN,DCA,"Denver, CO",Colorado,"Washington, DC",District of Columbia,2231,2066,-12,-10,2219,2056,11,4,2230,2052,1475,179,199,194,0,,0,0.0,0.0,0.0,0.0,0.0
2024,4,25,4,2024-04-25,OO,9815,PHL,STL,"Philadelphia, PA",Pennsylvania,"St. Louis, MO",Missouri,1550,2327,8,10,1558,2337,29,19,1587,2318,1602,205,225,253,0,,0,0.0,0.0,0.0,0.0,0.0
2024,8,24,6,2024-08-24,WN,7342,HNL,TPA,"Honolulu, HI",Hawaii,"Tampa, FL",Florida,2112,1850,34,30,2146,1880,8,18,2154,1862,2226,275,295,301,0,,0,7.0,4.0,5.0,0.0,14.0
2024,4,14,7,2024-04-14,UA,6231,CLT,LAS,"Charlotte, NC",North Carolina,"Las Vegas, NV",Nevada,2290,1165,-7,0,2283,1165,24,9,2307,1156,2958,370,390,403,0,,0,0.0,0.0,0.0,0.0,0.0
2024,9,15,7,2024-09-15,AA,3717,SEA,DEN,"Seattle, WA",Washington,"Denver, CO",Colorado,520,2227,-25,-15,495,2212,15,6,510,2206,1936,232,252,253,0,,0,0.0,0.0,0.0,0.0,0.0
2024,2,15,4,2024-02-15,OO,2800,SFO,CLT,"San Francisco, CA",California,"Charlotte, NC",North Carolina,1741,2150,14,5,1755,2155,11,15,1766,2140,2122,262,282,288,0,,0,0.0,0.0,0.0,0.0,0.0
2024,11,6,3,2024-11-06,UA,1105,TPA,ATL,"Tampa, FL",Florida,"Atlanta, GA",Georgia,1568,1419,13,10,1581,1429,18,6,1599,1423,2995,377,397,401,0,,0,0.0,0.0,0.0,0.0,0.0
2024,11,26,2,2024-11-26,YX,1801,DFW,JFK,"Dallas/Fort Worth, TX",Texas,"New York, NY",New York,1453,2314,23,15,1476,2329,29,7,1505,2322,217,17,37,53,0,,0,0.0,0.0,0.0,0.0,0.0
2024,8,3,6,2024-08-03,OH,3402,PDX,LAX,"Portland, OR",Oregon,"Los Angeles, CA",California,1930,1115,-10,0,1920,1115,11,18,1931,1097,869,110,130,139,0,,0,0.0,0.0,0.0,0.0,0.0
2024,10,27,7,2024-10-27,G4,9095,ORD,JFK,"Chicago, IL",Illinois,"New York, NY",New York,1193,1017,-1,0,1192,1017,28,11,1220,1006,2230,280,300,319,0,,0,0.0,0.0,0.0,0.0,0.0
2024,11,28,4,2024-11-28,B6,3466,PDX,DFW,"Portland, OR",Oregon,"Dallas/Fort Worth, TX",Texas,1297,1724,-7,0,1290,1724,14,13,1304,1711,1275,156,176,183,0,,0,0.0,0.0,0.0,0.0,0.0
2024,1,24,3,2024-01-24,MQ,3262,LGA,MCO,"New York, NY",New York,"Orlando, FL",Florida,978,1007,-13,-20,965,987,20,14,985,973,1475,192,212,226,0,,0,0.0,0.0,0.0,0.0,0.0
2024,2,4,7,2024-02-04,AS,8406,MIA,DFW,"Miami, FL",Florida,"Dallas/Fort Worth, TX",Texas,1362,2028,6,5,1368,2033,11,16,1379,2017,703,83,103,110,0,,0,0.0,0.0,0.0,0.0,0.0
2024,1,24,3,2024-01-24,B6,2237,PHL,DFW,"Philadelphia, PA",Pennsylvania,"Dallas/Fort Worth, TX",Texas,1155,1753,1,5,1156,1758,29,17,1185,1741,1039,121,141,167,0,,0,0.0,0.0,0.0,0.0,0.0
2024,1,28,7,2024-01-28,AA,4952,LAS,HNL,"Las Vegas, NV",Nevada,"Honolulu, HI",Hawaii,2087,2142,0,5,2087,2147,26,7,2113,2140,1213,159,179,192,0,,0,0.0,0.0,0.0,0.0,0.0
2024,1,16,2,2024-01-16,9E,130,JFK,MCO,"New York, NY",New York,"Orlando, FL",Florida,1262,2319,-2,0,1260,2319,15,12,1275,2307,1203,153,173,180,0,,0,0.0,0.0,0.0,0.0,0.0
2024,2,28,3,2024-02-28,AA,6048,STL,LAX,"St. Louis, MO",Missouri,"Los Angeles, CA",California,1117,1443,-4,5,1113,1448,29,10,1142,1438,2244,287,307,326,0,,0,0.0,0.0,0.0,0.0,0.0
2024,8,30,5,2024-08-30,WN,1905,SFO,STL,"San Francisco, CA",California,"St. Louis, MO",Missouri,1210,634,4,0,1214,634,23,10,1237,624,856,108,128,141,0,,0,0.0,0.0,0.0,0.0,0.0
2024,7,25,4,2024-07-25,HA,6513,LAS,MDW,"Las Vegas, NV",Nevada,"Chicago, IL",Illinois,836,753,-13,-15,823,738,8,6,831,732,2906,353,373,367,0,,0,0.0,0.0,0.0,0.0,0.0
2024,9,27,5,2024-09-27,UA,3669,SLC,CLT,"Salt Lake City, UT",Utah,"Charlotte, NC",North Carolina,1671,2025,10,10,1681,2035,29,13,1710,2022,383,56,76,98,0,,0,0.0,0.0,0.0,0.0,0.0
2024,9,5,4,2024-09-05,OO,9728,HNL,BOS,"Honolulu, HI",Hawaii,"Boston, MA",Massachusetts,2138,1687,8,0,2146,1687,6,8,2152,1679,2007,252,272,266,0,,0,0.0,0.0,0.0,0.0,0.0
2024,9,23,1,2024-09-23,F9,5410,LAS,SAN,"Las Vegas, NV",Nevada,"San Diego, CA",California,1934,1489,0,5,1934,1494,20,3,1954,1491,1926,233,253,256,0,,0,0.0,0.0,0.0,0.0,0.0
2024,7,11,4,2024-07-11,YX,556,DCA,SEA,"Washington, DC",District of Columbia,"Seattle, WA",Washington,2037,1167,-7,-5,2030,1162,6,7,2036,1155,2838,363,383,376,1,,0,0.0,0.0,0.0,0.0,0.0
2024,11,30,6,2024-11-30,YX,548,MCO,PHX,"Orlando, FL",Florida,"Phoenix, AZ",Arizona,1267,828,16,15,1283,843,12,3,1295,840,555,67,87,82,0,,0,0.0,0.0,0.0,0.0,0.0
2024,8,5,1,2024-08-05,NK,167,DCA,LAS,"Washington, DC",District of Columbia,"Las Vegas, NV",Nevada,2095,1575,0,0,2095,1575,15,5,2110,1570,2223,269,289,289,0,,0,0.0,0.0,0.0,0.0,0.0
2024,4,24,3,2024-04-24,HA,4189,HNL,LAS,"Honolulu, HI",Hawaii,"Las Vegas, NV",Nevada,1318,1600,-3,5,1315,1605,10,5,1325,1600,1580,192,212,207,0,,0,0.0,0.0,0.0,0.0,0.0
2024,3,8,5,2024-03-08,OO,1962,SEA,IAD,"Seattle, WA",Washington,"Washington, DC",District of Columbia,884,1876,27,20,911,1896,25,5,936,1891,1464,179,199,209,0,,0,2.0,2.0,3.0,0.0,13.0
2024,10,25,5,2024-10-25,HA,1902,STL,DEN,"St. Louis, MO",Missouri,"Denver, CO",Colorado,2005,2111,17,15,2022,2126,22,9,2044,2117,212,22,42,53,0,,0,0.0,0.0,0.0,0.0,0.0
2024,11,20,3,2024-11-20,NK,7654,PHX,HNL,"Phoenix, AZ",Arizona,"Honolulu, HI",Hawaii,2126,1404,2,0,2128,1404,21,3,2149,1401,1552,188,208,212,0,,0,0.0,0.0,0.0,0.0,0.0
2024,3,15,5,2024-03-15,HA,8419,SAN,EWR,"San Diego, CA",California,"Newark, NJ",New Jersey,1624,1163,-6,-10,1618,1153,23,12,1641,1141,1973,253,273,288,0,,0,0.0,0.0,0.0,0.0,0.0
2024,4,12,5,2024-04-12,F9,5995,IAD,BOS,"Washington, DC",District of Columbia,"Boston, MA",Massachusetts,1637,1514,28,20,1665,1534,15,7,1680,1527,1709,204,224,226,0,,0,2.0,3.0,3.0,0.0,12.0
2024,10,23,3,2024-10-23,OH,9559,LAS,LGA,"Las Vegas, NV",Nevada,"New York, NY",New York,1520,614,34,30,1554,644,10,18,1564,626,2062,259,279,287,0,,0,2.0,4.0,3.0,0.0,21.0
2024,6,26,3,2024-06-26,9E,9334,SLC,JFK,"Salt Lake City, UT",Utah,"New York, NY",New York,1785,1494,-11,-15,1774,1479,16,18,1790,1461,1832,231,251,265,0,,0,0.0,0.0,0.0,0.0,0.0
2024,8,2,5,2024-08-02,NK,5615,DEN,IAH,"Denver, CO",Colorado,"Houston, TX",Texas,1945,1453,-6,0,1939,1453,16,6,1955,1447,351,47,67,69,0,,0,0.0,0.0,0.0,0.0,0.0
2024,11,10,7,2024-11-10,9E,3838,MSP,CLT,"Minneapolis, MN",Minnesota,"Charlotte, NC",North Carolina,1577,939,-6,0,1571,939,16,19,1587,920,1707,203,223,238,0,,0,0.0,0.0,0.0,0.0,0.0
2024,2,8,4,2024-02-08,DL,467,LAS,DTW,"Las Vegas, NV",Nevada,"Detroit, MI",Michigan,1711,962,-24,-15,1687,947,9,15,1696,932,2530,319,339,343,0,,0,0.0,0.0,0.0,0.0,0.0
2024,9,15,7,2024-09-15,WN,6301,PDX,DCA,"Portland, OR",Oregon,"Washington, DC",District of Columbia,2062,779,-3,-10,2059,769,10,5,2069,764,2897,352,372,367,0,,0,0.0,0.0,0.0,0.0,0.0
2024,7,22,1,2024-07-22,HA,2740,IAH,TPA,"Houston, TX",Texas,"Tampa, FL",Florida,2275,1188,-5,0,2270,1188,19,10,2289,1178,966,124,144,153,0,,0,0.0,0.0,0.0,0.0,0.0
2024,1,7,7,2024-01-07,OO,5007,IAH,IAD,"Houston, TX",Texas,"Washington, DC",District of Columbia,1091,814,27,20,1118,834,11,4,1129,830,2619,332,352,347,0,,0,5.0,4.0,1.0,0.0,10.0
2024,2,18,7,2024-02-18,AS,158,PDX,HNL,"Portland, OR",Oregon,"Honolulu, HI",Hawaii,1713,2358,-24,-20,1689,2338,11,13,1700,2325,2180,269,289,293,0,,0,0.0,0.0,0.0,0.0,0.0
2024,1,26,5,2024-01-26,UA,4356,PDX,IAH,"Portland, OR",Oregon,"Houston, TX",Texas,1330,1777,24,15,1354,1792,7,6,1361,1786,2740,343,363,356,0,,0,0.0,0.0,0.0,0.0,0.0
2024,6,9,7,2024-06-09,HA,8394,BWI,LGA,"Baltimore, MD",Maryland,"New York, NY",New York,2126,1668,19,10,2145,1678,28,10,2173,1668,1613,199,219,237,0,,0,0.0,0.0,0.0,0.0,0.0
2024,12,22,7,2024-12-22,UA,5041,SAN,HNL,"San Diego, CA",California,"Honolulu, HI",Hawaii,2070,951,2,10,2072,961,12,15,2084,946,1884,240,260,267,0,,0,0.0,0.0,0.0,0.0,0.0
2024,6,24,1,2024-06-24,HA,4607,MDW,MIA,"Chicago, IL",Illinois,"Miami, FL",Florida,1581,620,1,-5,1582,615,15,6,1597,609,1011,131,151,152,0,,0,0.0,0.0,0.0,0.0,0.0
2024,3,19,2,2024-03-19,AS,885,DFW,SLC,"Dallas/Fort Worth, TX",Texas,"Salt Lake City, UT",Utah,1002,2216,9,0,1011,2216,23,4,1034,2212,1193,150,170,177,0,,0,0.0,0.0,0.0,0.0,0.0
2024,1,2,2,2024-01-02,AA,2546,MCO,PHX,"Orlando, FL",Florida,"Phoenix, AZ",Arizona,688,1588,3,-5,691,1583,26,10,717,1573,1421,172,192,208,0,,0,0.0,0.0,0.0,0.0,0.0
2024,5,11,6,2024-05-11,OH,9248,LGA,HNL,"New York, NY",New York,"Honolulu, HI",Hawaii,2288,1164,12,15,2300,1179,29,9,2329,1170,462,58,78,96,0,,0,0.0,0.0,0.0,0.0,0.0
2024,10,2,3,2024-10-02,AA,8728,EWR,MDW,"Newark, NJ",New Jersey,"Chicago, IL",Illinois,2071,1268,8,0,2079,1268,5,19,2084,1249,1725,207,227,231,0,,0,0.0,0.0,0.0,0.0,0.0
2024,4,26,5,2024-04-26,B6,2465,LAS,MDW,"Las Vegas, NV",Nevada,"Chicago, IL",Illinois,1369,1543,-7,-15,1362,1528,6,16,1368,1512,1770,212,232,234,0,,0,0.0,0.0,0.0,0.0,0.0
2024,6,12,3,2024-06-12,AA,4801,BWI,CLT,"Baltimore, MD",Maryland,"Charlotte, NC",North Carolina,2127,968,-15,-10,2112,958,22,9,2134,949,1317,165,185,196,0,,0,0.0,0.0,0.0,0.0,0.0
2024,10,14,1,2024-10-14,9E,7517,PHL,LGA,"Philadelphia, PA",Pennsylvania,"New York, NY",New York,2091,1258,9,0,2100,1258,25,15,2125,1243,965,116,136,156,0,,0,0.0,0.0,0.0,0.0,0.0
2024,1,28,7,2024-01-28,F9,5666,STL,PDX,"St. Louis, MO",Missouri,"Portland, OR",Oregon,1078,1293,17,20,1095,1313,26,4,1121,1309,229,34,54,64,0,,0,0.0,4.0,0.0,0.0,16.0
2024,11,28,4,2024-11-28,DL,8788,BOS,SFO,"Boston, MA",Massachusetts,"San Francisco, CA",California,1836,1701,-8,0,1828,1701,23,14,1851,1687,2689,333,353,370,0,,0,0.0,0.0,0.0,0.0,0.0
2024,1,1,1,2024-01-01,AS,9658,LGA,PHL,"New York, NY",New York,"Philadelphia, PA",Pennsylvania,1692,1622,-1,5,1691,1627,24,4,1715,1623,769,94,114,122,0,,0,0.0,0.0,0.0,0.0,0.0
2024,7,6,6,2024-07-06,9E,9314,ORD,LAS,"Chicago, IL",Illinois,"Las Vegas, NV",Nevada,1298,1742,-25,-15,1273,1727,17,10,1290,1717,1628,199,219,226,0,,0,0.0,0.0,0.0,0.0,0.0
2024,2,25,7,2024-02-25,9E,6483,SEA,DEN,"Seattle, WA",Washington,"Denver, CO",Colorado,630,958,0,10,630,968,22,4,652,964,2130,258,278,284,0,,0,0.0,0.0,0.0,0.0,0.0
2024,2,4,7,2024-02-04,B6,1589,IAH,TPA,"Houston, TX",Texas,"Tampa, FL",Florida,1177,2240,-10,0,1167,2240,23,6,1190,2234,1293,165,185,194,0,,0,0.0,0.0,0.0,0.0,0.0
2024,4,21,7,2024-04-21,9E,2434,HNL,BWI,"Honolulu, HI",Hawaii,"Baltimore, MD",Maryland,1448,2137,10,15,1458,2152,12,19,1470,2133,1946,238,258,269,0,,0,0.0,0.0,0.0,0.0,0.0
2024,10,12,6,2024-10-12,YX,7790,DCA,BOS,"Washington, DC",District of Columbia,"Boston, MA",Massachusetts,2087,2250,-14,-5,2073,2245,19,16,2092,2229,1526,185,205,220,0,,0,0.0,0.0,0.0,0.0,0.0
2024,11,5,2,2024-11-05,YX,3489,DCA,LAX,"Washington, DC",District of Columbia,"Los Angeles, CA",California,651,1102,6,5,657,1107,25,10,682,1097,2400,301,321,336,0,,0,0.0,0.0,0.0,0.0,0.0
2024,2,5,1,2024-02-05,WN,302,IAH,DTW,"Houston, TX",Texas,"Detroit, MI",Michigan,1421,631,6,0,1427,631,22,6,1449,625,999,115,135,143,0,,0,0.0,0.0,0.0,0.0,0.0
2024,8,4,7,2024-08-04,AA,330,EWR,TPA,"Newark, NJ",New Jersey,"Tampa, FL",Florida,1628,957,-16,-15,1612,942,14,18,1626,924,2003,243,263,275,0,,0,0.0,0.0,0.0,0.0,0.0
2024,3,20,3,2024-03-20,OH,7147,ATL,IAH,"Atlanta, GA",Georgia,"Houston, TX",Texas,1890,661,-16,-10,1874,651,19,11,1893,640,1748,209,229,239,0,,0,0.0,0.0,0.0,0.0,0.0
2024,11,9,6,2024-11-09,OH,3062,PDX,STL,"Portland, OR",Oregon,"St. Louis, MO",Missouri,1615,1720,-21,-15,1594,1705,14,15,1608,1690,1656,199,219,228,0,,0,0.0,0.0,0.0,0.0,0.0
2024,3,23,6,2024-03-23,UA,2427,IAD,ORD,"Washington, DC",District of Columbia,"Chicago, IL",Illinois,1212,2001,-14,-5,1198,1996,22,13,1220,1983,570,67,87,102,0,,0,0.0,0.0,0.0,0.0,0.0
2024,3,5,2,2024-03-05,MQ,2884,CLT,SFO,"Charlotte, NC",North Carolina,"San Francisco, CA",California,1304,2270,1,0,1305,2270,24,4,1329,2266,1642,202,222,230,0,,0,0.0,0.0,0.0,0.0,0.0
2024,11,20,3,2024-11-20,YX,903,PDX,ORD,"Portland, OR",Oregon,"Chicago, IL",Illinois,2254,2119,-16,-10,2238,2109,29,4,2267,2105,1241,155,175,188,0,,0,0.0,0.0,0.0,0.0,0.0
2024,5,7,2,2024-05-07,WN,5866,HNL,PDX,"Honolulu, HI",Hawaii,"Portland, OR",Oregon,931,2233,4,0,935,2233,10,13,945,2220,2713,329,349,352,0,,0,0.0,0.0,0.0,0.0,0.0
2024,11,2,6,2024-11-02,DL,3823,HNL,SAN,"Honolulu, HI",Hawaii,"San Diego, CA",California,2102,1051,9,0,2111,1051,5,15,2116,1036,1712,211,231,231,0,,0,0.0,0.0,0.0,0.0,0.0
2024,1,22,1,2024-01-22,YX,6496,PHL,MCO,"Philadelphia, PA",Pennsylvania,"Orlando, FL",Florida,2204,1838,7,0,2211,1838,18,17,2229,1821,650,83,103,118,0,,0,0.0,0.0,0.0,0.0,0.0
2024,8,3,6,2024-08-03,DL,275,IAD,BWI,"Washington, DC",District of Columbia,"Baltimore, MD",Maryland,1828,1707,-15,-10,1813,1697,24,18,1837,1679,2209,272,292,314,0,,0,0.0,0.0,0.0,0.0,0.0
2024,4,16,2,2024-04-16,DL,9736,MCO,LAX,"Orlando, FL",Florida,"Los Angeles, CA",California,527,1005,3,0,530,1005,7,18,537,987,965,112,132,137,0,,0,0.0,0.0,0.0,0.0,0.0
2024,4,18,4,2024-04-18,OO,5791,STL,DFW,"St. Louis, MO",Missouri,"Dallas/Fort Worth, TX",Texas,1811,1605,-5,-5,1806,1600,5,19,1811,1581,1723,213,233,237,0,,0,0.0,0.0,0.0,0.0,0.0
2024,12,22,7,2024-12-22,AA,3632,ORD,DFW,"Chicago, IL",Illinois,"Dallas/Fort Worth, TX",Texas,854,2292,-13,-10,841,2282,26,19,867,2263,2605,333,353,378,0,,0,0.0,0.0,0.0,0.0,0.0
2024,6,29,6,2024-06-29,9E,4449,LGA,SFO,"New York, NY",New York,"San Francisco, CA",California,2067,1730,-2,0,2065,1730,14,9,2079,1721,2145,264,284,287,0,,0,0.0,0.0,0.0,0.0,0.0
2024,12,21,6,2024-12-21,DL,1643,SLC,TPA,"Salt Lake City, UT",Utah,"Tampa, FL",Florida,1177,2112,-20,-15,1157,2097,21,11,1178,2086,1160,152,172,184,0,,0,0.0,0.0,0.0,0.0,0.0
2024,6,12,3,2024-06-12,AS,5556,MDW,IAH,"Chicago, IL",Illinois,"Houston, TX",Texas,1927,956,7,15,1934,971,5,6,1939,965,1173,155,175,166,0,,0,0.0,0.0,0.0,0.0,0.0
2024,3,8,5,2024-03-08,UA,3513,SFO,PHL,"San Francisco, CA",California,"Philadelphia, PA",Pennsylvania,635,730,12,15,647,745,20,17,667,728,2170,280,300,317,0,,0,0.0,0.0,0.0,0.0,0.0
2024,10,18,5,2024-10-18,9E,7185,CLT,EWR,"Charlotte, NC",North Carolina,"Newark, NJ",New Jersey,1591,1645,10,5,1601,1650,27,13,1628,1637,554,73,93,113,0,,0,0.0,0.0,0.0,0.0,0.0
2024,6,28,5,2024-06-28,B6,4279,CLT,JFK,"Charlotte, NC",North Carolina,"New York, NY",New York,653,1195,3,-5,656,1190,5,8,661,1182,1213,152,172,165,0,,0,0.0,0.0,0.0,0.0,0.0
2024,6,29,6,2024-06-29,AA,9432,IAH,HNL,"Houston, TX",Texas,"Honolulu, HI",Hawaii,1986,2224,-10,0,1976,2224,7,3,1983,2221,1698,210,230,220,0,,0,0.0,0.0,0.0,0.0,0.0
2024,6,17,1,2024-06-17,F9,4907,SFO,DTW,"San Francisco, CA",California,"Detroit, MI",Michigan,825,825,2,0,827,825,9,3,836,822,944,122,142,134,0,,0,0.0,0.0,0.0,0.0,0.0
2024,1,22,1,2024-01-22,MQ,7486,EWR,PHX,"Newark, NJ",New Jersey,"Phoenix, AZ",Arizona,1315,1729,-4,-5,1311,1724,23,7,1334,1717,359,46,66,76,0,,0,0.0,0.0,0.0,0.0,0.0
2024,3,6,3,2024-03-06,WN,2040,PHX,LAS,"Phoenix, AZ",Arizona,"Las Vegas, NV",Nevada,1619,1552,-1,-10,1618,1542,26,6,1644,1536,2828,353,373,385,0,,0,0.0,0.0,0.0,0.0,0.0
2024,1,21,7,2024-01-21,G4,756,PHL,JFK,"Philadelphia, PA",Pennsylvania,"New York, NY",New York,1720,993,-13,-10,1707,983,18,16,1725,967,2816,361,381,395,0,,0,0.0,0.0,0.0,0.0,0.0
2024,4,9,2,2024-04-09,WN,2603,HNL,ORD,"Honolulu, HI",Hawaii,"Chicago, IL",Illinois,607,1470,-7,-10,600,1460,18,12,618,1448,901,116,136,146,0,,0,0.0,0.0,0.0,0.0,0.0
2024,10,26,6,2024-10-26,OH,758,EWR,IAH,"Newark, NJ",New Jersey,"Houston, TX",Texas,1569,1724,0,5,1569,1729,29,3,1598,1726,2343,299,319,331,0,,0,0.0,0.0,0.0,0.0,0.0
2024,4,12,5,2024-04-12,HA,7138,DFW,PDX,"Dallas/Fort Worth, TX",Texas,"Portland, OR",Oregon,1709,1771,2,10,1711,1781,22,14,1733,1767,909,104,124,140,1,,0,0.0,0.0,0.0,0.0,0.0
2024,2,16,5,2024-02-16,HA,8202,PDX,DCA,"Portland, OR",Oregon,"Washington, DC",District of Columbia,953,1853,-13,-5,940,1848,11,19,951,1829,2300,288,308,318,0,,0,0.0,0.0,0.0,0.0,0.0
2024,2,8,4,2024-02-08,HA,6125,BWI,SFO,"Baltimore, MD",Maryland,"San Francisco, CA",California,822,686,-12,-15,810,671,24,5,834,666,1535,184,204,213,0,,0,0.0,0.0,0.0,0.0,0.0
2024,10,11,5,2024-10-11,DL,9346,STL,ORD,"St. Louis, MO",Missouri,"Chicago, IL",Illinois,784,1122,-28,-20,756,1102,15,12,771,1090,515,63,83,90,0,,0,0.0,0.0,0.0,0.0,0.0
2024,11,5,2,2024-11-05,UA,6598,EWR,TPA,"Newark, NJ",New Jersey,"Tampa, FL",Florida,1606,2271,-4,-5,1602,2266,26,3,1628,2263,2254,279,299,308,0,,0,0.0,0.0,0.0,0.0,0.0
2024,3,30,6,2024-03-30,B6,6448,DCA,DTW,"Washington, DC",District of Columbia,"Detroit, MI",Michigan,1149,692,-9,-10,1140,682,14,15,1154,667,2743,345,365,374,0,,0,0.0,0.0,0.0,0.0,0.0
2024,3,25,1,2024-03-25,YX,3141,DCA,PDX,"Washington, DC",District of Columbia,"Portland, OR",Oregon,1850,1403,1,-5,1851,1398,16,19,1867,1379,806,105,125,140,0,,0,0.0,0.0,0.0,0.0,0.0
2024,9,29,7,2024-09-29,9E,2438,LGA,MDW,"New York, NY",New York,"Chicago, IL",Illinois,1248,752,-10,-10,1238,742,14,6,1252,736,2036,244,264,264,0,,0,0.0,0.0,0.0,0.0,0.0
2024,12,1,7,2024-12-01,HA,210,MSP,DTW,"Minneapolis, MN",Minnesota,"Detroit, MI",Michigan,948,2046,3,5,951,2051,10,11,961,2040,2892,362,382,383,0,,0,0.0,0.0,0.0,0.0,0.0
2024,7,6,6,2024-07-06,MQ,5287,DEN,TPA,"Denver, CO",Colorado,"Tampa, FL",Florida,820,953,-6,0,814,953,12,12,826,941,2325,281,301,305,0,,0,0.0,0.0,0.0,0.0,0.0
2024,6,7,5,2024-06-07,MQ,1818,DFW,LGA,"Dallas/Fort Worth, TX",Texas,"New York, NY",New York,1668,1478,15,15,1683,1493,11,12,1694,1481,880,114,134,137,0,,0,0.0,0.0,0.0,0.0,0.0
2024,8,30,5,2024-08-30,OH,6616,BOS,SLC,"Boston, MA",Massachusetts,"Salt Lake City, UT",Utah,777,1207,1,5,778,1212,17,17,795,1195,1359,172,192,206,0,,0,0.0,0.0,0.0,0.0,0.0
2024,3,13,3,2024-03-13,AS,225,BOS,PHX,"Boston, MA",Massachusetts,"Phoenix, AZ",Arizona,1111,2197,-11,-10,1100,2187,25,7,1125,2180,368,46,66,78,0,,0,0.0,0.0,0.0,0.0,0.0
2024,2,18,7,2024-02-18,NK,8553,JFK,TPA,"New York, NY",New York,"Tampa, FL",Florida,1537,1582,3,5,1540,1587,27,13,1567,1574,701,77,97,117,0,,0,0.0,0.0,0.0,0.0,0.0
2024,4,10,3,2024-04-10,WN,3034,SLC,DTW,"Salt Lake City, UT",Utah,"Detroit, MI",Michigan,1785,1516,-1,-10,1784,1506,16,15,1800,1491,1838,234,254,265,0,,0,0.0,0.0,0.0,0.0,0.0
2024,1,2,2,2024-01-02,NK,6017,LAS,LGA,"Las Vegas, NV",Nevada,"New York, NY",New York,913,1514,4,0,917,1514,16,19,933,1495,1169,142,162,177,0,,0,0.0,0.0,0.0,0.0,0.0
2024,8,31,6,2024-08-31,HA,1704,BWI,SFO,"Baltimore, MD",Maryland,"San Francisco, CA",California,993,1008,-15,-15,978,993,26,18,1004,975,2769,348,368,392,0,,0,0.0,0.0,0.0,0.0,0.0
2024,6,24,1,2024-06-24,9E,7690,LAX,MIA,"Los Angeles, CA",California,"Miami, FL",Florida,546,1710,-28,-20,518,1690,17,7,535,1683,2753,335,355,359,0,,0,0.0,0.0,0.0,0.0,0.0
2024,8,25,7,2024-08-25,UA,2182,IAH,DEN,"Houston, TX",Texas,"Denver, CO",Colorado,2260,810,4,0,2264,810,25,10,2289,800,920,121,141,156,0,,0,0.0,0.0,0.0,0.0,0.0
2024,2,28,3,2024-02-28,NK,8946,MDW,JFK,"Chicago, IL",Illinois,"New York, NY",New York,1155,982,-9,-15,1146,967,13,16,1159,951,2299,294,314,323,0,,0,0.0,0.0,0.0,0.0,0.0
2024,12,18,3,2024-12-18,WN,5193,DCA,MIA,"Washington, DC",District of Columbia,"Miami, FL",Florida,1719,2218,-13,-5,1706,2213,24,15,1730,2198,1403,178,198,217,0,,0,0.0,0.0,0.0,0.0,0.0
2024,4,8,1,2024-04-08,MQ,7243,CLT,DCA,"Charlotte, NC",North Carolina,"Washington, DC",District of Columbia,1813,2147,4,-5,1817,2142,11,11,1828,2131,1466,176,196,198,0,,0,0.0,0.0,0.0,0.0,0.0
2024,12,24,2,2024-12-24,MQ,384,HNL,MSP,"Honolulu, HI",Hawaii,"Minneapolis, MN",Minnesota,1268,1470,-2,5,1266,1475,20,3,1286,1472,916,109,129,132,0,,0,0.0,0.0,0.0,0.0,0.0
2024,1,2,2,2024-01-02,F9,5666,ATL,LAX,"Atlanta, GA",Georgia,"Los Angeles, CA",California,931,1776,-5,-5,926,1771,27,9,953,1762,2796,354,374,390,0,,0,0.0,0.0,0.0,0.0,0.0
2024,8,30,5,2024-08-30,G4,8318,MIA,PDX,"Miami, FL",Florida,"Portland, OR",Oregon,2043,1628,-4,0,2039,1628,23,11,2062,1617,2027,253,273,287,0,,0,0.0,0.0,0.0,0.0,0.0
2024,10,23,3,2024-10-23,NK,2374,HNL,LGA,"Honolulu, HI",Hawaii,"New York, NY",New York,1847,1699,14,5,1861,1704,28,9,1889,1695,1884,239,259,276,0,,0,0.0,0.0,0.0,0.0,0.0
2024,7,29,1,2024-07-29,F9,4072,DFW,LAS,"Dallas/Fort Worth, TX",Texas,"Las Vegas, NV",Nevada,1455,1010,-7,-10,1448,1000,29,10,1477,990,1139,139,159,178,1,,0,0.0,0.0,0.0,0.0,0.0
2024,5,2,4,2024-05-02,F9,9883,TPA,MDW,"Tampa, FL",Florida,"Chicago, IL",Illinois,1952,603,3,10,1955,613,15,12,1970,601,2166,266,286,293,0,,0,0.0,0.0,0.0,0.0,0.0
2024,8,16,5,2024-08-16,DL,9420,PHL,IAH,"Philadelphia, PA",Pennsylvania,"Houston, TX",Texas,1816,1995,12,10,1828,2005,9,19,1837,1986,2313,292,312,320,0,,0,0.0,0.0,0.0,0.0,0.0
2024,3,22,5,2024-03-22,G4,4213,DFW,LGA,"Dallas/Fort Worth, TX",Texas,"New York, NY",New York,876,1706,20,30,896,1736,21,3,917,1733,2853,360,380,384,0,,0,1.0,2.0,2.0,0.0,25.0
2024,5,23,4,2024-05-23,AS,6829,BOS,BWI,"Boston, MA",Massachusetts,"Baltimore, MD",Maryland,2058,1540,2,-5,2060,1535,5,4,2065,1531,2486,306,326,315,0,,0,0.0,0.0,0.0,0.0,0.0
2024,5,19,7,2024-05-19,OO,8448,DTW,LGA,"Detroit, MI",Michigan,"New York, NY",New York,1607,1030,-3,-5,1604,1025,9,16,1613,1009,602,75,95,100,0,,0,0.0,0.0,0.0,0.0,0.0
2024,1,29,1,2024-01-29,WN,1389,JFK,MSP,"New York, NY",New York,"Minneapolis, MN",Minnesota,2290,2095,-3,5,2287,2100,6,6,2293,2094,452,56,76,68,0,,0,0.0,0.0,0.0,0.0,0.0
2024,9,26,4,2024-09-26,HA,2611,IAH,TPA,"Houston, TX",Texas,"Tampa, FL",Florida,1896,1985,-18,-15,1878,1970,6,19,1884,1951,943,115,135,140,0,,0,0.0,0.0,0.0,0.0,0.0
2024,9,3,2,2024-09-03,B6,5820,DCA,LAS,"Washington, DC",District of Columbia,"Las Vegas, NV",Nevada,1547,1011,-13,-20,1534,991,16,19,1550,972,790,107,127,142,0,,0,0.0,0.0,0.0,0.0,0.0
2024,1,12,5,2024-01-12,9E,1255,EWR,SAN,"Newark, NJ",New Jersey,"San Diego, CA",California,1408,634,-14,-5,1394,629,26,10,1420,619,2097,270,290,306,0,,0,0.0,0.0,0.0,0.0,0.0
2024,12,20,5,2024-12-20,B6,2888,CLT,JFK,"Charlotte, NC",North Carolina,"New York, NY",New York,824,1865,14,5,838,1870,9,3,847,1867,1055,139,159,151,0,,0,0.0,0.0,0.0,0.0,0.0
2024,12,2,1,2024-12-02,NK,5253,DFW,PDX,"Dallas/Fort Worth, TX",Texas,"Portland, OR",Oregon,815,2279,-20,-15,795,2264,15,19,810,2245,2938,366,386,400,0,,0,0.0,0.0,0.0,0.0,0.0
2024,4,15,1,2024-04-15,OH,6326,BWI,DFW,"Baltimore, MD",Maryland,"Dallas/Fort Worth, TX",Texas,2073,1507,7,0,2080,1507,17,10,2097,1497,2354,286,306,313,0,,0,0.0,0.0,0.0,0.0,0.0
2024,2,1,4,2024-02-01,G4,3076,SFO,DCA,"San Francisco, CA",California,"Washington, DC",District of Columbia,720,679,-3,-10,717,669,22,15,739,654,826,101,121,138,0,,0,0.0,0.0,0.0,0.0,0.0
2024,3,14,4,2024-03-14,NK,5351,EWR,MSP,"Newark, NJ",New Jersey,"Minneapolis, MN",Minnesota,713,674,3,5,716,679,18,4,734,675,921,120,140,142,0,,0,0.0,0.0,0.0,0.0,0.0
2024,6,19,3,2024-06-19,G4,3599,DFW,LAX,"Dallas/Fort Worth, TX",Texas,"Los Angeles, CA",California,1995,1410,4,0,1999,1410,9,19,2008,1391,2170,274,294,302,0,,0,0.0,0.0,0.0,0.0,0.0
2024,12,2,1,2024-12-02,WN,3013,EWR,TPA,"Newark, NJ",New Jersey,"Tampa, FL",Florida,1344,883,-23,-15,1321,868,15,9,1336,859,1196,155,175,179,0,,0,0.0,0.0,0.0,0.0,0.0
2024,3,9,6,2024-03-09,9E,303,BWI,MSP,"Baltimore, MD",Maryland,"Minneapolis, MN",Minnesota,2014,1326,-12,-10,2002,1316,8,18,2010,1298,1410,171,191,197,0,,0,0.0,0.0,0.0,0.0,0.0
2024,10,27,7,2024-10-27,OH,1922,IAD,SFO,"Washington, DC",District of Columbia,"San Francisco, CA",California,1608,1861,-3,-10,1605,1851,26,19,1631,1832,466,54,74,99,0,,0,0.0,0.0,0.0,0.0,0.0
2024,12,27,5,2024-12-27,9E,9651,MDW,TPA,"Chicago, IL",Illinois,"Tampa, FL",Florida,884,936,-1,-10,883,926,21,6,904,920,355,34,54,61,0,,0,0.0,0.0,0.0,0.0,0.0
2024,5,16,4,2024-05-16,WN,8733,DCA,DTW,"Washington, DC",District of Columbia,"Detroit, MI",Michigan,1527,2154,9,0,1536,2154,18,12,1554,2142,1874,237,257,267,0,,0,0.0,0.0,0.0,0.0,0.0
2024,4,9,2,2024-04-09,AS,7071,MCO,CLT,"Orlando, FL",Florida,"Charlotte, NC",North Carolina,2230,1185,16,20,2246,1205,7,11,2253,1194,896,113,133,131,0,,0,4.0,4.0,0.0,0.0,12.0
2024,5,25,6,2024-05-25,F9,7525,HNL,LAS,"Honolulu, HI",Hawaii,"Las Vegas, NV",Nevada,1637,1166,11,5,1648,1171,25,12,1673,1159,2247,275,295,312,0,,0,0.0,0.0,0.0,0.0,0.0
2024,1,9,2,2024-01-09,OH,9607,MDW,SFO,"Chicago, IL",Illinois,"San Francisco, CA",California,1738,682,2,10,1740,692,28,8,1768,684,456,50,70,86,0,,0,0.0,0.0,0.0,0.0,0.0
2024,3,2,6,2024-03-02,G4,9440,MSP,PDX,"Minneapolis, MN",Minnesota,"Portland, OR",Oregon,1859,2299,26,30,1885,2329,6,14,1891,2315,1366,179,199,199,0,,0,10.0,5.0,5.0,0.0,10.0
2024,7,3,3,2024-07-03,AA,5882,DCA,STL,"Washington, DC",District of Columbia,"St. Louis, MO",Missouri,1376,917,2,0,1378,917,12,13,1390,904,2159,263,283,288,0,,0,0.0,0.0,0.0,0.0,0.0
2024,1,29,1,2024-01-29,AA,8026,DCA,IAD,"Washington, DC",District of Columbia,"Washington, DC",District of Columbia,1152,1474,-12,-10,1140,1464,28,17,1168,1447,1152,147,167,192,0,,0,0.0,0.0,0.0,0.0,0.0
2024,4,23,2,2024-04-23,MQ,9490,IAH,EWR,"Houston, TX",Texas,"Newark, NJ",New Jersey,1690,1278,13,15,1703,1293,20,16,1723,1277,2245,272,292,308,0,,0,0.0,0.0,0.0,0.0,0.0
2024,5,22,3,2024-05-22,F9,6103,SEA,JFK,"Seattle, WA",Washington,"New York, NY",New York,786,2251,-1,5,785,2256,10,14,795,2242,1161,149,169,173,0,,0,0.0,0.0,0.0,0.0,0.0
2024,4,29,1,2024-04-29,OO,4275,SAN,MCO,"San Diego, CA",California,"Orlando, FL",Florida,2018,1920,13,20,2031,1940,25,14,2056,1926,1176,156,176,195,0,,0,1.0,1.0,0.0,0.0,18.0
2024,6,18,2,2024-06-18,NK,7886,PDX,SEA,"Portland, OR",Oregon,"Seattle, WA",Washington,883,1299,3,5,886,1304,11,9,897,1295,266,40,60,60,0,,0,0.0,0.0,0.0,0.0,0.0
2024,6,5,3,2024-06-05,G4,2959,SEA,EWR,"Seattle, WA",Washington,"Newark, NJ",New Jersey,1517,1965,0,5,1517,1970,26,7,1543,1963,2810,352,372,385,0,,0,0.0,0.0,0.0,0.0,0.0
2024,11,30,6,2024-11-30,OO,3062,LGA,IAH,"New York, NY",New York,"Houston, TX",Texas,1346,1433,9,10,1355,1443,19,17,1374,1426,1093,145,165,181,0,,0,0.0,0.0,0.0,0.0,0.0
2024,12,14,6,2024-12-14,UA,1467,IAD,PDX,"Washington, DC",District of Columbia,"Portland, OR",Oregon,1016,1554,12,5,1028,1559,13,18,1041,1541,1945,248,268,279,0,,0,0.0,0.0,0.0,0.0,0.0
2024,9,16,1,2024-09-16,9E,5310,DTW,STL,"Detroit, MI",Michigan,"St. Louis, MO",Missouri,626,2047,-8,0,618,2047,22,13,640,2034,895,104,124,139,0,,0,0.0,0.0,0.0,0.0,0.0
2024,3,22,5,2024-03-22,YX,3009,STL,CLT,"St. Louis, MO",Missouri,"Charlotte, NC",North Carolina,1956,1586,9,0,1965,1586,16,19,1981,1567,2063,247,267,282,0,,0,0.0,0.0,0.0,0.0,0.0
2024,8,29,4,2024-08-29,B6,3505,BOS,SEA,"Boston, MA",Massachusetts,"Seattle, WA",Washington,1609,618,6,10,1615,628,10,8,1625,620,2547,316,336,334,0,,0,0.0,0.0,0.0,0.0,0.0
2024,6,20,4,2024-06-20,UA,4594,SLC,LAX,"Salt Lake City, UT",Utah,"Los Angeles, CA",California,2121,1413,6,5,2127,1418,16,8,2143,1410,644,74,94,98,0,,0,0.0,0.0,0.0,0.0,0.0
2024,8,18,7,2024-08-18,HA,920,JFK,PHL,"New York, NY",New York,"Philadelphia, PA",Pennsylvania,2059,603,-11,-5,2048,598,11,14,2059,584,2017,259,279,284,0,,0,0.0,0.0,0.0,0.0,0.0
2024,7,26,5,2024-07-26,B6,7802,LAS,ATL,"Las Vegas, NV",Nevada,"Atlanta, GA",Georgia,1568,1066,6,0,1574,1066,19,10,1593,1056,520,58,78,87,0,,0,0.0,0.0,0.0,0.0,0.0
2024,3,15,5,2024-03-15,9E,7355,EWR,MCO,"Newark, NJ",New Jersey,"Orlando, FL",Florida,1122,789,8,0,1130,789,5,7,1135,782,1992,246,266,258,0,,0,0.0,0.0,0.0,0.0,0.0
2024,9,26,4,2024-09-26,AA,2762,LGA,BOS,"New York, NY",New York,"Boston, MA",Massachusetts,789,1904,-27,-20,762,1884,19,13,781,1871,817,101,121,133,0,,0,0.0,0.0,0.0,0.0,0.0
2024,4,23,2,2024-04-23,OH,7204,MSP,MDW,"Minneapolis, MN",Minnesota,"Chicago, IL",Illinois,1196,662,-9,-10,1187,652,18,4,1205,648,1419,173,193,195,0,,0,0.0,0.0,0.0,0.0,0.0
2024,3,2,6,2024-03-02,OO,5472,MIA,HNL,"Miami, FL",Florida,"Honolulu, HI",Hawaii,1758,1613,-6,-10,1752,1603,29,10,1781,1593,1951,235,255,274,0,,0,0.0,0.0,0.0,0.0,0.0
2024,12,27,5,2024-12-27,WN,4553,SAN,ORD,"San Diego, CA",California,"Chicago, IL",Illinois,656,1877,1,10,657,1887,17,10,674,1877,403,49,69,76,0,,0,0.0,0.0,0.0,0.0,0.0
2024,11,15,5,2024-11-15,AS,3229,LAX,DEN,"Los Angeles, CA",California,"Denver, CO",Colorado,905,2250,-1,-5,904,2245,28,10,932,2235,1301,167,187,205,0,,0,0.0,0.0,0.0,0.0,0.0
2024,4,11,4,2024-04-11,DL,4716,SAN,DEN,"San Diego, CA",California,"Denver, CO",Colorado,2196,1625,0,0,2196,1625,25,19,2221,1606,1199,158,178,202,0,,0,0.0,0.0,0.0,0.0,0.0
2024,12,27,5,2024-12-27,MQ,8186,ORD,HNL,"Chicago, IL",Illinois,"Honolulu, HI",Hawaii,2028,666,0,10,2028,676,18,9,2046,667,1125,132,152,159,0,,0,0.0,0.0,0.0,0.0,0.0
2024,7,28,7,2024-07-28,NK,1766,ATL,IAD,"Atlanta, GA",Georgia,"Washington, DC",District of Columbia,2235,1477,-7,-10,2228,1467,19,5,2247,1462,1838,235,255,259,0,,0,0.0,0.0,0.0,0.0,0.0
2024,9,11,3,2024-09-11,F9,7489,MSP,DFW,"Minneapolis, MN",Minnesota,"Dallas/Fort Worth, TX",Texas,1645,1909,-22,-15,1623,1894,25,3,1648,1891,744,92,112,120,0,,0,0.0,0.0,0.0,0.0,0.0
2024,1,20,6,2024-01-20,AA,3500,LAX,DTW,"Los Angeles, CA",California,"Detroit, MI",Michigan,1747,731,10,15,1757,746,13,7,1770,739,220,27,47,47,0,,0,0.0,0.0,0.0,0.0,0.0
2024,2,27,2,2024-02-27,MQ,2300,MDW,IAH,"Chicago, IL",Illinois,"Houston, TX",Texas,1376,1671,2,5,1378,1676,22,18,1400,1658,854,103,123,143,0,,0,0.0,0.0,0.0,0.0,0.0
2024,4,21,7,2024-04-21,WN,9184,MDW,PDX,"Chicago, IL",Illinois,"Portland, OR",Oregon,1546,2178,-1,-10,1545,2168,10,6,1555,2162,1542,189,209,205,0,,0,0.0,0.0,0.0,0.0,0.0
2024,11,8,5,2024-11-08,OO,1083,LAS,IAH,"Las Vegas, NV",Nevada,"Houston, TX",Texas,696,1204,1,10,697,1214,24,17,721,1197,935,120,140,161,0,,0,0.0,0.0,0.0,0.0,0.0
2024,7,14,7,2024-07-14,WN,6723,HNL,SAN,"Honolulu, HI",Hawaii,"San Diego, CA",California,978,1540,-2,5,976,1545,8,19,984,1526,1964,251,271,278,0,,0,0.0,0.0,0.0,0.0,0.0
2024,12,18,3,2024-12-18,MQ,8874,MCO,EWR,"Orlando, FL",Florida,"Newark, NJ",New Jersey,784,1592,16,10,800,1602,12,19,812,1583,1980,237,257,268,0,,0,0.0,0.0,0.0,0.0,0.0
2024,4,1,1,2024-04-01,B6,6151,DEN,EWR,"Denver, CO",Colorado,"Newark, NJ",New Jersey,2041,2276,-12,-10,2029,2266,23,15,2052,2251,1928,240,260,278,0,,0,0.0,0.0,0.0,0.0,0.0
2024,2,21,3,2024-02-21,OH,4215,LGA,DEN,"New York, NY",New York,"Denver, CO",Colorado,807,1670,3,-5,810,1665,15,13,825,1652,1018,132,152,160,0,,0,0.0,0.0,0.0,0.0,0.0
2024,10,19,6,2024-10-19,YX,2740,TPA,BOS,"Tampa, FL",Florida,"Boston, MA",Massachusetts,844,1854,2,5,846,1859,12,18,858,1841,1000,119,139,149,0,,0,0.0,0.0,0.0,0.0,0.0
2024,1,8,1,2024-01-08,YX,6471,BWI,SAN,"Baltimore, MD",Maryland,"San Diego, CA",California,2124,883,-7,-5,2117,878,14,6,2131,872,2217,277,297,297,0,,0,0.0,0.0,0.0,0.0,0.0
2024,10,26,6,2024-10-26,WN,3517,BOS,PHX,"Boston, MA",Massachusetts,"Phoenix, AZ",Arizona,1520,1148,-13,-15,1507,1133,9,17,1516,1116,690,94,114,120,0,,0,0.0,0.0,0.0,0.0,0.0
2024,4,7,7,2024-04-07,G4,6687,LAS,DFW,"Las Vegas, NV",Nevada,"Dallas/Fort Worth, TX",Texas,1490,1651,-18,-15,1472,1636,6,14,1478,1622,581,62,82,82,0,,0,0.0,0.0,0.0,0.0,0.0
2024,8,23,5,2024-08-23,NK,9180,IAD,LAS,"Washington, DC",District of Columbia,"Las Vegas, NV",Nevada,897,2034,3,0,900,2034,16,16,916,2018,2223,277,297,309,0,,0,0.0,0.0,0.0,0.0,0.0
2024,3,9,6,2024-03-09,MQ,1983,JFK,DCA,"New York, NY",New York,"Washington, DC",District of Columbia,1284,2096,2,-5,1286,2091,25,15,1311,2076,1705,220,240,260,0,,0,0.0,0.0,0.0,0.0,0.0
2024,2,14,3,2024-02-14,DL,4921,LAX,MDW,"Los Angeles, CA",California,"Chicago, IL",Illinois,1987,2293,-13,-20,1974,2273,24,11,1998,2262,1360,167,187,202,0,,0,0.0,0.0,0.0,0.0,0.0
2024,5,16,4,2024-05-16,AA,3922,PHL,SLC,"Philadelphia, PA",Pennsylvania,"Salt Lake City, UT",Utah,1295,1501,4,5,1299,1506,29,17,1328,1489,486,63,83,109,0,,0,0.0,0.0,0.0,0.0,0.0
2024,8,21,3,2024-08-21,G4,8438,STL,PHX,"St. Louis, MO",Missouri,"Phoenix, AZ",Arizona,1638,1845,4,-5,1642,1840,10,18,1652,1822,1892,245,265,273,0,,0,0.0,0.0,0.0,0.0,0.0
2024,2,1,4,2024-02-01,AA,1816,MDW,ATL,"Chicago, IL",Illinois,"Atlanta, GA",Georgia,1135,1999,-15,-5,1120,1994,15,12,1135,1982,2580,313,333,340,0,,0,0.0,0.0,0.0,0.0,0.0
2024,10,15,2,2024-10-15,AS,5723,STL,IAH,"St. Louis, MO",Missouri,"Houston, TX",Texas,949,1632,6,5,955,1637,23,7,978,1630,2385,295,315,325,0,,0,0.0,0.0,0.0,0.0,0.0
2024,5,5,7,2024-05-05,HA,2577,STL,ATL,"St. Louis, MO",Missouri,"Atlanta, GA",Georgia,1271,1501,-8,0,1263,1501,22,13,1285,1488,1360,170,190,205,0,,0,0.0,0.0,0.0,0.0,0.0
2024,3,7,4,2024-03-07,HA,9755,EWR,DTW,"Newark, NJ",New Jersey,"Detroit, MI",Michigan,1927,2036,14,5,1941,2041,11,8,1952,2033,2548,315,335,334,0,,0,0.0,0.0,0.0,0.0,0.0
2024,1,30,2,2024-01-30,DL,9602,DFW,DEN,"Dallas/Fort Worth, TX",Texas,"Denver, CO",Colorado,1180,2094,-19,-20,1161,2074,21,13,1182,2061,2488,301,321,335,0,,0,0.0,0.0,0.0,0.0,0.0
2024,4,23,2,2024-04-23,WN,468,PDX,STL,"Portland, OR",Oregon,"St. Louis, MO",Missouri,1047,1693,-13,-20,1034,1673,25,4,1059,1669,1817,231,251,260,0,,0,0.0,0.0,0.0,0.0,0.0
2024,7,22,1,2024-07-22,AS,9555,PHX,ORD,"Phoenix, AZ",Arizona,"Chicago, IL",Illinois,728,941,1,0,729,941,25,17,754,924,2626,336,356,378,0,,0,0.0,0.0,0.0,0.0,0.0
2024,1,29,1,2024-01-29,B6,2949,SAN,PHX,"San Diego, CA",California,"Phoenix, AZ",Arizona,2169,665,26,30,2195,695,8,14,2203,681,615,82,102,104,0,,0,7.0,8.0,3.0,0.0,12.0
2024,5,10,5,2024-05-10,OO,2847,SEA,IAH,"Seattle, WA",Washington,"Houston, TX",Texas,743,1206,-18,-10,725,1196,7,9,732,1187,463,66,86,82,0,,0,0.0,0.0,0.0,0.0,0.0
2024,7,3,3,2024-07-03,AS,7662,PHL,MDW,"Philadelphia, PA",Pennsylvania,"Chicago, IL",Illinois,564,2316,1,5,565,2321,29,8,594,2313,2751,347,367,384,0,,0,0.0,0.0,0.0,0.0,0.0
2024,9,9,1,2024-09-09,UA,7239,JFK,LAS,"New York, NY",New York,"Las Vegas, NV",Nevada,1760,1693,-8,-10,1752,1683,8,13,1760,1670,2905,365,385,386,0,,0,0.0,0.0,0.0,0.0,0.0
2024,10,12,6,2024-10-12,B6,6804,JFK,LAS,"New York, NY",New York,"Las Vegas, NV",Nevada,1445,1345,-5,-5,1440,1340,18,6,1458,1334,279,29,49,53,0,,0,0.0,0.0,0.0,0.0,0.0
2024,3,2,6,2024-03-02,DL,1987,DEN,MDW,"Denver, CO",Colorado,"Chicago, IL",Illinois,1526,1884,-6,-15,1520,1869,13,16,1533,1853,1461,174,194,203,0,,0,0.0,0.0,0.0,0.0,0.0
2024,1,3,3,2024-01-03,NK,159,PDX,PHL,"Portland, OR",Oregon,"Philadelphia, PA",Pennsylvania,2023,1131,19,10,2042,1141,27,12,2069,1129,2720,344,364,383,0,,0,0.0,0.0,0.0,0.0,0.0
2024,3,8,5,2024-03-08,UA,644,BWI,LGA,"Baltimore, MD",Maryland,"New York, NY",New York,1560,2019,1,-5,1561,2014,29,17,1590,1997,2996,381,401,427,0,,0,0.0,0.0,0.0,0.0,0.0
2024,1,25,4,2024-01-25,AA,3164,DCA,JFK,"Washington, DC",District of Columbia,"New York, NY",New York,2144,1981,-6,-10,2138,1971,22,6,2160,1965,1602,202,222,230,0,,0,0.0,0.0,0.0,0.0,0.0
2024,6,27,4,2024-06-27,OH,6546,SFO,DFW,"San Francisco, CA",California,"Dallas/Fort Worth, TX",Texas,1501,957,0,5,1501,962,22,15,1523,947,742,96,116,133,0,,0,0.0,0.0,0.0,0.0,0.0
2024,5,20,1,2024-05-20,F9,5903,PDX,MIA,"Portland, OR",Oregon,"Miami, FL",Florida,1773,2015,-15,-10,1758,2005,20,10,1778,1995,598,75,95,105,0,,0,0.0,0.0,0.0,0.0,0.0
2024,8,18,7,2024-08-18,F9,1330,SFO,MIA,"San Francisco, CA",California,"Miami, FL",Florida,502,975,-14,-10,488,965,16,10,504,955,662,87,107,113,0,,0,0.0,0.0,0.0,0.0,0.0
2024,10,26,6,2024-10-26,UA,7642,ATL,DEN,"Atlanta, GA",Georgia,"Denver, CO",Colorado,1758,1809,-17,-15,1741,1794,12,15,1753,1779,1390,174,194,201,0,,0,0.0,0.0,0.0,0.0,0.0
2024,6,11,2,2024-06-11,MQ,658,MIA,STL,"Miami, FL",Florida,"St. Louis, MO",Missouri,1940,1928,18,20,1958,1948,13,13,1971,1935,1382,178,198,204,0,,0,2.0,2.0,1.0,0.0,15.0
2024,11,6,3,2024-11-06,NK,9804,SLC,IAD,"Salt Lake City, UT",Utah,"Washington, DC",District of Columbia,1454,663,-3,-10,1451,653,22,7,1473,646,1091,138,158,167,0,,0,0.0,0.0,0.0,0.0,0.0
2024,5,9,4,2024-05-09,G4,6163,TPA,ATL,"Tampa, FL",Florida,"Atlanta, GA",Georgia,1774,777,50,60,1824,837,10,4,1834,833,1204,148,168,162,0,,0,15.0,17.0,1.0,0.0,27.0
2024,9,2,1,2024-09-02,F9,8961,STL,DCA,"St. Louis, MO",Missouri,"Washington, DC",District of Columbia,642,834,-3,-10,639,824,18,17,657,807,2055,263,283,298,0,,0,0.0,0.0,0.0,0.0,0.0
2024,10,23,3,2024-10-23,UA,8549,MCO,DCA,"Orlando, FL",Florida,"Washington, DC",District of Columbia,2283,1464,-13,-20,2270,1444,10,7,2280,1437,1901,236,256,253,0,,0,0.0,0.0,0.0,0.0,0.0
2024,6,20,4,2024-06-20,HA,1170,JFK,PDX,"New York, NY",New York,"Portland, OR",Oregon,1579,1361,11,10,1590,1371,11,6,1601,1365,369,48,68,65,0,,0,0.0,0.0,0.0,0.0,0.0
2024,3,4,1,2024-03-04,MQ,1150,PDX,CLT,"Portland, OR",Oregon,"Charlotte, NC",North Carolina,560,639,-10,0,550,639,9,10,559,629,2716,339,359,358,0,,0,0.0,0.0,0.0,0.0,0.0
2024,1,31,3,2024-01-31,DL,4138,LAX,ORD,"Los Angeles, CA",California,"Chicago, IL",Illinois,567,1910,3,-5,570,1905,7,17,577,1888,1276,166,186,190,0,,0,0.0,0.0,0.0,0.0,0.0
2024,2,16,5,2024-02-16,MQ,5246,CLT,TPA,"Charlotte, NC",North Carolina,"Tampa, FL",Florida,578,1882,3,0,581,1882,14,14,595,1868,1898,235,255,263,0,,0,0.0,0.0,0.0,0.0,0.0
2024,5,9,4,2024-05-09,9E,4122,BOS,JFK,"Boston, MA",Massachusetts,"New York, NY",New York,1850,2090,-7,-10,1843,2080,20,9,1863,2071,2582,330,350,359,0,,0,0.0,0.0,0.0,0.0,0.0
2024,12,17,2,2024-12-17,NK,8436,TPA,MCO,"Tampa, FL",Florida,"Orlando, FL",Florida,866,1863,5,0,871,1863,15,18,886,1845,2043,255,275,288,0,,0,0.0,0.0,0.0,0.0,0.0
2024,11,28,4,2024-11-28,NK,2734,CLT,LGA,"Charlotte, NC",North Carolina,"New York, NY",New York,2231,2126,-5,0,2226,2126,7,10,2233,2116,818,109,129,126,0,,0,0.0,0.0,0.0,0.0,0.0
2024,4,19,5,2024-04-19,G4,7388,MSP,PHL,"Minneapolis, MN",Minnesota,"Philadelphia, PA",Pennsylvania,1457,2207,-9,-15,1448,2192,19,16,1467,2176,1827,225,245,260,0,,0,0.0,0.0,0.0,0.0,0.0
2024,3,9,6,2024-03-09,B6,9092,DEN,CLT,"Denver, CO",Colorado,"Charlotte, NC",North Carolina,2230,2165,17,15,2247,2180,16,10,2263,2170,2599,331,351,357,0,,0,0.0,0.0,0.0,0.0,0.0
2024,2,27,2,2024-02-27,WN,1585,DEN,SAN,"Denver, CO",Colorado,"San Diego, CA",California,2058,950,8,0,2066,950,26,18,2092,932,1338,170,190,214,0,,0,0.0,0.0,0.0,0.0,0.0
2024,4,15,1,2024-04-15,F9,2923,IAH,STL,"Houston, TX",Texas,"St. Louis, MO",Missouri,1025,1140,-1,-10,1024,1130,5,11,1029,1119,1157,152,172,168,0,,0,0.0,0.0,0.0,0.0,0.0
2024,10,26,6,2024-10-26,OH,772,HNL,MIA,"Honolulu, HI",Hawaii,"Miami, FL",Florida,889,1565,-14,-5,875,1560,17,3,892,1557,350,33,53,53,0,,0,0.0,0.0,0.0,0.0,0.0
2024,11,25,1,2024-11-25,WN,4522,PHX,JFK,"Phoenix, AZ",Arizona,"New York, NY",New York,1812,1935,9,10,1821,1945,20,10,1841,1935,2839,349,369,379,0,,0,0.0,0.0,0.0,0.0,0.0
2024,9,12,4,2024-09-12,WN,1514,DCA,SFO,"Washington, DC",District of Columbia,"San Francisco, CA",California,1020,1561,-7,-5,1013,1556,28,9,1041,1547,1666,215,235,252,0,,0,0.0,0.0,0.0,0.0,0.0
2024,11,7,4,2024-11-07,YX,6215,MIA,LGA,"Miami, FL",Florida,"New York, NY",New York,2175,2222,1,0,2176,2222,11,10,2187,2212,924,121,141,142,0,,0,0.0,0.0,0.0,0.0,0.0
2024,6,19,3,2024-06-19,OH,3994,PDX,JFK,"Portland, OR",Oregon,"New York, NY",New York,2277,1731,12,15,2289,1746,11,15,2300,1731,2422,305,325,331,1,,0,0.0,0.0,0.0,0.0,0.0
2024,6,10,1,2024-06-10,YX,3946,MDW,SEA,"Chicago, IL",Illinois,"Seattle, WA",Washington,752,1430,3,5,755,1435,10,5,765,1430,1243,164,184,179,0,,0,0.0,0.0,0.0,0.0,0.0
2024,10,12,6,2024-10-12,DL,9486,EWR,LGA,"Newark, NJ",New Jersey,"New York, NY",New York,2262,629,5,5,2267,634,7,4,2274,630,1953,246,266,257,0,,0,0.0,0.0,0.0,0.0,0.0
2024,3,11,1,2024-03-11,MQ,2124,LGA,IAH,"New York, NY",New York,"Houston, TX",Texas,1618,908,-20,-10,1598,898,16,15,1614,883,472,63,83,94,0,,0,0.0,0.0,0.0,0.0,0.0
2024,9,11,3,2024-09-11,HA,1457,MIA,HNL,"Miami, FL",Florida,"Honolulu, HI",Hawaii,2214,2109,5,5,2219,2114,13,6,2232,2108,2272,281,301,300,0,,0,0.0,0.0,0.0,0.0,0.0
2024,2,24,6,2024-02-24,AA,7576,ORD,MCO,"Chicago, IL",Illinois,"Orlando, FL",Florida,502,645,3,-5,505,640,15,4,520,636,2571,329,349,348,0,,0,0.0,0.0,0.0,0.0,0.0
2024,11,18,1,2024-11-18,WN,8148,DFW,TPA,"Dallas/Fort Worth, TX",Texas,"Tampa, FL",Florida,1195,1982,6,15,1201,1997,10,9,1211,1988,1315,161,181,180,0,,0,0.0,0.0,0.0,0.0,0.0
2024,1,3,3,2024-01-03,NK,668,BOS,STL,"Boston, MA",Massachusetts,"St. Louis, MO",Missouri,545,736,-12,-15,533,721,16,11,549,710,2696,343,363,370,0,,0,0.0,0.0,0.0,0.0,0.0
2024,1,26,5,2024-01-26,YX,6590,IAD,IAH,"Washington, DC",District of Columbia,"Houston, TX",Texas,1152,1374,-17,-10,1135,1364,20,11,1155,1353,324,38,58,69,0,,0,0.0,0.0,0.0,0.0,0.0
2024,11,8,5,2024-11-08,G4,7569,EWR,STL,"Newark, NJ",New Jersey,"St. Louis, MO",Missouri,1024,2198,-6,-15,1018,2183,26,13,1044,2170,2325,297,317,336,0,,0,0.0,0.0,0.0,0.0,0.0
2024,5,5,7,2024-05-05,G4,2045,MDW,BWI,"Chicago, IL",Illinois,"Baltimore, MD",Maryland,2221,2054,-1,-5,2220,2049,26,15,2246,2034,733,89,109,130,0,,0,0.0,0.0,0.0,0.0,0.0
2024,2,22,4,2024-02-22,YX,8638,CLT,MSP,"Charlotte, NC",North Carolina,"Minneapolis, MN",Minnesota,2005,1155,-24,-15,1981,1140,26,10,2007,1130,1622,194,214,230,0,,0,0.0,0.0,0.0,0.0,0.0
2024,7,16,2,2024-07-16,9E,507,LAX,MCO,"Los Angeles, CA",California,"Orlando, FL",Florida,2120,1874,15,10,2135,1884,10,16,2145,1868,571,76,96,102,0,,0,0.0,0.0,0.0,0.0,0.0
2024,10,25,5,2024-10-25,HA,4328,IAD,SFO,"Washington, DC",District of Columbia,"San Francisco, CA",California,917,1032,8,15,925,1047,16,7,941,1040,2822,348,368,371,0,,0,0.0,0.0,0.0,0.0,0.0
2024,7,6,6,2024-07-06,AA,8905,HNL,EWR,"Honolulu, HI",Hawaii,"Newark, NJ",New Jersey,1501,1446,-4,5,1497,1451,8,18,1505,1433,1459,188,208,214,0,,0,0.0,0.0,0.0,0.0,0.0
2024,7,4,4,2024-07-04,B6,7231,MIA,IAD,"Miami, FL",Florida,"Washington, DC",District of Columbia,1566,806,-11,-15,1555,791,22,9,1577,782,2422,305,325,336,0,,0,0.0,0.0,0.0,0.0,0.0
2024,10,31,4,2024-10-31,NK,8397,DCA,IAH,"Washington, DC",District of Columbia,"Houston, TX",Texas,1395,1045,3,-5,1398,1040,21,16,1419,1024,617,77,97,114,0,,0,0.0,0.0,0.0,0.0,0.0
2024,10,24,4,2024-10-24,MQ,2318,PDX,DTW,"Portland, OR",Oregon,"Detroit, MI",Michigan,2191,1682,28,20,2219,1702,12,7,2231,1695,2852,359,379,378,0,,0,3.0,3.0,1.0,0.0,13.0
2024,7,22,1,2024-07-22,NK,7811,SFO,BWI,"San Francisco, CA",California,"Baltimore, MD",Maryland,1195,1829,-10,-15,1185,1814,17,18,1202,1796,2333,287,307,322,0,,0,0.0,0.0,0.0,0.0,0.0
2024,1,11,4,2024-01-11,9E,4457,PDX,SAN,"Portland, OR",Oregon,"San Diego, CA",California,1058,930,1,0,1059,930,9,9,1068,921,270,38,58,56,0,,0,0.0,0.0,0.0,0.0,0.0
2024,12,24,2,2024-12-24,AS,593,STL,PHX,"St. Louis, MO",Missouri,"Phoenix, AZ",Arizona,1430,1195,-13,-5,1417,1190,7,18,1424,1172,1416,167,187,192,0,,0,0.0,0.0,0.0,0.0,0.0
2024,12,19,4,2024-12-19,OO,3968,MDW,DTW,"Chicago, IL",Illinois,"Detroit, MI",Michigan,1729,1124,129,120,1858,1244,29,14,1887,1230,2993,383,403,426,0,,0,28.0,8.0,13.0,4.0,67.0
2024,5,25,6,2024-05-25,9E,4485,BWI,DEN,"Baltimore, MD",Maryland,"Denver, CO",Colorado,2245,1348,-6,-10,2239,1338,23,18,2262,1320,1081,134,154,175,0,,0,0.0,0.0,0.0,0.0,0.0
2024,3,25,1,2024-03-25,WN,5533,BOS,SAN,"Boston, MA",Massachusetts,"San Diego, CA",California,1798,1781,-24,-20,1774,1761,9,19,1783,1742,463,57,77,85,0,,0,0.0,0.0,0.0,0.0,0.0
2024,4,9,2,2024-04-09,UA,6328,EWR,LAS,"Newark, NJ",New Jersey,"Las Vegas, NV",Nevada,1094,1727,3,5,1097,1732,22,10,1119,1722,2206,279,299,311,0,,0,0.0,0.0,0.0,0.0,0.0
2024,4,13,6,2024-04-13,YX,1538,SAN,DTW,"San Diego, CA",California,"Detroit, MI",Michigan,1620,958,-1,-5,1619,953,10,14,1629,939,2919,371,391,395,0,,0,0.0,0.0,0.0,0.0,0.0
2024,2,15,4,2024-02-15,MQ,1452,DFW,HNL,"Dallas/Fort Worth, TX",Texas,"Honolulu, HI",Hawaii,1702,1451,14,5,1716,1456,13,7,1729,1449,288,41,61,61,0,,0,0.0,0.0,0.0,0.0,0.0
2024,2,13,2,2024-02-13,G4,8336,MCO,STL,"Orlando, FL",Florida,"St. Louis, MO",Missouri,1366,1988,-13,-15,1353,1973,21,6,1374,1967,2371,299,319,326,0,,0,0.0,0.0,0.0,0.0,0.0
2024,10,4,5,2024-10-04,HA,5010,IAH,DCA,"Houston, TX",Texas,"Washington, DC",District of Columbia,1671,1154,-4,0,1667,1154,15,14,1682,1140,2127,259,279,288,0,,0,0.0,0.0,0.0,0.0,0.0
2024,6,29,6,2024-06-29,YX,2480,BOS,DCA,"Boston, MA",Massachusetts,"Washington, DC",District of Columbia,883,1802,0,-5,883,1797,19,6,902,1791,1951,247,267,272,0,,0,0.0,0.0,0.0,0.0,0.0
2024,7,5,5,2024-07-05,MQ,4660,DCA,STL,"Washington, DC",District of Columbia,"St. Louis, MO",Missouri,1595,957,-1,0,1594,957,23,9,1617,948,2091,262,282,294,0,,0,0.0,0.0,0.0,0.0,0.0
2024,4,23,2,2024-04-23,9E,299,ATL,LGA,"Atlanta, GA",Georgia,"New York, NY",New York,716,1887,1,10,717,1897,20,9,737,1888,2444,310,330,339,0,,0,0.0,0.0,0.0,0.0,0.0
2024,9,11,3,2024-09-11,WN,4524,ORD,LAS,"Chicago, IL",Illinois,"Las Vegas, NV",Nevada,2244,1354,28,20,2272,1374,5,5,2277,1369,2540,326,346,336,0,,0,5.0,2.0,2.0,0.0,11.0
2024,1,30,2,2024-01-30,F9,7947,MCO,MIA,"Orlando, FL",Florida,"Miami, FL",Florida,1332,1148,0,5,1332,1153,19,15,1351,1138,671,83,103,117,0,,0,0.0,0.0,0.0,0.0,0.0
2024,9,20,5,2024-09-20,MQ,4897,PHL,JFK,"Philadelphia, PA",Pennsylvania,"New York, NY",New York,1305,1976,12,5,1317,1981,25,16,1342,1965,2566,329,349,370,0,,0,0.0,0.0,0.0,0.0,0.0
2024,4,7,7,2024-04-07,AA,6900,DTW,MDW,"Detroit, MI",Michigan,"Chicago, IL",Illinois,1956,1987,-9,0,1947,1987,9,9,1956,1978,945,123,143,141,0,,0,0.0,0.0,0.0,0.0,0.0
2024,11,8,5,2024-11-08,NK,7626,MCO,LAS,"Orlando, FL",Florida,"Las Vegas, NV",Nevada,2159,1873,-25,-15,2134,1858,24,15,2158,1843,706,85,105,124,0,,0,0.0,0.0,0.0,0.0,0.0
2024,11,24,7,2024-11-24,YX,6120,ATL,BOS,"Atlanta, GA",Georgia,"Boston, MA",Massachusetts,2024,1743,9,5,2033,1748,9,16,2042,1732,2352,291,311,316,0,,0,0.0,0.0,0.0,0.0,0.0
2024,4,24,3,2024-04-24,AS,2868,IAH,DCA,"Houston, TX",Texas,"Washington, DC",District of Columbia,2191,1815,-16,-15,2175,1800,20,19,2195,1781,2498,303,323,342,0,,0,0.0,0.0,0.0,0.0,0.0
2024,10,2,3,2024-10-02,MQ,2507,LAX,BOS,"Los Angeles, CA",California,"Boston, MA",Massachusetts,1556,1406,-18,-10,1538,1396,12,17,1550,1379,841,98,118,127,0,,0,0.0,0.0,0.0,0.0,0.0
2024,10,7,1,2024-10-07,YX,5597,HNL,CLT,"Honolulu, HI",Hawaii,"Charlotte, NC",North Carolina,1280,1685,4,5,1284,1690,28,11,1312,1679,295,28,48,67,0,,0,0.0,0.0,0.0,0.0,0.0
2024,10,1,2,2024-10-01,AA,3891,MIA,DCA,"Miami, FL",Florida,"Washington, DC",District of Columbia,715,1833,-3,5,712,1838,10,4,722,1834,1950,241,261,255,0,,0,0.0,0.0,0.0,0.0,0.0
2024,9,17,2,2024-09-17,HA,3393,PDX,MDW,"Portland, OR",Oregon,"Chicago, IL",Illinois,600,651,-10,-5,590,646,16,5,606,641,2279,289,309,310,0,,0,0.0,0.0,0.0,0.0,0.0
2024,11,26,2,2024-11-26,WN,2946,PHX,CLT,"Phoenix, AZ",Arizona,"Charlotte, NC",North Carolina,969,2345,-4,5,965,2350,8,10,973,2340,1207,152,172,170,0,,0,0.0,0.0,0.0,0.0,0.0
2024,7,25,4,2024-07-25,YX,7942,DTW,TPA,"Detroit, MI",Michigan,"Tampa, FL",Florida,679,912,13,15,692,927,20,13,712,914,1802,227,247,260,0,,0,0.0,0.0,0.0,0.0,0.0
2024,11,23,6,2024-11-23,HA,6608,JFK,CLT,"New York, NY",New York,"Charlotte, NC",North Carolina,1138,1902,-3,0,1135,1902,15,12,1150,1890,1689,206,226,233,0,,0,0.0,0.0,0.0,0.0,0.0
2024,7,29,1,2024-07-29,OH,3411,DCA,ORD,"Washington, DC",District of Columbia,"Chicago, IL",Illinois,1856,987,-5,5,1851,992,17,13,1868,979,1073,143,163,173,0,,0,0.0,0.0,0.0,0.0,0.0
2024,8,2,5,2024-08-02,B6,9729,JFK,DFW,"New York, NY",New York,"Dallas/Fort Worth, TX",Texas,2011,1825,-4,-10,2007,1815,24,5,2031,1810,682,78,98,107,0,,0,0.0,0.0,0.0,0.0,0.0
2024,2,9,5,2024-02-09,OO,226,LAX,DTW,"Los Angeles, CA",California,"Detroit, MI",Michigan,1983,738,22,20,2005,758,19,14,2024,744,803,108,128,141,0,,0,7.0,1.0,3.0,0.0,9.0
2024,1,26,5,2024-01-26,F9,5706,TPA,CLT,"Tampa, FL",Florida,"Charlotte, NC",North Carolina,876,618,-16,-10,860,608,25,11,885,597,2715,340,360,376,0,,0,0.0,0.0,0.0,0.0,0.0
2024,1,27,6,2024-01-27,HA,9912,MDW,DCA,"Chicago, IL",Illinois,"Washington, DC",District of Columbia,1180,920,6,10,1186,930,9,14,1195,916,840,97,117,120,0,,0,0.0,0.0,0.0,0.0,0.0
2024,7,8,1,2024-07-08,WN,7794,LAX,SEA,"Los Angeles, CA",California,"Seattle, WA",Washington,1316,694,13,15,1329,709,17,16,1346,693,625,72,92,105,0,,0,0.0,0.0,0.0,0.0,0.0
2024,3,23,6,2024-03-23,UA,3419,PDX,CLT,"Portland, OR",Oregon,"Charlotte, NC",North Carolina,1658,729,8,5,1666,734,6,15,1672,719,1179,141,161,162,0,,0,0.0,0.0,0.0,0.0,0.0
2024,6,18,2,2024-06-18,DL,8773,LGA,SEA,"New York, NY",New York,"Seattle, WA",Washington,2128,1728,18,10,2146,1738,16,10,2162,1728,1496,187,207,213,0,,0,0.0,0.0,0.0,0.0,0.0
2024,6,15,6,2024-06-15,WN,5531,TPA,HNL,"Tampa, FL",Florida,"Honolulu, HI",Hawaii,2256,1544,-10,0,2246,1544,10,5,2256,1539,1174,149,169,164,0,,0,0.0,0.0,0.0,0.0,0.0
2024,7,6,6,2024-07-06,OO,4478,EWR,BOS,"Newark, NJ",New Jersey,"Boston, MA",Massachusetts,1933,1820,7,15,1940,1835,27,8,1967,1827,2226,284,304,319,0,,0,0.0,0.0,0.0,0.0,0.0
2024,6,17,1,2024-06-17,9E,7269,SLC,MCO,"Salt Lake City, UT",Utah,"Orlando, FL",Florida,1678,859,10,5,1688,864,7,18,1695,846,1911,234,254,259,0,,0,0.0,0.0,0.0,0.0,0.0
2024,10,15,2,2024-10-15,OH,2221,LAS,STL,"Las Vegas, NV",Nevada,"St. Louis, MO",Missouri,779,1586,-8,-5,771,1581,14,16,785,1565,1693,207,227,237,0,,0,0.0,0.0,0.0,0.0,0.0
2024,8,16,5,2024-08-16,MQ,3235,SAN,EWR,"San Diego, CA",California,"Newark, NJ",New Jersey,2002,1662,-24,-20,1978,1642,24,3,2002,1639,1367,162,182,189,0,,0,0.0,0.0,0.0,0.0,0.0
2024,4,6,6,2024-04-06,WN,6590,SFO,PHX,"San Francisco, CA",California,"Phoenix, AZ",Arizona,1722,2124,0,0,1722,2124,29,10,1751,2114,2984,368,388,407,0,,0,0.0,0.0,0.0,0.0,0.0
2024,1,16,2,2024-01-16,MQ,6240,TPA,MIA,"Tampa, FL",Florida,"Miami, FL",Florida,1348,1416,14,10,1362,1426,8,8,1370,1418,1055,134,154,150,0,,0,0.0,0.0,0.0,0.0,0.0
2024,10,5,6,2024-10-05,9E,338,SAN,ATL,"San Diego, CA",California,"Atlanta, GA",Georgia,1252,1754,12,10,1264,1764,14,7,1278,1757,1883,241,261,262,0,,0,0.0,0.0,0.0,0.0,0.0
2024,5,14,2,2024-05-14,B6,1520,TPA,PDX,"Tampa, FL",Florida,"Portland, OR",Oregon,1940,753,19,10,1959,763,11,9,1970,754,1125,136,156,156,0,,0,0.0,0.0,0.0,0.0,0.0
2024,1,26,5,2024-01-26,MQ,440,IAH,MSP,"Houston, TX",Texas,"Minneapolis, MN",Minnesota,1621,1152,-15,-10,1606,1142,22,3,1628,1139,1384,182,202,207,0,,0,0.0,0.0,0.0,0.0,0.0
2024,12,17,2,2024-12-17,NK,7620,DFW,IAH,"Dallas/Fort Worth, TX",Texas,"Houston, TX",Texas,749,1944,-11,-5,738,1939,25,15,763,1924,2848,347,367,387,0,,0,0.0,0.0,0.0,0.0,0.0
2024,1,12,5,2024-01-12,G4,5087,TPA,MIA,"Tampa, FL",Florida,"Miami, FL",Florida,1413,721,-7,0,1406,721,26,18,1432,703,1397,181,201,225,0,,0,0.0,0.0,0.0,0.0,0.0
2024,3,12,2,2024-03-12,DL,9778,DEN,JFK,"Denver, CO",Colorado,"New York, NY",New York,1628,1356,13,5,1641,1361,18,14,1659,1347,2495,308,328,340,0,,0,0.0,0.0,0.0,0.0,0.0
2024,5,12,7,2024-05-12,B6,4175,CLT,LAX,"Charlotte, NC",North Carolina,"Los Angeles, CA",California,1272,1767,-1,-5,1271,1762,22,16,1293,1746,960,122,142,160,1,,0,0.0,0.0,0.0,0.0,0.0
2024,4,15,1,2024-04-15,OO,5512,DEN,CLT,"Denver, CO",Colorado,"Charlotte, NC",North Carolina,1140,1809,-1,5,1139,1814,5,17,1144,1797,2923,373,393,395,0,,0,0.0,0.0,0.0,0.0,0.0
2024,8,7,3,2024-08-07,9E,9024,JFK,TPA,"New York, NY",New York,"Tampa, FL",Florida,826,1146,0,0,826,1146,29,14,855,1132,2967,365,385,408,0,,0,0.0,0.0,0.0,0.0,0.0
2024,6,25,2,2024-06-25,G4,3578,DCA,MSP,"Washington, DC",District of Columbia,"Minneapolis, MN",Minnesota,1389,1834,7,0,1396,1834,27,19,1423,1815,751,101,121,147,0,,0,0.0,0.0,0.0,0.0,0.0
2024,10,8,2,2024-10-08,YX,8453,SEA,MIA,"Seattle, WA",Washington,"Miami, FL",Florida,2005,999,4,5,2009,1004,28,11,2037,993,2497,319,339,358,0,,0,0.0,0.0,0.0,0.0,0.0
2024,5,12,7,2024-05-12,OH,7770,BWI,TPA,"Baltimore, MD",Maryland,"Tampa, FL",Florida,1270,1656,5,0,1275,1656,25,6,1300,1650,273,30,50,61,0,,0,0.0,0.0,0.0,0.0,0.0
2024,1,22,1,2024-01-22,MQ,2595,BWI,SAN,"Baltimore, MD",Maryland,"San Diego, CA",California,876,1782,-17,-10,859,1772,25,14,884,1758,1325,156,176,195,0,,0,0.0,0.0,0.0,0.0,0.0
2024,9,25,3,2024-09-25,UA,7962,BOS,JFK,"Boston, MA",Massachusetts,"New York, NY",New York,2175,1005,18,10,2193,1015,21,13,2214,1002,474,53,73,87,0,,0,0.0,0.0,0.0,0.0,0.0
2024,6,9,7,2024-06-09,AA,8152,EWR,PHX,"Newark, NJ",New Jersey,"Phoenix, AZ",Arizona,1538,963,-16,-10,1522,953,7,4,1529,949,1023,126,146,137,0,,0,0.0,0.0,0.0,0.0,0.0
2024,4,16,2,2024-04-16,DL,8423,SEA,MSP,"Seattle, WA",Washington,"Minneapolis, MN",Minnesota,1195,1579,9,5,1204,1584,19,16,1223,1568,2502,319,339,354,0,,0,0.0,0.0,0.0,0.0,0.0
2024,10,5,6,2024-10-05,OH,1957,IAH,HNL,"Houston, TX",Texas,"Honolulu, HI",Hawaii,980,2327,-15,-10,965,2317,18,14,983,2303,1609,198,218,230,0,,0,0.0,0.0,0.0,0.0,0.0
2024,12,18,3,2024-12-18,AS,9534,SLC,DFW,"Salt Lake City, UT",Utah,"Dallas/Fort Worth, TX",Texas,1539,762,-4,5,1535,767,11,4,1546,763,2798,349,369,364,0,,0,0.0,0.0,0.0,0.0,0.0
2024,8,22,4,2024-08-22,B6,8963,SLC,STL,"Salt Lake City, UT",Utah,"St. Louis, MO",Missouri,2256,1363,9,10,2265,1373,14,13,2279,1360,2131,271,291,298,0,,0,0.0,0.0,0.0,0.0,0.0
2024,1,18,4,2024-01-18,AA,604,TPA,MCO,"Tampa, FL",Florida,"Orlando, FL",Florida,1074,1150,-11,-20,1063,1130,29,7,1092,1123,1135,132,152,168,0,,0,0.0,0.0,0.0,0.0,0.0
2024,8,29,4,2024-08-29,AA,7567,MCO,EWR,"Orlando, FL",Florida,"Newark, NJ",New Jersey,2276,730,15,20,2291,750,12,16,2303,734,2900,360,380,388,0,,0,3.0,3.0,2.0,0.0,12.0
2024,4,26,5,2024-04-26,OO,2256,BWI,LGA,"Baltimore, MD",Maryland,"New York, NY",New York,984,1719,-12,-20,972,1699,15,17,987,1682,1448,184,204,216,0,,0,0.0,0.0,0.0,0.0,0.0
2024,10,12,6,2024-10-12,WN,9553,MCO,LGA,"Orlando, FL",Florida,"New York, NY",New York,1802,1252,-25,-20,1777,1232,9,5,1786,1227,2319,298,318,312,0,,0,0.0,0.0,0.0,0.0,0.0
2024,10,8,2,2024-10-08,YX,8584,DTW,MSP,"Detroit, MI",Michigan,"Minneapolis, MN",Minnesota,1856,1607,14,10,1870,1617,7,19,1877,1598,2110,272,292,298,0,,0,0.0,0.0,0.0,0.0,0.0
2024,5,23,4,2024-05-23,HA,5023,TPA,IAH,"Tampa, FL",Florida,"Houston, TX",Texas,1439,869,-5,5,1434,874,29,8,1463,866,2173,269,289,306,0,,0,0.0,0.0,0.0,0.0,0.0
2024,7,23,2,2024-07-23,WN,9351,MDW,LGA,"Chicago, IL",Illinois,"New York, NY",New York,756,2304,-18,-15,738,2289,24,9,762,2280,1946,239,259,272,0,,0,0.0,0.0,0.0,0.0,0.0
2024,2,8,4,2024-02-08,HA,5654,ATL,PHX,"Atlanta, GA",Georgia,"Phoenix, AZ",Arizona,1708,1503,15,15,1723,1518,13,15,1736,1503,1692,209,229,237,0,,0,0.0,0.0,0.0,0.0,0.0
2024,6,2,7,2024-06-02,AS,5838,DCA,SEA,"Washington, DC",District of Columbia,"Seattle, WA",Washington,2111,1990,8,5,2119,1995,23,3,2142,1992,1523,190,210,216,0,,0,0.0,0.0,0.0,0.0,0.0
2024,6,24,1,2024-06-24,AS,2895,PHX,LAS,"Phoenix, AZ",Arizona,"Las Vegas, NV",Nevada,526,1386,-25,-15,501,1371,11,15,512,1356,1020,123,143,149,0,,0,0.0,0.0,0.0,0.0,0.0
2024,8,28,3,2024-08-28,9E,9493,LAS,EWR,"Las Vegas, NV",Nevada,"Newark, NJ",New Jersey,1548,964,13,10,1561,974,5,8,1566,966,2183,266,286,279,0,,0,0.0,0.0,0.0,0.0,0.0
2024,5,13,1,2024-05-13,OH,7000,MCO,TPA,"Orlando, FL",Florida,"Tampa, FL",Florida,1585,2057,-1,0,1584,2057,14,19,1598,2038,771,89,109,122,0,,0,0.0,0.0,0.0,0.0,0.0
2024,2,15,4,2024-02-15,AS,2260,CLT,MSP,"Charlotte, NC",North Carolina,"Minneapolis, MN",Minnesota,2181,1210,-4,-10,2177,1200,16,8,2193,1192,402,50,70,74,0,,0,0.0,0.0,0.0,0.0,0.0
2024,2,19,1,2024-02-19,AA,7433,DEN,MIA,"Denver, CO",Colorado,"Miami, FL",Florida,732,1684,10,10,742,1694,19,6,761,1688,2682,328,348,353,0,,0,0.0,0.0,0.0,0.0,0.0
2024,6,14,5,2024-06-14,9E,7771,MSP,JFK,"Minneapolis, MN",Minnesota,"New York, NY",New York,1987,1531,4,5,1991,1536,25,8,2016,1528,2848,362,382,395,0,,0,0.0,0.0,0.0,0.0,0.0
2024,4,15,1,2024-04-15,G4,6321,SEA,LAS,"Seattle, WA",Washington,"Las Vegas, NV",Nevada,848,1946,4,0,852,1946,29,3,881,1943,2728,347,367,379,0,,0,0.0,0.0,0.0,0.0,0.0
2024,8,3,6,2024-08-03,OO,9010,MCO,PDX,"Orlando, FL",Florida,"Portland, OR",Oregon,1809,2352,11,10,1820,2362,29,3,1849,2359,2352,291,311,323,0,,0,0.0,0.0,0.0,0.0,0.0
2024,5,25,6,2024-05-25,NK,9169,DFW,IAH,"Dallas/Fort Worth, TX",Texas,"Houston, TX",Texas,913,1188,2,10,915,1198,26,15,941,1183,1884,230,250,271,0,,0,0.0,0.0,0.0,0.0,0.0
2024,3,12,2,2024-03-12,NK,3367,SAN,PHL,"San Diego, CA",California,"Philadelphia, PA",Pennsylvania,2119,807,-3,-10,2116,797,15,9,2131,788,917,120,140,144,0,,0,0.0,0.0,0.0,0.0,0.0
2024,11,25,1,2024-11-25,OO,4597,TPA,MDW,"Tampa, FL",Florida,"Chicago, IL",Illinois,2210,947,6,10,2216,957,10,13,2226,944,1207,150,170,173,0,,0,0.0,0.0,0.0,0.0,0.0
2024,9,29,7,2024-09-29,NK,7076,TPA,MIA,"Tampa, FL",Florida,"Miami, FL",Florida,905,644,-5,-5,900,639,7,14,907,625,1286,161,181,182,0,,0,0.0,0.0,0.0,0.0,0.0
2024,9,3,2,2024-09-03,DL,8355,MCO,ORD,"Orlando, FL",Florida,"Chicago, IL",Illinois,1904,946,2,-5,1906,941,13,11,1919,930,304,35,55,59,0,,0,0.0,0.0,0.0,0.0,0.0
2024,7,4,4,2024-07-04,DL,2799,STL,PHL,"St. Louis, MO",Missouri,"Philadelphia, PA",Pennsylvania,1693,1313,26,20,1719,1333,21,15,1740,1318,774,86,106,122,0,,0,7.0,2.0,1.0,0.0,10.0
2024,3,10,7,2024-03-10,AS,5644,DTW,ORD,"Detroit, MI",Michigan,"Chicago, IL",Illinois,1813,2345,10,5,1823,2350,27,9,1850,2341,2788,345,365,381,0,,0,0.0,0.0,0.0,0.0,0.0
2024,5,29,3,2024-05-29,NK,472,SFO,BOS,"San Francisco, CA",California,"Boston, MA",Massachusetts,1458,1246,-13,-5,1445,1241,23,7,1468,1234,472,67,87,97,0,,0,0.0,0.0,0.0,0.0,0.0
2024,9,2,1,2024-09-02,UA,4127,LAX,LGA,"Los Angeles, CA",California,"New York, NY",New York,1015,968,2,0,1017,968,6,18,1023,950,1336,175,195,199,0,,0,0.0,0.0,0.0,0.0,0.0
2024,9,18,3,2024-09-18,MQ,8597,SAN,MSP,"San Diego, CA",California,"Minneapolis, MN",Minnesota,1509,1133,-3,0,1506,1133,25,14,1531,1119,1611,194,214,233,0,,0,0.0,0.0,0.0,0.0,0.0
2024,1,26,5,2024-01-26,WN,2614,PHL,STL,"Philadelphia, PA",Pennsylvania,"St. Louis, MO",Missouri,786,957,-21,-15,765,942,9,3,774,939,2821,349,369,361,0,,0,0.0,0.0,0.0,0.0,0.0
2024,5,19,7,2024-05-19,OH,1031,ATL,SEA,"Atlanta, GA",Georgia,"Seattle, WA",Washington,806,1094,6,10,812,1104,22,10,834,1094,565,77,97,109,0,,0,0.0,0.0,0.0,0.0,0.0
2024,4,8,1,2024-04-08,YX,7571,ATL,CLT,"Atlanta, GA",Georgia,"Charlotte, NC",North Carolina,1061,1504,18,10,1079,1514,16,6,1095,1508,2205,266,286,288,0,,0,0.0,0.0,0.0,0.0,0.0
2024,10,4,5,2024-10-04,UA,2090,DFW,IAH,"Dallas/Fort Worth, TX",Texas,"Houston, TX",Texas,1281,659,13,5,1294,664,28,19,1322,645,661,72,92,119,0,,0,0.0,0.0,0.0,0.0,0.0
2024,2,20,2,2024-02-20,NK,3756,MCO,DEN,"Orlando, FL",Florida,"Denver, CO",Colorado,1531,897,1,0,1532,897,19,5,1551,892,1685,207,227,231,0,,0,0.0,0.0,0.0,0.0,0.0
2024,5,30,4,2024-05-30,NK,9707,DCA,MSP,"Washington, DC",District of Columbia,"Minneapolis, MN",Minnesota,856,658,-12,-10,844,648,18,10,862,638,567,68,88,96,0,,0,0.0,0.0,0.0,0.0,0.0
2024,4,13,6,2024-04-13,WN,6890,PHX,BOS,"Phoenix, AZ",Arizona,"Boston, MA",Massachusetts,1080,2047,16,10,1096,2057,6,3,1102,2054,1664,217,237,226,0,,0,0.0,0.0,0.0,0.0,0.0
2024,3,29,5,2024-03-29,MQ,8653,MCO,SEA,"Orlando, FL",Florida,"Seattle, WA",Washington,638,830,-6,-5,632,825,28,11,660,814,1808,223,243,262,0,,0,0.0,0.0,0.0,0.0,0.0
2024,5,20,1,2024-05-20,NK,5483,DEN,MCO,"Denver, CO",Colorado,"Orlando, FL",Florida,2034,1396,-13,-20,2021,1376,26,4,2047,1372,1033,133,153,163,0,,0,0.0,0.0,0.0,0.0,0.0
2024,7,31,3,2024-07-31,B6,815,BWI,MIA,"Baltimore, MD",Maryland,"Miami, FL",Florida,1771,2318,20,30,1791,2348,14,12,1805,2336,2649,334,354,360,0,,0,3.0,6.0,2.0,0.0,19.0
2024,8,20,2,2024-08-20,AA,9937,LGA,PDX,"New York, NY",New York,"Portland, OR",Oregon,2064,1047,14,10,2078,1057,24,16,2102,1041,935,107,127,147,0,,0,0.0,0.0,0.0,0.0,0.0
2024,7,1,1,2024-07-01,9E,8834,LAX,HNL,"Los Angeles, CA",California,"Honolulu, HI",Hawaii,1706,1212,0,0,1706,1212,7,3,1713,1209,2640,330,350,340,0,,0,0.0,0.0,0.0,0.0,0.0
2024,9,7,6,2024-09-07,WN,1647,LAX,PHL,"Los Angeles, CA",California,"Philadelphia, PA",Pennsylvania,2248,2249,-27,-20,2221,2229,13,12,2234,2217,1331,162,182,187,0,,0,0.0,0.0,0.0,0.0,0.0
2024,1,9,2,2024-01-09,NK,8092,PDX,DTW,"Portland, OR",Oregon,"Detroit, MI",Michigan,922,967,-15,-10,907,957,19,10,926,947,651,84,104,113,0,,0,0.0,0.0,0.0,0.0,0.0
2024,3,19,2,2024-03-19,MQ,751,SFO,STL,"San Francisco, CA",California,"St. Louis, MO",Missouri,896,1153,2,0,898,1153,26,5,924,1148,2698,336,356,367,0,,0,0.0,0.0,0.0,0.0,0.0
2024,2,21,3,2024-02-21,HA,1150,CLT,TPA,"Charlotte, NC",North Carolina,"Tampa, FL",Florida,1331,1652,-3,0,1328,1652,25,15,1353,1637,1855,234,254,274,0,,0,0.0,0.0,0.0,0.0,0.0
2024,9,25,3,2024-09-25,DL,4842,DCA,LGA,"Washington, DC",District of Columbia,"New York, NY",New York,804,1587,1,5,805,1592,7,5,812,1587,2165,278,298,290,0,,0,0.0,0.0,0.0,0.0,0.0
2024,8,13,2,2024-08-13,DL,5144,MSP,CLT,"Minneapolis, MN",Minnesota,"Charlotte, NC",North Carolina,1542,876,-1,5,1541,881,23,9,1564,872,933,124,144,156,0,,0,0.0,0.0,0.0,0.0,0.0
2024,2,20,2,2024-02-20,AA,5156,DCA,SEA,"Washington, DC",District of Columbia,"Seattle, WA",Washington,1906,1208,-6,0,1900,1208,10,13,1910,1195,2591,329,349,352,0,,0,0.0,0.0,0.0,0.0,0.0
2024,7,4,4,2024-07-04,DL,9094,PHX,ATL,"Phoenix, AZ",Arizona,"Atlanta, GA",Georgia,725,1302,10,5,735,1307,24,16,759,1291,1416,167,187,207,0,,0,0.0,0.0,0.0,0.0,0.0
2024,2,3,6,2024-02-03,9E,7361,BWI,ORD,"Baltimore, MD",Maryland,"Chicago, IL",Illinois,1753,2002,5,10,1758,2012,8,9,1766,2003,1879,234,254,251,0,,0,0.0,0.0,0.0,0.0,0.0
2024,10,17,4,2024-10-17,OH,1780,DCA,JFK,"Washington, DC",District of Columbia,"New York, NY",New York,1350,1430,10,5,1360,1435,15,17,1375,1418,2403,299,319,331,0,,0,0.0,0.0,0.0,0.0,0.0
2024,8,17,6,2024-08-17,F9,9899,SFO,LAS,"San Francisco, CA",California,"Las Vegas, NV",Nevada,2131,637,24,20,2155,657,12,10,2167,647,1984,253,273,275,0,,0,5.0,5.0,1.0,0.0,9.0
2024,5,10,5,2024-05-10,OO,3622,JFK,MSP,"New York, NY",New York,"Minneapolis, MN",Minnesota,994,1830,5,10,999,1840,22,3,1021,1837,1310,157,177,182,0,,0,0.0,0.0,0.0,0.0,0.0
2024,4,29,1,2024-04-29,F9,2157,STL,EWR,"St. Louis, MO",Missouri,"Newark, NJ",New Jersey,2007,2329,-13,-10,1994,2319,26,5,2020,2314,1897,234,254,265,0,,1,0.0,0.0,0.0,0.0,0.0
2024,11,21,4,2024-11-21,F9,2821,PDX,DEN,"Portland, OR",Oregon,"Denver, CO",Colorado,1126,2275,7,15,1133,2290,17,10,1150,2280,2233,272,292,299,0,,0,0.0,0.0,0.0,0.0,0.0
2024,9,3,2,2024-09-03,HA,4921,MCO,MIA,"Orlando, FL",Florida,"Miami, FL",Florida,1882,888,-12,-10,1870,878,19,15,1889,863,2499,308,328,342,0,,0,0.0,0.0,0.0,0.0,0.0
2024,7,10,3,2024-07-10,AA,2663,LAS,STL,"Las Vegas, NV",Nevada,"St. Louis, MO",Missouri,2215,1574,43,45,2258,1619,20,9,2278,1610,2903,361,381,390,0,,0,16.0,4.0,0.0,0.0,25.0
2024,11,18,1,2024-11-18,AA,302,JFK,MCO,"New York, NY",New York,"Orlando, FL",Florida,1896,2116,-1,5,1895,2121,29,8,1924,2113,496,62,82,99,0,,0,0.0,0.0,0.0,0.0,0.0
2024,7,28,7,2024-07-28,YX,1041,CLT,LGA,"Charlotte, NC",North Carolina,"New York, NY",New York,1601,1848,8,0,1609,1848,7,10,1616,1838,295,29,49,46,0,,0,0.0,0.0,0.0,0.0,0.0
2024,4,12,5,2024-04-12,9E,688,ORD,CLT,"Chicago, IL",Illinois,"Charlotte, NC",North Carolina,826,1051,0,-5,826,1046,9,6,835,1040,1431,182,202,197,0,,0,0.0,0.0,0.0,0.0,0.0
2024,11,24,7,2024-11-24,WN,8862,EWR,DCA,"Newark, NJ",New Jersey,"Washington, DC",District of Columbia,1799,627,-10,-15,1789,612,11,16,1800,596,2794,349,369,376,0,,0,0.0,0.0,0.0,0.0,0.0
2024,5,12,7,2024-05-12,AS,8487,PHX,MIA,"Phoenix, AZ",Arizona,"Miami, FL",Florida,1875,1301,-8,-15,1867,1286,5,11,1872,1275,1418,179,199,195,0,,0,0.0,0.0,0.0,0.0,0.0
2024,11,18,1,2024-11-18,F9,9637,TPA,IAH,"Tampa, FL",Florida,"Houston, TX",Texas,1705,1356,11,10,1716,1366,12,15,1728,1351,2907,356,376,383,0,,0,0.0,0.0,0.0,0.0,0.0
2024,5,18,6,2024-05-18,MQ,8709,DCA,IAD,"Washington, DC",District of Columbia,"Washington, DC",District of Columbia,1004,933,0,-5,1004,928,10,14,1014,914,2111,268,288,292,0,,0,0.0,0.0,0.0,0.0,0.0
2024,4,30,2,2024-04-30,DL,1742,MCO,SEA,"Orlando, FL",Florida,"Seattle, WA",Washington,1106,1996,-6,0,1100,1996,8,4,1108,1992,1545,201,221,213,0,,0,0.0,0.0,0.0,0.0,0.0
2024,4,3,3,2024-04-03,MQ,1465,BWI,EWR,"Baltimore, MD",Maryland,"Newark, NJ",New Jersey,2121,1160,7,15,2128,1175,15,8,2143,1167,276,31,51,54,0,,0,0.0,0.0,0.0,0.0,0.0
2024,5,8,3,2024-05-08,UA,7656,IAH,MDW,"Houston, TX",Texas,"Chicago, IL",Illinois,1912,1924,-14,-10,1898,1914,10,11,1908,1903,2381,303,323,324,0,,0,0.0,0.0,0.0,0.0,0.0
2024,3,31,7,2024-03-31,AS,108,HNL,EWR,"Honolulu, HI",Hawaii,"Newark, NJ",New Jersey,1106,803,14,5,1120,808,22,17,1142,791,1301,161,181,200,0,,0,0.0,0.0,0.0,0.0,0.0
2024,4,1,1,2024-04-01,9E,631,CLT,DTW,"Charlotte, NC",North Carolina,"Detroit, MI",Michigan,1858,978,3,0,1861,978,24,3,1885,975,2079,264,284,291,0,,0,0.0,0.0,0.0,0.0,0.0
2024,3,3,7,2024-03-03,WN,9844,MSP,EWR,"Minneapolis, MN",Minnesota,"Newark, NJ",New Jersey,1503,1501,-5,-10,1498,1491,28,9,1526,1482,2082,253,273,290,0,,0,0.0,0.0,0.0,0.0,0.0
2024,1,29,1,2024-01-29,YX,1135,BOS,SAN,"Boston, MA",Massachusetts,"San Diego, CA",California,1969,1738,0,10,1969,1748,24,5,1993,1743,1822,234,254,263,0,,0,0.0,0.0,0.0,0.0,0.0
2024,7,28,7,2024-07-28,DL,1717,EWR,SEA,"Newark, NJ",New Jersey,"Seattle, WA",Washington,1008,1643,-1,5,1007,1648,25,9,1032,1639,2090,270,290,304,0,,0,0.0,0.0,0.0,0.0,0.0
2024,1,12,5,2024-01-12,NK,6822,JFK,BOS,"New York, NY",New York,"Boston, MA",Massachusetts,1156,1607,-18,-15,1138,1592,6,15,1144,1577,1146,139,159,160,0,,0,0.0,0.0,0.0,0.0,0.0
2024,11,28,4,2024-11-28,WN,3816,PHX,HNL,"Phoenix, AZ",Arizona,"Honolulu, HI",Hawaii,1771,2220,-9,0,1762,2220,23,11,1785,2209,748,92,112,126,0,,0,0.0,0.0,0.0,0.0,0.0
2024,10,23,3,2024-10-23,F9,6175,BWI,MSP,"Baltimore, MD",Maryland,"Minneapolis, MN",Minnesota,2216,1511,6,10,2222,1521,23,4,2245,1517,1173,148,168,175,0,,0,0.0,0.0,0.0,0.0,0.0
2024,5,9,4,2024-05-09,F9,1176,IAD,IAH,"Washington, DC",District of Columbia,"Houston, TX",Texas,1816,995,-20,-15,1796,980,22,14,1818,966,1825,233,253,269,0,,0,0.0,0.0,0.0,0.0,0.0
2024,10,19,6,2024-10-19,NK,7703,MCO,PHX,"Orlando, FL",Florida,"Phoenix, AZ",Arizona,1030,1675,-6,-5,1024,1670,28,4,1052,1666,1167,148,168,180,0,,0,0.0,0.0,0.0,0.0,0.0
2024,6,21,5,2024-06-21,9E,4115,JFK,MDW,"New York, NY",New York,"Chicago, IL",Illinois,1661,2283,2,10,1663,2293,15,15,1678,2278,2492,313,333,343,0,,0,0.0,0.0,0.0,0.0,0.0
2024,7,26,5,2024-07-26,G4,7229,LAS,MCO,"Las Vegas, NV",Nevada,"Orlando, FL",Florida,2079,1809,5,10,2084,1819,7,3,2091,1816,2932,357,377,367,0,,0,0.0,0.0,0.0,0.0,0.0
2024,1,24,3,2024-01-24,WN,3062,DCA,ORD,"Washington, DC",District of Columbia,"Chicago, IL",Illinois,2261,2308,13,5,2274,2313,15,5,2289,2308,486,52,72,72,1,,0,0.0,0.0,0.0,0.0,0.0
2024,4,8,1,2024-04-08,NK,4940,IAD,JFK,"Washington, DC",District of Columbia,"New York, NY",New York,1868,952,-14,-5,1854,947,5,9,1859,938,2319,286,306,300,0,,0,0.0,0.0,0.0,0.0,0.0
2024,12,21,6,2024-12-21,9E,1012,STL,MIA,"St. Louis, MO",Missouri,"Miami, FL",Florida,536,1737,8,0,544,1737,6,5,550,1732,1131,137,157,148,0,,0,0.0,0.0,0.0,0.0,0.0
2024,5,18,6,2024-05-18,9E,4249,LAX,JFK,"Los Angeles, CA",California,"New York, NY",New York,813,1113,11,5,824,1118,28,17,852,1101,933,109,129,154,0,,0,0.0,0.0,0.0,0.0,0.0
2024,11,9,6,2024-11-09,HA,4170,MIA,CLT,"Miami, FL",Florida,"Charlotte, NC",North Carolina,719,1145,-17,-10,702,1135,5,14,707,1121,2946,361,381,380,0,,0,0.0,0.0,0.0,0.0,0.0
2024,6,22,6,2024-06-22,YX,5799,EWR,ORD,"Newark, NJ",New Jersey,"Chicago, IL",Illinois,1139,881,-8,0,1131,881,5,13,1136,868,1598,204,224,222,0,,0,0.0,0.0,0.0,0.0,0.0
2024,1,29,1,2024-01-29,AA,6022,DFW,IAD,"Dallas/Fort Worth, TX",Texas,"Washington, DC",District of Columbia,1666,1272,8,5,1674,1277,17,15,1691,1262,2428,308,328,340,0,,0,0.0,0.0,0.0,0.0,0.0
2024,5,22,3,2024-05-22,WN,8635,ATL,PDX,"Atlanta, GA",Georgia,"Portland, OR",Oregon,1927,1793,2,10,1929,1803,5,5,1934,1798,358,42,62,52,0,,0,0.0,0.0,0.0,0.0,0.0
2024,11,11,1,2024-11-11,DL,9484,DEN,BWI,"Denver, CO",Colorado,"Baltimore, MD",Maryland,2218,1205,-15,-15,2203,1190,14,17,2217,1173,2922,362,382,393,0,,0,0.0,0.0,0.0,0.0,0.0
2024,12,16,1,2024-12-16,G4,5380,LGA,PHL,"New York, NY",New York,"Philadelphia, PA",Pennsylvania,903,1359,-6,-5,897,1354,17,12,914,1342,620,80,100,109,0,,0,0.0,0.0,0.0,0.0,0.0
2024,2,11,7,2024-02-11,B6,8994,JFK,PHL,"New York, NY",New York,"Philadelphia, PA",Pennsylvania,2078,1944,-8,0,2070,1944,12,6,2082,1938,1285,166,186,184,0,,0,0.0,0.0,0.0,0.0,0.0
2024,10,25,5,2024-10-25,UA,1998,PHX,PHL,"Phoenix, AZ",Arizona,"Philadelphia, PA",Pennsylvania,978,965,3,5,981,970,26,7,1007,963,366,40,60,73,0,,0,0.0,0.0,0.0,0.0,0.0
2024,7,26,5,2024-07-26,WN,6655,DCA,ORD,"Washington, DC",District of Columbia,"Chicago, IL",Illinois,1221,1119,10,5,1231,1124,11,14,1242,1110,1733,208,228,233,0,,0,0.0,0.0,0.0,0.0,0.0
2024,11,25,1,2024-11-25,AS,8490,CLT,PDX,"Charlotte, NC",North Carolina,"Portland, OR",Oregon,1436,709,-3,-10,1433,699,24,18,1457,681,1151,152,172,194,0,,0,0.0,0.0,0.0,0.0,0.0
2024,7,10,3,2024-07-10,9E,3332,LAS,PHX,"Las Vegas, NV",Nevada,"Phoenix, AZ",Arizona,2083,1505,-26,-20,2057,1485,16,19,2073,1466,2464,310,330,345,0,,0,0.0,0.0,0.0,0.0,0.0
2024,6,8,6,2024-06-08,AA,2922,SEA,JFK,"Seattle, WA",Washington,"New York, NY",New York,1323,2167,9,5,1332,2172,12,10,1344,2162,1670,207,227,229,0,,0,0.0,0.0,0.0,0.0,0.0
2024,3,4,1,2024-03-04,NK,4584,IAH,EWR,"Houston, TX",Texas,"Newark, NJ",New Jersey,719,2186,20,15,739,2201,17,4,756,2197,446,45,65,66,0,,0,0.0,0.0,0.0,0.0,0.0
2024,8,30,5,2024-08-30,F9,8765,EWR,LAX,"Newark, NJ",New Jersey,"Los Angeles, CA",California,866,1552,12,5,878,1557,6,18,884,1539,2916,371,391,395,0,,0,0.0,0.0,0.0,0.0,0.0
2024,9,14,6,2024-09-14,NK,5600,HNL,ORD,"Honolulu, HI",Hawaii,"Chicago, IL",Illinois,1719,1279,-5,0,1714,1279,13,17,1727,1262,2083,255,275,285,0,,0,0.0,0.0,0.0,0.0,0.0
2024,5,31,5,2024-05-31,NK,1754,JFK,MCO,"New York, NY",New York,"Orlando, FL",Florida,1483,2201,13,20,1496,2221,24,13,1520,2208,2705,337,357,374,0,,0,2.0,3.0,3.0,0.0,12.0
2024,8,2,5,2024-08-02,G4,691,SFO,ORD,"San Francisco, CA",California,"Chicago, IL",Illinois,1183,2166,-3,-5,1180,2161,21,7,1201,2154,1231,150,170,178,0,,0,0.0,0.0,0.0,0.0,0.0
2024,11,17,7,2024-11-17,MQ,1948,MIA,DCA,"Miami, FL",Florida,"Washington, DC",District of Columbia,2272,1558,-10,0,2262,1558,22,4,2284,1554,1583,194,214,220,0,,0,0.0,0.0,0.0,0.0,0.0
2024,6,14,5,2024-06-14,WN,5291,PDX,BWI,"Portland, OR",Oregon,"Baltimore, MD",Maryland,1468,923,-29,-20,1439,903,28,9,1467,894,2597,327,347,364,0,,0,0.0,0.0,0.0,0.0,0.0
2024,1,31,3,2024-01-31,OH,3141,CLT,BOS,"Charlotte, NC",North Carolina,"Boston, MA",Massachusetts,2210,611,19,15,2229,626,20,9,2249,617,624,82,102,111,0,,0,0.0,0.0,0.0,0.0,0.0
2024,8,19,1,2024-08-19,NK,267,STL,SLC,"St. Louis, MO",Missouri,"Salt Lake City, UT",Utah,1555,1646,-7,0,1548,1646,13,3,1561,1643,1933,237,257,253,0,,0,0.0,0.0,0.0,0.0,0.0
2024,10,8,2,2024-10-08,G4,4479,PHX,MSP,"Phoenix, AZ",Arizona,"Minneapolis, MN",Minnesota,1518,1784,-3,-5,1515,1779,9,19,1524,1760,2902,362,382,390,0,,0,0.0,0.0,0.0,0.0,0.0
2024,1,29,1,2024-01-29,HA,7761,EWR,ORD,"Newark, NJ",New Jersey,"Chicago, IL",Illinois,2259,863,-17,-20,2242,843,24,18,2266,825,2174,266,286,308,1,,0,0.0,0.0,0.0,0.0,0.0
2024,7,13,6,2024-07-13,B6,7067,SLC,STL,"Salt Lake City, UT",Utah,"St. Louis, MO",Missouri,1577,2325,-1,-5,1576,2320,20,19,1596,2301,2896,371,391,410,0,,0,0.0,0.0,0.0,0.0,0.0
2024,11,29,5,2024-11-29,DL,7383,CLT,LGA,"Charlotte, NC",North Carolina,"New York, NY",New York,922,979,-23,-20,899,959,17,13,916,946,2233,279,299,309,0,,0,0.0,0.0,0.0,0.0,0.0
2024,9,12,4,2024-09-12,HA,4110,SEA,EWR,"Seattle, WA",Washington,"Newark, NJ",New Jersey,2221,679,-7,-5,2214,674,27,16,2241,658,1755,223,243,266,0,,0,0.0,0.0,0.0,0.0,0.0
2024,10,7,1,2024-10-07,B6,5086,ATL,IAH,"Atlanta, GA",Georgia,"Houston, TX",Texas,1503,1894,14,20,1517,1914,6,15,1523,1899,2168,278,298,299,0,,0,2.0,0.0,0.0,0.0,18.0
2024,10,30,3,2024-10-30,WN,3948,JFK,MSP,"New York, NY",New York,"Minneapolis, MN",Minnesota,733,1024,-18,-10,715,1014,27,5,742,1009,212,25,45,57,0,,0,0.0,0.0,0.0,0.0,0.0
2024,11,16,6,2024-11-16,F9,2281,EWR,BWI,"Newark, NJ",New Jersey,"Baltimore, MD",Maryland,1328,1215,-4,0,1324,1215,16,10,1340,1205,2978,379,399,405,0,,0,0.0,0.0,0.0,0.0,0.0
2024,11,18,1,2024-11-18,HA,9946,MDW,DFW,"Chicago, IL",Illinois,"Dallas/Fort Worth, TX",Texas,1242,1035,-13,-10,1229,1025,13,14,1242,1011,1231,156,176,183,0,,0,0.0,0.0,0.0,0.0,0.0
2024,12,11,3,2024-12-11,B6,932,IAD,BOS,"Washington, DC",District of Columbia,"Boston, MA",Massachusetts,1633,1521,10,5,1643,1526,6,13,1649,1513,2673,332,352,351,0,,0,0.0,0.0,0.0,0.0,0.0
2024,10,20,7,2024-10-20,G4,1121,PDX,BOS,"Portland, OR",Oregon,"Boston, MA",Massachusetts,1486,1701,6,0,1492,1701,16,14,1508,1687,1976,241,261,271,0,,0,0.0,0.0,0.0,0.0,0.0
2024,3,27,3,2024-03-27,G4,3592,STL,LAS,"St. Louis, MO",Missouri,"Las Vegas, NV",Nevada,1378,2147,-11,-10,1367,2137,28,17,1395,2120,1283,168,188,213,0,,0,0.0,0.0,0.0,0.0,0.0
2024,5,28,2,2024-05-28,UA,9186,DEN,MCO,"Denver, CO",Colorado,"Orlando, FL",Florida,1623,1394,0,10,1623,1404,26,6,1649,1398,2874,368,388,400,0,,0,0.0,0.0,0.0,0.0,0.0
2024,9,5,4,2024-09-05,MQ,9807,PHX,IAH,"Phoenix, AZ",Arizona,"Houston, TX",Texas,2235,1734,13,5,2248,1739,10,12,2258,1727,1083,143,163,165,0,,0,0.0,0.0,0.0,0.0,0.0
2024,11,16,6,2024-11-16,9E,388,JFK,DFW,"New York, NY",New York,"Dallas/Fort Worth, TX",Texas,1734,1590,27,20,1761,1610,17,18,1778,1592,863,111,131,146,0,,0,0.0,5.0,2.0,0.0,13.0
2024,10,9,3,2024-10-09,HA,7916,PDX,LGA,"Portland, OR",Oregon,"New York, NY",New York,1232,1051,-13,-20,1219,1031,20,11,1239,1020,755,91,111,122,0,,0,0.0,0.0,0.0,0.0,0.0
2024,12,27,5,2024-12-27,AS,1176,LAX,IAD,"Los Angeles, CA",California,"Washington, DC",District of Columbia,1926,2037,9,0,1935,2037,24,19,1959,2018,303,45,65,88,0,,0,0.0,0.0,0.0,0.0,0.0
2024,7,16,2,2024-07-16,AS,1471,JFK,BWI,"New York, NY",New York,"Baltimore, MD",Maryland,1673,859,114,120,1787,979,29,15,1816,964,646,73,93,117,0,,0,26.0,18.0,2.0,3.0,71.0
2024,2,13,2,2024-02-13,WN,1174,STL,HNL,"St. Louis, MO",Missouri,"Honolulu, HI",Hawaii,1174,1421,10,10,1184,1431,12,10,1196,1421,2210,285,305,307,0,,0,0.0,0.0,0.0,0.0,0.0
2024,12,21,6,2024-12-21,OO,5034,LAX,LGA,"Los Angeles, CA",California,"New York, NY",New York,1917,1974,0,10,1917,1984,11,10,1928,1974,1658,200,220,221,0,,0,0.0,0.0,0.0,0.0,0.0
2024,1,28,7,2024-01-28,MQ,139,LAS,IAH,"Las Vegas, NV",Nevada,"Houston, TX",Texas,1154,1307,0,0,1154,1307,19,5,1173,1302,1435,174,194,198,0,,0,0.0,0.0,0.0,0.0,0.0
2024,1,17,3,2024-01-17,9E,4374,DCA,LGA,"Washington, DC",District of Columbia,"New York, NY",New York,757,1451,5,5,762,1456,9,15,771,1441,1450,176,196,200,0,,0,0.0,0.0,0.0,0.0,0.0
2024,5,6,1,2024-05-06,UA,282,MCO,LAX,"Orlando, FL",Florida,"Los Angeles, CA",California,1768,1807,4,10,1772,1817,25,19,1797,1798,1359,163,183,207,0,,0,0.0,0.0,0.0,0.0,0.0
2024,6,16,7,2024-06-16,AA,5596,DFW,IAD,"Dallas/Fort Worth, TX",Texas,"Washington, DC",District of Columbia,1501,1257,-6,-15,1495,1242,22,18,1517,1224,2719,335,355,375,0,,0,0.0,0.0,0.0,0.0,0.0
2024,8,31,6,2024-08-31,YX,8788,SEA,SFO,"Seattle, WA",Washington,"San Francisco, CA",California,1673,774,12,5,1685,779,25,4,1710,775,1647,207,227,236,0,,0,0.0,0.0,0.0,0.0,0.0
2024,3,16,6,2024-03-16,NK,8888,BWI,ORD,"Baltimore, MD",Maryland,"Chicago, IL",Illinois,1123,1311,7,10,1130,1321,23,12,1153,1309,1974,250,270,285,0,,0,0.0,0.0,0.0,0.0,0.0
2024,8,18,7,2024-08-18,HA,2608,MDW,IAD,"Chicago, IL",Illinois,"Washington, DC",District of Columbia,598,2323,-16,-20,582,2303,17,5,599,2298,2664,341,361,363,0,,0,0.0,0.0,0.0,0.0,0.0
2024,7,22,1,2024-07-22,HA,8976,SFO,LGA,"San Francisco, CA",California,"New York, NY",New York,1626,2241,-18,-10,1608,2231,27,4,1635,2227,2652,323,343,354,0,,0,0.0,0.0,0.0,0.0,0.0
2024,9,4,3,2024-09-04,B6,8172,IAH,DEN,"Houston, TX",Texas,"Denver, CO",Colorado,2246,2009,0,-5,2246,2004,29,3,2275,2001,488,66,86,98,0,,0,0.0,0.0,0.0,0.0,0.0
2024,10,28,1,2024-10-28,OH,418,SEA,DEN,"Seattle, WA",Washington,"Denver, CO",Colorado,511,1184,19,10,530,1194,20,4,550,1190,2100,265,285,289,0,,0,0.0,0.0,0.0,0.0,0.0
2024,8,1,4,2024-08-01,9E,9727,LAS,MCO,"Las Vegas, NV",Nevada,"Orlando, FL",Florida,1749,1895,6,5,1755,1900,17,4,1772,1896,966,112,132,133,0,,0,0.0,0.0,0.0,0.0,0.0
2024,8,2,5,2024-08-02,HA,2503,IAD,MIA,"Washington, DC",District of Columbia,"Miami, FL",Florida,1312,2349,-4,5,1308,2354,18,8,1326,2346,254,24,44,50,0,,0,0.0,0.0,0.0,0.0,0.0
2024,6,6,4,2024-06-06,NK,828,MCO,ATL,"Orlando, FL",Florida,"Atlanta, GA",Georgia,1965,785,19,10,1984,795,20,16,2004,779,2056,264,284,300,1,,0,0.0,0.0,0.0,0.0,0.0
2024,3,9,6,2024-03-09,AA,1387,SEA,STL,"Seattle, WA",Washington,"St. Louis, MO",Missouri,1671,1251,9,0,1680,1251,26,12,1706,1239,2573,326,346,364,0,,0,0.0,0.0,0.0,0.0,0.0
2024,3,25,1,2024-03-25,F9,4101,DEN,CLT,"Denver, CO",Colorado,"Charlotte, NC",North Carolina,678,766,12,10,690,776,16,3,706,773,341,39,59,58,0,,0,0.0,0.0,0.0,0.0,0.0
2024,9,23,1,2024-09-23,UA,5706,LAX,LAS,"Los Angeles, CA",California,"Las Vegas, NV",Nevada,1530,742,-2,-10,1528,732,16,15,1544,717,419,51,71,82,0,,0,0.0,0.0,0.0,0.0,0.0
2024,3,9,6,2024-03-09,NK,8852,MCO,DEN,"Orlando, FL",Florida,"Denver, CO",Colorado,651,1092,7,5,658,1097,15,18,673,1079,839,104,124,137,0,,0,0.0,0.0,0.0,0.0,0.0
2024,4,8,1,2024-04-08,YX,1475,LAS,PHX,"Las Vegas, NV",Nevada,"Phoenix, AZ",Arizona,1334,671,-3,-10,1331,661,27,4,1358,657,2158,273,293,304,0,,0,0.0,0.0,0.0,0.0,0.0
2024,12,12,4,2024-12-12,UA,9757,SFO,EWR,"San Francisco, CA",California,"Newark, NJ",New Jersey,1081,1967,-15,-20,1066,1947,27,16,1093,1931,1502,187,207,230,0,,0,0.0,0.0,0.0,0.0,0.0
2024,8,3,6,2024-08-03,OH,124,BWI,HNL,"Baltimore, MD",Maryland,"Honolulu, HI",Hawaii,1876,1098,-11,-10,1865,1088,11,14,1876,1074,2930,364,384,389,0,,0,0.0,0.0,0.0,0.0,0.0
2024,6,9,7,2024-06-09,UA,1254,SLC,DCA,"Salt Lake City, UT",Utah,"Washington, DC",District of Columbia,1064,746,-4,0,1060,746,8,18,1068,728,1070,142,162,168,0,,0,0.0,0.0,0.0,0.0,0.0
2024,4,3,3,2024-04-03,9E,1559,TPA,HNL,"Tampa, FL",Florida,"Honolulu, HI",Hawaii,2197,2236,1,10,2198,2246,10,11,2208,2235,1368,164,184,185,0,,0,0.0,0.0,0.0,0.0,0.0
2024,6,22,6,2024-06-22,G4,5207,DTW,MCO,"Detroit, MI",Michigan,"Orlando, FL",Florida,1940,2124,-7,0,1933,2124,27,13,1960,2111,1382,162,182,202,0,,0,0.0,0.0,0.0,0.0,0.0
2024,6,13,4,2024-06-13,MQ,4806,ATL,PDX,"Atlanta, GA",Georgia,"Portland, OR",Oregon,2128,1961,-17,-10,2111,1951,18,14,2129,1937,1217,159,179,191,0,,0,0.0,0.0,0.0,0.0,0.0
2024,4,24,3,2024-04-24,DL,9512,MDW,SFO,"Chicago, IL",Illinois,"San Francisco, CA",California,2186,1708,35,45,2221,1753,18,6,2239,1747,251,24,44,48,0,,0,9.0,3.0,4.0,1.0,28.0
2024,8,7,3,2024-08-07,OH,2256,BOS,SEA,"Boston, MA",Massachusetts,"Seattle, WA",Washington,2093,1490,-5,-10,2088,1480,16,12,2104,1468,2019,248,268,276,0,,0,0.0,0.0,0.0,0.0,0.0
2024,1,31,3,2024-01-31,WN,6079,IAD,DEN,"Washington, DC",District of Columbia,"Denver, CO",Colorado,695,1406,25,30,720,1436,19,17,739,1419,2624,331,351,367,0,,0,0.0,0.0,5.0,0.0,25.0
2024,1,11,4,2024-01-11,AS,8043,BOS,IAH,"Boston, MA",Massachusetts,"Houston, TX",Texas,824,1445,23,15,847,1460,15,19,862,1441,2265,280,300,314,0,,0,0.0,0.0,0.0,0.0,0.0
2024,12,8,7,2024-12-08,OH,6142,STL,DTW,"St. Louis, MO",Missouri,"Detroit, MI",Michigan,981,1766,-6,0,975,1766,8,14,983,1752,1431,185,205,207,0,,0,0.0,0.0,0.0,0.0,0.0
2024,5,9,4,2024-05-09,UA,9011,ATL,DCA,"Atlanta, GA",Georgia,"Washington, DC",District of Columbia,707,1490,-20,-15,687,1475,29,3,716,1472,2381,292,312,324,0,,0,0.0,0.0,0.0,0.0,0.0
2024,4,14,7,2024-04-14,YX,7586,STL,LAX,"St. Louis, MO",Missouri,"Los Angeles, CA",California,1435,1934,1,5,1436,1939,15,18,1451,1921,1161,151,171,184,0,,0,0.0,0.0,0.0,0.0,0.0
2024,1,27,6,2024-01-27,9E,1205,BOS,DFW,"Boston, MA",Massachusetts,"Dallas/Fort Worth, TX",Texas,1826,1992,4,10,1830,2002,29,10,1859,1992,1627,199,219,238,0,,0,0.0,0.0,0.0,0.0,0.0
2024,8,14,3,2024-08-14,OH,3869,TPA,DEN,"Tampa, FL",Florida,"Denver, CO",Colorado,1822,2330,-15,-5,1807,2325,16,11,1823,2314,836,111,131,138,0,,0,0.0,0.0,0.0,0.0,0.0
2024,1,2,2,2024-01-02,9E,2579,ORD,MCO,"Chicago, IL",Illinois,"Orlando, FL",Florida,1456,2319,-19,-10,1437,2309,24,13,1461,2296,542,62,82,99,0,,0,0.0,0.0,0.0,0.0,0.0
2024,12,24,2,2024-12-24,NK,4831,STL,MSP,"St. Louis, MO",Missouri,"Minneapolis, MN",Minnesota,925,1412,9,10,934,1422,12,19,946,1403,713,97,117,128,0,,0,0.0,0.0,0.0,0.0,0.0
2024,4,10,3,2024-04-10,NK,3272,DEN,SEA,"Denver, CO",Colorado,"Seattle, WA",Washington,1585,1570,-9,0,1576,1570,28,11,1604,1559,352,42,62,81,0,,0,0.0,0.0,0.0,0.0,0.0
2024,1,21,7,2024-01-21,HA,8285,DTW,PDX,"Detroit, MI",Michigan,"Portland, OR",Oregon,1718,2064,-1,-10,1717,2054,22,13,1739,2041,1078,127,147,162,0,,0,0.0,0.0,0.0,0.0,0.0
2024,2,27,2,2024-02-27,B6,7168,MSP,TPA,"Minneapolis, MN",Minnesota,"Tampa, FL",Florida,1066,666,18,15,1084,681,10,11,1094,670,626,80,100,101,0,,0,0.0,0.0,0.0,0.0,0.0
2024,6,28,5,2024-06-28,UA,6657,JFK,PDX,"New York, NY",New York,"Portland, OR",Oregon,1886,2357,11,15,1897,2372,13,4,1910,2368,943,108,128,125,0,,0,0.0,0.0,0.0,0.0,0.0
2024,12,6,5,2024-12-06,DL,3430,PHL,ORD,"Philadelphia, PA",Pennsylvania,"Chicago, IL",Illinois,2084,1437,-6,-5,2078,1432,28,11,2106,1421,356,47,67,86,1,,0,0.0,0.0,0.0,0.0,0.0
2024,12,14,6,2024-12-14,HA,6122,MSP,IAH,"Minneapolis, MN",Minnesota,"Houston, TX",Texas,1117,1526,-18,-15,1099,1511,21,13,1120,1498,2256,289,309,323,0,,0,0.0,0.0,0.0,0.0,0.0
2024,1,20,6,2024-01-20,HA,2158,IAH,LAS,"Houston, TX",Texas,"Las Vegas, NV",Nevada,1444,2157,-10,0,1434,2157,9,3,1443,2154,982,129,149,141,0,,0,0.0,0.0,0.0,0.0,0.0
2024,9,11,3,2024-09-11,WN,5790,PHX,ATL,"Phoenix, AZ",Arizona,"Atlanta, GA",Georgia,1601,940,-8,-5,1593,935,20,7,1613,928,1909,237,257,264,0,,0,0.0,0.0,0.0,0.0,0.0
2024,11,12,2,2024-11-12,OH,5871,SLC,HNL,"Salt Lake City, UT",Utah,"Honolulu, HI",Hawaii,1386,2301,-10,-15,1376,2286,17,10,1393,2276,2583,313,333,340,0,,0,0.0,0.0,0.0,0.0,0.0
2024,2,7,3,2024-02-07,HA,1970,BWI,ORD,"Baltimore, MD",Maryland,"Chicago, IL",Illinois,1428,701,13,10,1441,711,17,11,1458,700,2103,262,282,290,0,,0,0.0,0.0,0.0,0.0,0.0
2024,5,27,1,2024-05-27,MQ,3721,ORD,IAD,"Chicago, IL",Illinois,"Washington, DC",District of Columbia,783,1937,98,90,881,2027,25,4,906,2023,1082,125,145,154,0,,0,4.0,16.0,8.0,0.0,62.0
2024,1,25,4,2024-01-25,WN,9437,LGA,PDX,"New York, NY",New York,"Portland, OR",Oregon,1580,1551,-6,-5,1574,1546,13,19,1587,1527,2548,324,344,356,0,,0,0.0,0.0,0.0,0.0,0.0
2024,4,30,2,2024-04-30,OO,4091,EWR,SFO,"Newark, NJ",New Jersey,"San Francisco, CA",California,1180,1733,12,5,1192,1738,6,13,1198,1725,1415,175,195,194,0,,0,0.0,0.0,0.0,0.0,0.0
2024,1,26,5,2024-01-26,F9,8416,SLC,MIA,"Salt Lake City, UT",Utah,"Miami, FL",Florida,875,1506,-24,-15,851,1491,25,16,876,1475,499,59,79,100,0,,0,0.0,0.0,0.0,0.0,0.0
2024,6,17,1,2024-06-17,F9,8603,SLC,DFW,"Salt Lake City, UT",Utah,"Dallas/Fort Worth, TX",Texas,875,2055,-11,-5,864,2050,20,8,884,2042,547,77,97,105,0,,0,0.0,0.0,0.0,0.0,0.0
2024,11,18,1,2024-11-18,MQ,874,PHL,ORD,"Philadelphia, PA",Pennsylvania,"Chicago, IL",Illinois,2242,941,-24,-15,2218,926,5,7,2223,919,2735,350,370,362,0,,0,0.0,0.0,0.0,0.0,0.0
2024,8,12,1,2024-08-12,B6,8985,PHX,DTW,"Phoenix, AZ",Arizona,"Detroit, MI",Michigan,1271,1427,-6,-15,1265,1412,12,14,1277,1398,1875,239,259,265,0,,0,0.0,0.0,0.0,0.0,0.0
2024,1,1,1,2024-01-01,MQ,5378,TPA,ATL,"Tampa, FL",Florida,"Atlanta, GA",Georgia,1287,1802,-8,0,1279,1802,28,14,1307,1788,578,78,98,120,1,,0,0.0,0.0,0.0,0.0,0.0
2024,11,2,6,2024-11-02,AS,1476,PHX,IAH,"Phoenix, AZ",Arizona,"Houston, TX",Texas,872,1278,8,10,880,1288,6,12,886,1276,2461,298,318,316,0,,0,0.0,0.0,0.0,0.0,0.0
2024,9,17,2,2024-09-17,F9,6039,EWR,DFW,"Newark, NJ",New Jersey,"Dallas/Fort Worth, TX",Texas,1356,733,0,0,1356,733,14,5,1370,728,2163,269,289,288,0,,0,0.0,0.0,0.0,0.0,0.0
2024,1,13,6,2024-01-13,HA,9281,ATL,DCA,"Atlanta, GA",Georgia,"Washington, DC",District of Columbia,2198,1653,5,0,2203,1653,17,19,2220,1634,2927,359,379,395,0,,0,0.0,0.0,0.0,0.0,0.0
2024,2,17,6,2024-02-17,AA,2946,SLC,MSP,"Salt Lake City, UT",Utah,"Minneapolis, MN",Minnesota,743,1474,-7,-10,736,1464,5,17,741,1447,1603,193,213,215,0,,0,0.0,0.0,0.0,0.0,0.0
2024,11,8,5,2024-11-08,B6,6917,PHL,TPA,"Philadelphia, PA",Pennsylvania,"Tampa, FL",Florida,1261,2096,8,5,1269,2101,7,6,1276,2095,2635,323,343,336,0,,0,0.0,0.0,0.0,0.0,0.0
2024,10,17,4,2024-10-17,WN,7530,IAD,MDW,"Washington, DC",District of Columbia,"Chicago, IL",Illinois,1562,1595,4,-5,1566,1590,13,8,1579,1582,2545,322,342,343,0,,0,0.0,0.0,0.0,0.0,0.0
2024,11,27,3,2024-11-27,WN,1816,MCO,PHX,"Orlando, FL",Florida,"Phoenix, AZ",Arizona,1832,984,-15,-15,1817,969,27,4,1844,965,1896,229,249,260,0,,0,0.0,0.0,0.0,0.0,0.0
2024,4,3,3,2024-04-03,OO,9918,HNL,SFO,"Honolulu, HI",Hawaii,"San Francisco, CA",California,1132,1197,-10,-10,1122,1187,27,14,1149,1173,923,119,139,160,0,,0,0.0,0.0,0.0,0.0,0.0
2024,9,17,2,2024-09-17,DL,6880,SLC,IAD,"Salt Lake City, UT",Utah,"Washington, DC",District of Columbia,585,608,-8,-15,577,593,8,18,585,575,2614,330,350,356,0,,0,0.0,0.0,0.0,0.0,0.0
2024,10,4,5,2024-10-04,9E,3431,STL,MIA,"St. Louis, MO",Missouri,"Miami, FL",Florida,598,735,-5,-5,593,730,9,9,602,721,2377,287,307,305,0,,0,0.0,0.0,0.0,0.0,0.0
2024,12,24,2,2024-12-24,AA,9181,SEA,DCA,"Seattle, WA",Washington,"Washington, DC",District of Columbia,873,1913,-12,-15,861,1898,27,19,888,1879,1105,147,167,193,0,,0,0.0,0.0,0.0,0.0,0.0
2024,7,23,2,2024-07-23,OH,1478,SEA,IAD,"Seattle, WA",Washington,"Washington, DC",District of Columbia,1257,1575,18,10,1275,1585,6,16,1281,1569,1621,201,221,223,0,,0,0.0,0.0,0.0,0.0,0.0
2024,7,3,3,2024-07-03,HA,4684,SAN,PHL,"San Diego, CA",California,"Philadelphia, PA",Pennsylvania,2018,1578,22,15,2040,1593,19,11,2059,1582,1028,137,157,167,0,,0,0.0,0.0,0.0,0.0,0.0
2024,6,23,7,2024-06-23,AS,7481,DEN,SAN,"Denver, CO",Colorado,"San Diego, CA",California,1731,2271,-17,-10,1714,2261,7,15,1721,2246,2324,295,315,317,0,,0,0.0,0.0,0.0,0.0,0.0
2024,11,4,1,2024-11-04,NK,4375,LGA,BWI,"New York, NY",New York,"Baltimore, MD",Maryland,1124,2275,2,0,1126,2275,23,14,1149,2261,1556,184,204,221,0,,0,0.0,0.0,0.0,0.0,0.0
2024,3,9,6,2024-03-09,B6,5638,MSP,DCA,"Minneapolis, MN",Minnesota,"Washington, DC",District of Columbia,1482,642,-9,0,1473,642,15,15,1488,627,2941,368,388,398,0,,0,0.0,0.0,0.0,0.0,0.0
2024,4,13,6,2024-04-13,HA,7410,SAN,MDW,"San Diego, CA",California,"Chicago, IL",Illinois,582,1728,38,30,620,1758,11,18,631,1740,1764,218,238,247,0,,0,2.0,7.0,5.0,0.0,16.0
2024,9,2,1,2024-09-02,F9,331,SEA,ATL,"Seattle, WA",Washington,"Atlanta, GA",Georgia,2100,1654,-17,-15,2083,1639,11,19,2094,1620,975,121,141,151,0,,0,0.0,0.0,0.0,0.0,0.0
2024,6,9,7,2024-06-09,G4,9904,ATL,SLC,"Atlanta, GA",Georgia,"Salt Lake City, UT",Utah,500,2305,5,5,505,2310,26,13,531,2297,415,58,78,97,0,,0,0.0,0.0,0.0,0.0,0.0
2024,7,18,4,2024-07-18,OO,5522,DCA,EWR,"Washington, DC",District of Columbia,"Newark, NJ",New Jersey,936,2296,1,-5,937,2291,21,7,958,2284,2313,280,300,308,0,,0,0.0,0.0,0.0,0.0,0.0
2024,8,3,6,2024-08-03,OO,4526,PHL,BWI,"Philadelphia, PA",Pennsylvania,"Baltimore, MD",Maryland,1185,1386,-6,0,1179,1386,19,17,1198,1369,2861,366,386,402,0,,0,0.0,0.0,0.0,0.0,0.0
2024,7,30,2,2024-07-30,DL,347,DEN,CLT,"Denver, CO",Colorado,"Charlotte, NC",North Carolina,749,1842,-12,-10,737,1832,12,3,749,1829,787,106,126,121,0,,0,0.0,0.0,0.0,0.0,0.0
2024,1,16,2,2024-01-16,OO,4478,MCO,PDX,"Orlando, FL",Florida,"Portland, OR",Oregon,909,712,-5,-10,904,702,14,19,918,683,657,78,98,111,0,,0,0.0,0.0,0.0,0.0,0.0
2024,11,27,3,2024-11-27,MQ,3841,LAS,HNL,"Las Vegas, NV",Nevada,"Honolulu, HI",Hawaii,1237,1331,-9,-10,1228,1321,19,11,1247,1310,1913,229,249,259,0,,0,0.0,0.0,0.0,0.0,0.0
2024,7,23,2,2024-07-23,WN,162,CLT,SEA,"Charlotte, NC",North Carolina,"Seattle, WA",Washington,1909,2318,-25,-15,1884,2303,24,19,1908,2284,1934,234,254,277,0,,0,0.0,0.0,0.0,0.0,0.0
2024,12,30,1,2024-12-30,OO,4323,EWR,ATL,"Newark, NJ",New Jersey,"Atlanta, GA",Georgia,1607,1883,-4,-10,1603,1873,28,5,1631,1868,1120,132,152,165,0,,0,0.0,0.0,0.0,0.0,0.0
2024,2,8,4,2024-02-08,G4,1651,IAH,SFO,"Houston, TX",Texas,"San Francisco, CA",California,989,611,8,5,997,616,11,10,1008,606,2875,352,372,373,0,,0,0.0,0.0,0.0,0.0,0.0
2024,3,29,5,2024-03-29,B6,6406,BWI,PHL,"Baltimore, MD",Maryland,"Philadelphia, PA",Pennsylvania,738,2094,1,5,739,2099,21,13,760,2086,653,81,101,115,0,,0,0.0,0.0,0.0,0.0,0.0
2024,9,12,4,2024-09-12,UA,3105,CLT,ATL,"Charlotte, NC",North Carolina,"Atlanta, GA",Georgia,1422,1963,5,0,1427,1963,27,19,1454,1944,1053,139,159,185,0,,0,0.0,0.0,0.0,0.0,0.0
2024,9,10,2,2024-09-10,AS,3422,PDX,DFW,"Portland, OR",Oregon,"Dallas/Fort Worth, TX",Texas,1039,1471,-16,-20,1023,1451,24,18,1047,1433,711,86,106,128,0,,0,0.0,0.0,0.0,0.0,0.0
2024,8,3,6,2024-08-03,HA,8097,CLT,PHL,"Charlotte, NC",North Carolina,"Philadelphia, PA",Pennsylvania,879,845,-22,-15,857,830,25,16,882,814,1582,196,216,237,0,,0,0.0,0.0,0.0,0.0,0.0
2024,10,29,2,2024-10-29,UA,8586,IAH,JFK,"Houston, TX",Texas,"New York, NY",New York,1298,1873,14,10,1312,1883,17,19,1329,1864,1875,232,252,268,0,,0,0.0,0.0,0.0,0.0,0.0
2024,6,20,4,2024-06-20,OH,982,BWI,LAX,"Baltimore, MD",Maryland,"Los Angeles, CA",California,1442,2193,-4,-10,1438,2183,10,9,1448,2174,2689,345,365,364,0,,0,0.0,0.0,0.0,0.0,0.0
2024,5,16,4,2024-05-16,B6,493,BOS,PHX,"Boston, MA",Massachusetts,"Phoenix, AZ",Arizona,1914,1108,6,15,1920,1123,9,13,1929,1110,2145,266,286,288,0,,0,0.0,0.0,0.0,0.0,0.0
2024,6,26,3,2024-06-26,UA,2839,ATL,JFK,"Atlanta, GA",Georgia,"New York, NY",New York,1851,1927,7,10,1858,1937,20,19,1878,1918,980,129,149,168,0,,0,0.0,0.0,0.0,0.0,0.0
2024,3,17,7,2024-03-17,AS,4267,TPA,CLT,"Tampa, FL",Florida,"Charlotte, NC",North Carolina,2003,2136,-15,-10,1988,2126,6,15,1994,2111,281,37,57,58,0,,0,0.0,0.0,0.0,0.0,0.0
2024,7,6,6,2024-07-06,YX,4513,BOS,MIA,"Boston, MA",Massachusetts,"Miami, FL",Florida,1827,1984,6,10,1833,1994,28,19,1861,1975,908,106,126,153,0,,0,0.0,0.0,0.0,0.0,0.0
2024,1,15,1,2024-01-15,9E,4790,IAD,EWR,"Washington, DC",District of Columbia,"Newark, NJ",New Jersey,1805,2338,5,0,1810,2338,28,13,1838,2325,1254,155,175,196,0,,0,0.0,0.0,0.0,0.0,0.0
2024,10,18,5,2024-10-18,B6,4574,DTW,HNL,"Detroit, MI",Michigan,"Honolulu, HI",Hawaii,1194,643,-6,0,1188,643,9,6,1197,637,2008,244,264,259,0,,0,0.0,0.0,0.0,0.0,0.0
2024,11,14,4,2024-11-14,OH,4331,EWR,CLT,"Newark, NJ",New Jersey,"Charlotte, NC",North Carolina,1868,1942,17,10,1885,1952,9,18,1894,1934,598,74,94,101,0,,0,0.0,0.0,0.0,0.0,0.0
2024,11,20,3,2024-11-20,G4,2877,SEA,BOS,"Seattle, WA",Washington,"Boston, MA",Massachusetts,634,1206,4,-5,638,1201,16,3,654,1198,2239,278,298,297,0,,0,0.0,0.0,0.0,0.0,0.0
2024,8,1,4,2024-08-01,UA,1501,DFW,STL,"Dallas/Fort Worth, TX",Texas,"St. Louis, MO",Missouri,1991,2112,5,5,1996,2117,27,15,2023,2102,471,66,86,108,0,,0,0.0,0.0,0.0,0.0,0.0
2024,7,26,5,2024-07-26,AS,8186,DCA,EWR,"Washington, DC",District of Columbia,"Newark, NJ",New Jersey,860,1917,-4,5,856,1922,22,19,878,1903,2115,271,291,312,0,,0,0.0,0.0,0.0,0.0,0.0
2024,6,17,1,2024-06-17,F9,1005,LGA,STL,"New York, NY",New York,"St. Louis, MO",Missouri,1068,1108,1,5,1069,1113,25,17,1094,1096,2544,320,340,362,0,,0,0.0,0.0,0.0,0.0,0.0
2024,11,25,1,2024-11-25,NK,629,STL,DEN,"St. Louis, MO",Missouri,"Denver, CO",Colorado,1638,2144,9,5,1647,2149,5,12,1652,2137,1611,195,215,212,0,,0,0.0,0.0,0.0,0.0,0.0
2024,10,6,7,2024-10-06,AS,8111,IAD,BWI,"Washington, DC",District of Columbia,"Baltimore, MD",Maryland,685,1949,-17,-15,668,1934,17,3,685,1931,547,68,88,88,0,,0,0.0,0.0,0.0,0.0,0.0
2024,10,31,4,2024-10-31,OH,7178,LAX,JFK,"Los Angeles, CA",California,"New York, NY",New York,977,1876,-19,-10,958,1866,24,17,982,1849,2450,301,321,342,0,,0,0.0,0.0,0.0,0.0,0.0
2024,5,25,6,2024-05-25,HA,4718,DFW,LGA,"Dallas/Fort Worth, TX",Texas,"New York, NY",New York,1387,907,8,15,1395,922,16,13,1411,909,2672,342,362,371,0,,0,0.0,0.0,0.0,0.0,0.0
2024,9,19,4,2024-09-19,DL,3821,PHL,MIA,"Philadelphia, PA",Pennsylvania,"Miami, FL",Florida,500,1946,-6,-10,494,1936,12,15,506,1921,735,100,120,127,0,,0,0.0,0.0,0.0,0.0,0.0
2024,1,4,4,2024-01-04,HA,8678,LAX,MIA,"Los Angeles, CA",California,"Miami, FL",Florida,1349,2231,-3,0,1346,2231,5,5,1351,2226,755,85,105,95,0,,0,0.0,0.0,0.0,0.0,0.0
2024,3,30,6,2024-03-30,NK,2721,IAD,PHL,"Washington, DC",District of Columbia,"Philadelphia, PA",Pennsylvania,1467,1466,-12,-5,1455,1461,19,18,1474,1443,1977,255,275,292,0,,0,0.0,0.0,0.0,0.0,0.0
2024,2,29,4,2024-02-29,F9,6826,PDX,JFK,"Portland, OR",Oregon,"New York, NY",New York,1040,1511,-18,-15,1022,1496,14,16,1036,1480,2315,283,303,313,0,,0,0.0,0.0,0.0,0.0,0.0
2024,11,6,3,2024-11-06,AA,672,MCO,BWI,"Orlando, FL",Florida,"Baltimore, MD",Maryland,2267,2265,-14,-10,2253,2255,5,13,2258,2242,2899,362,382,380,0,,0,0.0,0.0,0.0,0.0,0.0
2024,1,16,2,2024-01-16,HA,743,PHX,CLT,"Phoenix, AZ",Arizona,"Charlotte, NC",North Carolina,2185,635,-8,-10,2177,625,18,12,2195,613,1406,175,195,205,0,,0,0.0,0.0,0.0,0.0,0.0
2024,8,14,3,2024-08-14,G4,4171,MSP,LAX,"Minneapolis, MN",Minnesota,"Los Angeles, CA",California,1491,2240,-6,0,1485,2240,17,15,1502,2225,459,59,79,91,0,,0,0.0,0.0,0.0,0.0,0.0
2024,1,29,1,2024-01-29,WN,8171,CLT,ATL,"Charlotte, NC",North Carolina,"Atlanta, GA",Georgia,1947,1310,19,10,1966,1320,24,9,1990,1311,2080,269,289,302,0,,0,0.0,0.0,0.0,0.0,0.0
2024,5,30,4,2024-05-30,F9,7113,MSP,LAX,"Minneapolis, MN",Minnesota,"Los Angeles, CA",California,1201,1914,7,0,1208,1914,14,19,1222,1895,1176,146,166,179,0,,0,0.0,0.0,0.0,0.0,0.0
2024,9,1,7,2024-09-01,HA,9584,DFW,DEN,"Dallas/Fort Worth, TX",Texas,"Denver, CO",Colorado,769,2165,13,5,782,2170,9,18,791,2152,2306,287,307,314,0,,0,0.0,0.0,0.0,0.0,0.0
2024,9,26,4,2024-09-26,9E,5705,JFK,ATL,"New York, NY",New York,"Atlanta, GA",Georgia,2283,1540,-5,-5,2278,1535,13,7,2291,1528,2361,286,306,306,0,,0,0.0,0.0,0.0,0.0,0.0
2024,3,19,2,2024-03-19,NK,5782,MIA,BWI,"Miami, FL",Florida,"Baltimore, MD",Maryland,1397,2228,5,10,1402,2238,18,8,1420,2230,980,129,149,155,0,,0,0.0,0.0,0.0,0.0,0.0
2024,10,15,2,2024-10-15,OH,654,LGA,PDX,"New York, NY",New York,"Portland, OR",Oregon,918,2112,-2,5,916,2117,25,4,941,2113,1356,167,187,196,0,,0,0.0,0.0,0.0,0.0,0.0
2024,6,1,6,2024-06-01,MQ,3493,MDW,PHX,"Chicago, IL",Illinois,"Phoenix, AZ",Arizona,1850,1560,-23,-15,1827,1545,5,5,1832,1540,2870,360,380,370,0,,0,0.0,0.0,0.0,0.0,0.0
2024,10,3,4,2024-10-03,9E,9235,DCA,CLT,"Washington, DC",District of Columbia,"Charlotte, NC",North Carolina,694,835,9,0,703,835,19,12,722,823,252,27,47,58,0,,0,0.0,0.0,0.0,0.0,0.0
2024,10,5,6,2024-10-05,NK,4668,BOS,LAX,"Boston, MA",Massachusetts,"Los Angeles, CA",California,754,2008,5,10,759,2018,23,18,782,2000,2371,289,309,330,0,,0,0.0,0.0,0.0,0.0,0.0
2024,2,26,1,2024-02-26,DL,9285,MIA,EWR,"Miami, FL",Florida,"Newark, NJ",New Jersey,578,960,9,5,587,965,24,3,611,962,260,37,57,64,0,,0,0.0,0.0,0.0,0.0,0.0
2024,7,4,4,2024-07-04,AA,3559,TPA,SEA,"Tampa, FL",Florida,"Seattle, WA",Washington,1621,2330,7,15,1628,2345,11,5,1639,2340,2636,320,340,336,0,,0,0.0,0.0,0.0,0.0,0.0
2024,4,2,2,2024-04-02,WN,1221,MDW,DTW,"Chicago, IL",Illinois,"Detroit, MI",Michigan,1673,1879,-4,-10,1669,1869,22,6,1691,1863,1043,120,140,148,0,,0,0.0,0.0,0.0,0.0,0.0
2024,10,2,3,2024-10-02,YX,5630,STL,TPA,"St. Louis, MO",Missouri,"Tampa, FL",Florida,1285,1467,11,20,1296,1487,8,6,1304,1481,1187,154,174,168,0,,0,6.0,4.0,2.0,0.0,8.0
2024,6,6,4,2024-06-06,DL,5209,SLC,ORD,"Salt Lake City, UT",Utah,"Chicago, IL",Illinois,1313,1982,-5,-10,1308,1972,28,9,1336,1963,1681,204,224,241,0,,0,0.0,0.0,0.0,0.0,0.0
2024,10,1,2,2024-10-01,F9,155,IAD,PHL,"Washington, DC",District of Columbia,"Philadelphia, PA",Pennsylvania,946,2166,-9,-15,937,2151,25,11,962,2140,1608,209,229,245,0,,0,0.0,0.0,0.0,0.0,0.0
2024,6,29,6,2024-06-29,9E,8949,CLT,SAN,"Charlotte, NC",North Carolina,"San Diego, CA",California,622,624,0,0,622,624,10,9,632,615,1642,198,218,217,0,,0,0.0,0.0,0.0,0.0,0.0
2024,12,24,2,2024-12-24,NK,8551,TPA,PDX,"Tampa, FL",Florida,"Portland, OR",Oregon,2133,1414,-22,-15,2111,1399,7,5,2118,1394,1891,232,252,244,0,,0,0.0,0.0,0.0,0.0,0.0
2024,3,17,7,2024-03-17,F9,4836,MCO,BOS,"Orlando, FL",Florida,"Boston, MA",Massachusetts,1175,1551,6,5,1181,1556,8,7,1189,1549,1018,117,137,132,0,,0,0.0,0.0,0.0,0.0,0.0
2024,5,30,4,2024-05-30,OO,2709,DFW,EWR,"Dallas/Fort Worth, TX",Texas,"Newark, NJ",New Jersey,2081,1583,12,15,2093,1598,29,6,2122,1592,2697,332,352,367,0,,0,0.0,0.0,0.0,0.0,0.0
2024,8,25,7,2024-08-25,AS,4009,DCA,STL,"Washington, DC",District of Columbia,"St. Louis, MO",Missouri,858,1624,7,15,865,1639,6,13,871,1626,2014,242,262,261,0,,0,0.0,0.0,0.0,0.0,0.0
2024,10,15,2,2024-10-15,AA,503,MCO,SFO,"Orlando, FL",Florida,"San Francisco, CA",California,738,957,0,0,738,957,7,12,745,945,780,105,125,124,0,,0,0.0,0.0,0.0,0.0,0.0
2024,8,18,7,2024-08-18,OH,894,JFK,LAX,"New York, NY",New York,"Los Angeles, CA",California,2265,717,2,0,2267,717,22,16,2289,701,2568,325,345,363,0,,0,0.0,0.0,0.0,0.0,0.0
2024,1,18,4,2024-01-18,MQ,1661,SEA,LAX,"Seattle, WA",Washington,"Los Angeles, CA",California,1304,1078,43,45,1347,1123,6,19,1353,1104,2619,332,352,357,0,,0,14.0,1.0,7.0,1.0,22.0
2024,3,13,3,2024-03-13,MQ,9475,DCA,DTW,"Washington, DC",District of Columbia,"Detroit, MI",Michigan,2279,1276,4,0,2283,1276,29,4,2312,1272,2852,346,366,379,0,,0,0.0,0.0,0.0,0.0,0.0
2024,7,7,7,2024-07-07,YX,7523,PHL,LAX,"Philadelphia, PA",Pennsylvania,"Los Angeles, CA",California,2053,1058,16,15,2069,1073,12,12,2081,1061,720,82,102,106,0,,0,0.0,0.0,0.0,0.0,0.0
2024,1,17,3,2024-01-17,G4,6895,IAD,MDW,"Washington, DC",District of Columbia,"Chicago, IL",Illinois,1182,712,14,15,1196,727,11,9,1207,718,2666,330,350,350,0,,0,0.0,0.0,0.0,0.0,0.0
2024,1,19,5,2024-01-19,AS,5592,MSP,SAN,"Minneapolis, MN",Minnesota,"San Diego, CA",California,1168,1818,-17,-10,1151,1808,13,5,1164,1803,516,72,92,90,0,,0,0.0,0.0,0.0,0.0,0.0
2024,8,6,2,2024-08-06,YX,5099,DEN,TPA,"Denver, CO",Colorado,"Tampa, FL",Florida,703,2275,-24,-20,679,2255,28,3,707,2252,527,74,94,105,0,,0,0.0,0.0,0.0,0.0,0.0
2024,11,21,4,2024-11-21,MQ,6298,ATL,BWI,"Atlanta, GA",Georgia,"Baltimore, MD",Maryland,2181,1643,-7,-5,2174,1638,13,11,2187,1627,734,90,110,114,0,,0,0.0,0.0,0.0,0.0,0.0
2024,4,29,1,2024-04-29,9E,5297,TPA,DEN,"Tampa, FL",Florida,"Denver, CO",Colorado,642,1909,5,10,647,1919,6,6,653,1913,645,84,104,96,0,,0,0.0,0.0,0.0,0.0,0.0
2024,4,10,3,2024-04-10,AA,3662,EWR,LAS,"Newark, NJ",New Jersey,"Las Vegas, NV",Nevada,686,1057,6,10,692,1067,11,5,703,1062,627,71,91,87,0,,0,0.0,0.0,0.0,0.0,0.0
2024,2,3,6,2024-02-03,AA,1794,SAN,DCA,"San Diego, CA",California,"Washington, DC",District of Columbia,2011,2071,6,0,2017,2071,29,7,2046,2064,2434,313,333,349,0,,0,0.0,0.0,0.0,0.0,0.0
2024,3,24,7,2024-03-24,F9,955,IAH,JFK,"Houston, TX",Texas,"New York, NY",New York,621,2214,-17,-10,604,2204,17,19,621,2185,920,113,133,149,0,,0,0.0,0.0,0.0,0.0,0.0
2024,7,14,7,2024-07-14,AS,9587,PHX,SEA,"Phoenix, AZ",Arizona,"Seattle, WA",Washington,1873,1239,-24,-15,1849,1224,29,19,1878,1205,802,109,129,157,0,,0,0.0,0.0,0.0,0.0,0.0
2024,11,25,1,2024-11-25,F9,4855,STL,PHX,"St. Louis, MO",Missouri,"Phoenix, AZ",Arizona,1623,1708,26,20,1649,1728,12,15,1661,1713,1956,246,266,273,0,,0,3.0,4.0,2.0,0.0,11.0
2024,7,20,6,2024-07-20,F9,3721,IAH,SFO,"Houston, TX",Texas,"San Francisco, CA",California,783,1175,-9,-5,774,1170,5,3,779,1167,2566,314,334,322,0,,0,0.0,0.0,0.0,0.0,0.0
2024,12,9,1,2024-12-09,HA,4306,LGA,SEA,"New York, NY",New York,"Seattle, WA",Washington,1448,1897,0,0,1448,1897,7,15,1455,1882,1419,180,200,202,0,,0,0.0,0.0,0.0,0.0,0.0
2024,12,6,5,2024-12-06,OO,1138,IAD,SAN,"Washington, DC",District of Columbia,"San Diego, CA",California,1026,1399,24,15,1050,1414,12,9,1062,1405,1560,192,212,213,0,,0,0.0,0.0,0.0,0.0,0.0
2024,1,11,4,2024-01-11,OH,4696,IAD,LAX,"Washington, DC",District of Columbia,"Los Angeles, CA",California,883,1002,17,10,900,1012,23,14,923,998,698,88,108,125,0,,0,0.0,0.0,0.0,0.0,0.0
2024,12,12,4,2024-12-12,F9,4613,SEA,MDW,"Seattle, WA",Washington,"Chicago, IL",Illinois,2078,852,-4,0,2074,852,8,11,2082,841,289,43,63,62,0,,0,0.0,0.0,0.0,0.0,0.0
2024,8,5,1,2024-08-05,9E,4470,ATL,PDX,"Atlanta, GA",Georgia,"Portland, OR",Oregon,1397,2229,7,0,1404,2229,14,15,1418,2214,2756,334,354,363,0,,0,0.0,0.0,0.0,0.0,0.0
2024,9,9,1,2024-09-09,HA,7761,DEN,MIA,"Denver, CO",Colorado,"Miami, FL",Florida,686,1557,13,5,699,1562,22,3,721,1559,719,92,112,117,0,,0,0.0,0.0,0.0,0.0,0.0
2024,8,9,5,2024-08-09,NK,5416,DCA,MIA,"Washington, DC",District of Columbia,"Miami, FL",Florida,1531,1261,-2,-5,1529,1256,23,4,1552,1252,2281,276,296,303,0,,0,0.0,0.0,0.0,0.0,0.0
2024,3,20,3,2024-03-20,NK,3547,EWR,MCO,"Newark, NJ",New Jersey,"Orlando, FL",Florida,1123,1988,-3,0,1120,1988,25,10,1145,1978,1767,213,233,248,0,,0,0.0,0.0,0.0,0.0,0.0
2024,1,7,7,2024-01-07,9E,5950,HNL,SAN,"Honolulu, HI",Hawaii,"San Diego, CA",California,1044,1268,-24,-20,1020,1248,16,4,1036,1244,2068,261,281,281,0,,0,0.0,0.0,0.0,0.0,0.0
2024,9,28,6,2024-09-28,WN,7330,TPA,SAN,"Tampa, FL",Florida,"San Diego, CA",California,1942,1327,0,10,1942,1337,15,14,1957,1323,1305,168,188,197,0,,0,0.0,0.0,0.0,0.0,0.0
2024,8,14,3,2024-08-14,G4,3532,DTW,EWR,"Detroit, MI",Michigan,"Newark, NJ",New Jersey,1413,1883,85,90,1498,1973,10,3,1508,1970,1044,135,155,148,0,,0,22.0,0.0,11.0,2.0,55.0
2024,1,16,2,2024-01-16,YX,7216,LGA,DFW,"New York, NY",New York,"Dallas/Fort Worth, TX",Texas,589,2057,13,20,602,2077,10,11,612,2066,1606,205,225,226,1,,0,5.0,4.0,1.0,0.0,10.0
2024,1,12,5,2024-01-12,DL,5329,LGA,DTW,"New York, NY",New York,"Detroit, MI",Michigan,995,1211,0,-5,995,1206,27,8,1022,1198,2755,337,357,372,0,,0,0.0,0.0,0.0,0.0,0.0
2024,10,17,4,2024-10-17,OO,2341,SLC,JFK,"Salt Lake City, UT",Utah,"New York, NY",New York,2184,1745,4,0,2188,1745,12,3,2200,1742,2496,317,337,332,0,,0,0.0,0.0,0.0,0.0,0.0
2024,8,28,3,2024-08-28,G4,7918,LAX,PHX,"Los Angeles, CA",California,"Phoenix, AZ",Arizona,1459,2267,-3,-10,1456,2257,26,8,1482,2249,2566,312,332,346,0,,0,0.0,0.0,0.0,0.0,0.0
2024,1,21,7,2024-01-21,9E,7098,PDX,MSP,"Portland, OR",Oregon,"Minneapolis, MN",Minnesota,2247,2140,2,-5,2249,2135,14,18,2263,2117,2314,279,299,311,0,,0,0.0,0.0,0.0,0.0,0.0
2024,6,26,3,2024-06-26,UA,4994,MIA,TPA,"Miami, FL",Florida,"Tampa, FL",Florida,615,1578,-3,0,612,1578,26,4,638,1574,1381,168,188,198,0,,0,0.0,0.0,0.0,0.0,0.0
2024,8,15,4,2024-08-15,OH,6544,LAS,IAD,"Las Vegas, NV",Nevada,"Washington, DC",District of Columbia,1184,1278,4,5,1188,1283,6,4,1194,1279,2818,353,373,363,0,,0,0.0,0.0,0.0,0.0,0.0
2024,9,29,7,2024-09-29,MQ,3115,DFW,DTW,"Dallas/Fort Worth, TX",Texas,"Detroit, MI",Michigan,1543,1168,-26,-20,1517,1148,17,9,1534,1139,360,50,70,76,0,,0,0.0,0.0,0.0,0.0,0.0
2024,10,14,1,2024-10-14,HA,6915,MIA,SEA,"Miami, FL",Florida,"Seattle, WA",Washington,631,1142,-9,-5,622,1137,23,18,645,1119,727,83,103,124,0,,0,0.0,0.0,0.0,0.0,0.0
2024,10,23,3,2024-10-23,DL,4964,DTW,DCA,"Detroit, MI",Michigan,"Washington, DC",District of Columbia,1815,1118,6,0,1821,1118,26,9,1847,1109,2808,341,361,376,0,,0,0.0,0.0,0.0,0.0,0.0
2024,5,13,1,2024-05-13,MQ,9776,MIA,DEN,"Miami, FL",Florida,"Denver, CO",Colorado,1877,611,-15,-10,1862,601,26,5,1888,596,694,91,111,122,0,,0,0.0,0.0,0.0,0.0,0.0
2024,10,9,3,2024-10-09,WN,4334,BOS,MCO,"Boston, MA",Massachusetts,"Orlando, FL",Florida,1760,609,-15,-15,1745,594,10,4,1755,590,2517,312,332,326,1,,0,0.0,0.0,0.0,0.0,0.0
2024,6,1,6,2024-06-01,B6,5056,LGA,BOS,"New York, NY",New York,"Boston, MA",Massachusetts,2112,756,-1,0,2111,756,8,11,2119,745,2482,318,338,337,0,,0,0.0,0.0,0.0,0.0,0.0
2024,3,6,3,2024-03-06,DL,2439,IAH,EWR,"Houston, TX",Texas,"Newark, NJ",New Jersey,722,1611,-4,0,718,1611,15,7,733,1604,2484,303,323,325,0,,0,0.0,0.0,0.0,0.0,0.0
2024,5,16,4,2024-05-16,MQ,8626,MSP,PDX,"Minneapolis, MN",Minnesota,"Portland, OR",Oregon,935,1324,-4,0,931,1324,22,13,953,1311,2444,298,318,333,0,,0,0.0,0.0,0.0,0.0,0.0
2024,4,1,1,2024-04-01,HA,6942,PHL,MSP,"Philadelphia, PA",Pennsylvania,"Minneapolis, MN",Minnesota,2161,740,-6,-5,2155,735,28,5,2183,730,1203,156,176,189,0,,0,0.0,0.0,0.0,0.0,0.0
2024,11,12,2,2024-11-12,AA,1958,BOS,DEN,"Boston, MA",Massachusetts,"Denver, CO",Colorado,1562,1238,-8,-10,1554,1228,6,4,1560,1224,2200,284,304,294,0,,0,0.0,0.0,0.0,0.0,0.0
2024,9,15,7,2024-09-15,9E,1307,DFW,DEN,"Dallas/Fort Worth, TX",Texas,"Denver, CO",Colorado,826,2333,-18,-10,808,2323,7,13,815,2310,572,62,82,82,0,,0,0.0,0.0,0.0,0.0,0.0
2024,4,12,5,2024-04-12,OO,1024,HNL,TPA,"Honolulu, HI",Hawaii,"Tampa, FL",Florida,1732,736,-22,-20,1710,716,21,14,1731,702,2396,304,324,339,0,,0,0.0,0.0,0.0,0.0,0.0
2024,2,24,6,2024-02-24,B6,3045,IAD,PHL,"Washington, DC",District of Columbia,"Philadelphia, PA",Pennsylvania,605,1290,-16,-10,589,1280,13,17,602,1263,2531,325,345,355,0,,0,0.0,0.0,0.0,0.0,0.0
2024,9,13,5,2024-09-13,G4,5481,PHX,DEN,"Phoenix, AZ",Arizona,"Denver, CO",Colorado,1151,2223,15,10,1166,2233,23,19,1189,2214,1408,182,202,224,0,,0,0.0,0.0,0.0,0.0,0.0
2024,4,10,3,2024-04-10,HA,5529,DFW,ORD,"Dallas/Fort Worth, TX",Texas,"Chicago, IL",Illinois,1772,2023,-20,-20,1752,2003,22,4,1774,1999,2626,321,341,347,0,,0,0.0,0.0,0.0,0.0,0.0
2024,7,16,2,2024-07-16,YX,4539,HNL,LGA,"Honolulu, HI",Hawaii,"New York, NY",New York,1066,1042,-13,-20,1053,1022,10,3,1063,1019,1920,235,255,248,0,,0,0.0,0.0,0.0,0.0,0.0
2024,10,27,7,2024-10-27,YX,7691,LAX,IAH,"Los Angeles, CA",California,"Houston, TX",Texas,1129,2065,-11,-15,1118,2050,28,6,1146,2044,1688,206,226,240,0,,0,0.0,0.0,0.0,0.0,0.0
2024,8,13,2,2024-08-13,HA,5992,ATL,STL,"Atlanta, GA",Georgia,"St. Louis, MO",Missouri,1187,1890,-11,-5,1176,1885,8,19,1184,1866,305,40,60,67,0,,0,0.0,0.0,0.0,0.0,0.0
2024,8,24,6,2024-08-24,B6,6045,SLC,ORD,"Salt Lake City, UT",Utah,"Chicago, IL",Illinois,1877,1275,-8,-5,1869,1270,21,9,1890,1261,1245,162,182,192,0,,0,0.0,0.0,0.0,0.0,0.0
2024,1,26,5,2024-01-26,YX,7791,SFO,ATL,"San Francisco, CA",California,"Atlanta, GA",Georgia,969,2136,-13,-10,956,2126,27,7,983,2119,2015,241,261,275,0,,0,0.0,0.0,0.0,0.0,0.0
2024,4,30,2,2024-04-30,OO,4127,SEA,LGA,"Seattle, WA",Washington,"New York, NY",New York,1224,876,-7,-15,1217,861,23,10,1240,851,1071,129,149,162,0,,0,0.0,0.0,0.0,0.0,0.0
2024,6,30,7,2024-06-30,9E,4395,EWR,STL,"Newark, NJ",New Jersey,"St. Louis, MO",Missouri,764,2307,9,15,773,2322,25,3,798,2319,473,57,77,85,0,,0,0.0,0.0,0.0,0.0,0.0
2024,7,17,3,2024-07-17,G4,7579,SFO,IAH,"San Francisco, CA",California,"Houston, TX",Texas,2175,1979,8,15,2183,1994,15,12,2198,1982,512,56,76,83,0,,0,0.0,0.0,0.0,0.0,0.0
2024,10,28,1,2024-10-28,OH,4761,MDW,IAH,"Chicago, IL",Illinois,"Houston, TX",Texas,1987,1532,14,5,2001,1537,22,6,2023,1531,1809,232,252,260,0,,0,0.0,0.0,0.0,0.0,0.0
2024,9,11,3,2024-09-11,MQ,2498,SEA,STL,"Seattle, WA",Washington,"St. Louis, MO",Missouri,1336,2277,-3,-10,1333,2267,28,16,1361,2251,1068,127,147,171,0,,0,0.0,0.0,0.0,0.0,0.0
2024,5,1,3,2024-05-01,YX,127,DCA,CLT,"Washington, DC",District of Columbia,"Charlotte, NC",North Carolina,1350,1716,-4,-5,1346,1711,20,11,1366,1700,2081,253,273,284,0,,0,0.0,0.0,0.0,0.0,0.0
2024,1,31,3,2024-01-31,9E,1998,TPA,JFK,"Tampa, FL",Florida,"New York, NY",New York,1964,1240,-5,5,1959,1245,23,19,1982,1226,2942,370,390,412,0,,0,0.0,0.0,0.0,0.0,0.0
2024,11,10,7,2024-11-10,AS,7400,EWR,DCA,"Newark, NJ",New Jersey,"Washington, DC",District of Columbia,1807,1759,-13,-10,1794,1749,13,16,1807,1733,2265,282,302,311,0,,0,0.0,0.0,0.0,0.0,0.0
2024,10,11,5,2024-10-11,UA,2527,IAD,PDX,"Washington, DC",District of Columbia,"Portland, OR",Oregon,1284,710,-2,0,1282,710,21,4,1303,706,2645,329,349,354,0,,0,0.0,0.0,0.0,0.0,0.0
2024,4,15,1,2024-04-15,WN,1725,PHX,STL,"Phoenix, AZ",Arizona,"St. Louis, MO",Missouri,1033,1667,7,5,1040,1672,20,16,1060,1656,1575,190,210,226,0,,0,0.0,0.0,0.0,0.0,0.0
2024,8,11,7,2024-08-11,WN,2136,TPA,MIA,"Tampa, FL",Florida,"Miami, FL",Florida,868,1490,-10,0,858,1490,10,11,868,1479,2542,317,337,338,0,,0,0.0,0.0,0.0,0.0,0.0
2024,9,29,7,2024-09-29,AA,9602,PHL,PDX,"Philadelphia, PA",Pennsylvania,"Portland, OR",Oregon,1198,810,-10,-5,1188,805,23,7,1211,798,363,46,66,76,0,,0,0.0,0.0,0.0,0.0,0.0
2024,8,19,1,2024-08-19,UA,3455,BOS,IAD,"Boston, MA",Massachusetts,"Washington, DC",District of Columbia,2242,942,-15,-5,2227,937,8,17,2235,920,2102,271,291,296,0,,0,0.0,0.0,0.0,0.0,0.0
2024,9,12,4,2024-09-12,UA,7146,PDX,ATL,"Portland, OR",Oregon,"Atlanta, GA",Georgia,2182,1982,8,5,2190,1987,15,8,2205,1979,854,105,125,128,0,,0,0.0,0.0,0.0,0.0,0.0
2024,1,24,3,2024-01-24,MQ,3820,SLC,LAS,"Salt Lake City, UT",Utah,"Las Vegas, NV",Nevada,2018,960,-1,5,2017,965,24,18,2041,947,514,65,85,107,0,,0,0.0,0.0,0.0,0.0,0.0
2024,4,18,4,2024-04-18,OH,5002,DCA,STL,"Washington, DC",District of Columbia,"St. Louis, MO",Missouri,1445,1954,7,5,1452,1959,19,13,1471,1946,616,76,96,108,0,,0,0.0,0.0,0.0,0.0,0.0
2024,7,9,2,2024-07-09,AA,5336,MSP,PDX,"Minneapolis, MN",Minnesota,"Portland, OR",Oregon,653,1010,-11,-5,642,1005,28,11,670,994,1687,207,227,246,0,,0,0.0,0.0,0.0,0.0,0.0
2024,12,12,4,2024-12-12,MQ,8380,MCO,IAH,"Orlando, FL",Florida,"Houston, TX",Texas,1119,1358,9,5,1128,1363,13,14,1141,1349,2059,266,286,293,1,,0,0.0,0.0,0.0,0.0,0.0
2024,1,25,4,2024-01-25,G4,8413,IAH,SAN,"Houston, TX",Texas,"San Diego, CA",California,815,1107,12,20,827,1127,25,10,852,1117,506,72,92,107,0,,0,6.0,4.0,3.0,0.0,7.0
2024,7,5,5,2024-07-05,OO,5061,LAX,BOS,"Los Angeles, CA",California,"Boston, MA",Massachusetts,1823,831,-2,5,1821,836,15,19,1836,817,2337,291,311,325,0,,0,0.0,0.0,0.0,0.0,0.0
2024,10,14,1,2024-10-14,AA,132,BOS,MDW,"Boston, MA",Massachusetts,"Chicago, IL",Illinois,1963,1403,-13,-5,1950,1398,14,14,1964,1384,831,108,128,136,0,,0,0.0,0.0,0.0,0.0,0.0
2024,4,25,4,2024-04-25,G4,4798,LAS,BWI,"Las Vegas, NV",Nevada,"Baltimore, MD",Maryland,1310,1793,14,5,1324,1798,14,3,1338,1795,300,41,61,58,0,,0,0.0,0.0,0.0,0.0,0.0
2024,12,3,2,2024-12-03,AA,8987,IAD,IAH,"Washington, DC",District of Columbia,"Houston, TX",Texas,650,2027,1,0,651,2027,23,10,674,2017,873,110,130,143,0,,0,0.0,0.0,0.0,0.0,0.0
2024,2,6,2,2024-02-06,DL,3941,DTW,BWI,"Detroit, MI",Michigan,"Baltimore, MD",Maryland,1929,833,13,10,1942,843,29,3,1971,840,2033,251,271,283,0,,0,0.0,0.0,0.0,0.0,0.0
2024,10,8,2,2024-10-08,DL,8816,MSP,DCA,"Minneapolis, MN",Minnesota,"Washington, DC",District of Columbia,674,1119,0,5,674,1124,5,15,679,1109,2000,256,276,276,0,,0,0.0,0.0,0.0,0.0,0.0
2024,5,16,4,2024-05-16,OH,5544,IAD,DEN,"Washington, DC",District of Columbia,"Denver, CO",Colorado,1578,901,13,5,1591,906,21,7,1612,899,819,95,115,123,0,,0,0.0,0.0,0.0,0.0,0.0
2024,8,14,3,2024-08-14,AS,6277,MIA,IAD,"Miami, FL",Florida,"Washington, DC",District of Columbia,1278,699,-1,5,1277,704,23,7,1300,697,2517,304,324,334,0,,0,0.0,0.0,0.0,0.0,0.0
2024,11,15,5,2024-11-15,NK,8538,LAS,MDW,"Las Vegas, NV",Nevada,"Chicago, IL",Illinois,1834,852,-9,-15,1825,837,22,10,1847,827,1206,144,164,176,0,,0,0.0,0.0,0.0,0.0,0.0
2024,11,23,6,2024-11-23,OO,4026,MIA,CLT,"Miami, FL",Florida,"Charlotte, NC",North Carolina,653,907,8,0,661,907,28,13,689,894,2743,351,371,392,0,,0,0.0,0.0,0.0,0.0,0.0
2024,6,30,7,2024-06-30,AA,3059,PDX,SLC,"Portland, OR",Oregon,"Salt Lake City, UT",Utah,2023,1393,-8,-15,2015,1378,25,10,2040,1368,301,33,53,68,0,,0,0.0,0.0,0.0,0.0,0.0
2024,12,27,5,2024-12-27,UA,2327,PDX,CLT,"Portland, OR",Oregon,"Charlotte, NC",North Carolina,1000,1402,-4,-5,996,1397,21,12,1017,1385,1612,198,218,231,0,,0,0.0,0.0,0.0,0.0,0.0
2024,3,26,2,2024-03-26,DL,1493,ORD,LAX,"Chicago, IL",Illinois,"Los Angeles, CA",California,1713,2323,12,5,1725,2328,23,7,1748,2321,442,45,65,75,0,,0,0.0,0.0,0.0,0.0,0.0
2024,2,22,4,2024-02-22,F9,2123,ORD,MCO,"Chicago, IL",Illinois,"Orlando, FL",Florida,1005,986,-11,-5,994,981,7,5,1001,976,547,62,82,74,0,,0,0.0,0.0,0.0,0.0,0.0
2024,12,13,5,2024-12-13,G4,6164,PDX,LAS,"Portland, OR",Oregon,"Las Vegas, NV",Nevada,648,1746,-18,-20,630,1726,17,7,647,1719,232,25,45,49,0,,0,0.0,0.0,0.0,0.0,0.0
2024,12,20,5,2024-12-20,MQ,7662,PHX,TPA,"Phoenix, AZ",Arizona,"Tampa, FL",Florida,507,731,-12,-5,495,726,6,17,501,709,280,27,47,50,0,,0,0.0,0.0,0.0,0.0,0.0
2024,8,22,4,2024-08-22,DL,6739,DFW,MSP,"Dallas/Fort Worth, TX",Texas,"Minneapolis, MN",Minnesota,2183,1859,-8,-15,2175,1844,13,16,2188,1828,2031,250,270,279,0,,0,0.0,0.0,0.0,0.0,0.0
2024,9,23,1,2024-09-23,DL,2578,ATL,MCO,"Atlanta, GA",Georgia,"Orlando, FL",Florida,2208,820,14,5,2222,825,17,7,2239,818,2410,293,313,317,0,,0,0.0,0.0,0.0,0.0,0.0
2024,10,13,7,2024-10-13,9E,7474,IAD,HNL,"Washington, DC",District of Columbia,"Honolulu, HI",Hawaii,1092,661,3,5,1095,666,5,4,1100,662,910,121,141,130,0,,0,0.0,0.0,0.0,0.0,0.0
2024,4,9,2,2024-04-09,HA,8029,DCA,CLT,"Washington, DC",District of Columbia,"Charlotte, NC",North Carolina,1090,1431,1,10,1091,1441,14,9,1105,1432,2739,347,367,370,0,,0,0.0,0.0,0.0,0.0,0.0
2024,3,27,3,2024-03-27,G4,4559,BWI,LAS,"Baltimore, MD",Maryland,"Las Vegas, NV",Nevada,968,2313,-21,-20,947,2293,25,9,972,2284,1777,214,234,248,0,,0,0.0,0.0,0.0,0.0,0.0
2024,1,15,1,2024-01-15,OH,6553,MSP,BWI,"Minneapolis, MN",Minnesota,"Baltimore, MD",Maryland,820,1331,-18,-20,802,1311,29,16,831,1295,2726,331,351,376,0,,0,0.0,0.0,0.0,0.0,0.0
2024,4,10,3,2024-04-10,WN,9273,SFO,DFW,"San Francisco, CA",California,"Dallas/Fort Worth, TX",Texas,1071,1002,10,15,1081,1017,7,17,1088,1000,319,44,64,68,0,,0,0.0,0.0,0.0,0.0,0.0
2024,6,13,4,2024-06-13,B6,8518,DTW,MCO,"Detroit, MI",Michigan,"Orlando, FL",Florida,950,770,-6,-15,944,755,14,19,958,736,2892,367,387,400,0,,0,0.0,0.0,0.0,0.0,0.0
2024,1,29,1,2024-01-29,MQ,1366,JFK,MSP,"New York, NY",New York,"Minneapolis, MN",Minnesota,2130,2099,2,5,2132,2104,23,11,2155,2093,2179,276,296,310,0,,0,0.0,0.0,0.0,0.0,0.0
2024,4,23,2,2024-04-23,OO,2157,MDW,SFO,"Chicago, IL",Illinois,"San Francisco, CA",California,627,2217,7,5,634,2222,11,6,645,2216,204,28,48,45,0,,0,0.0,0.0,0.0,0.0,0.0
2024,4,16,2,2024-04-16,G4,8096,DEN,IAH,"Denver, CO",Colorado,"Houston, TX",Texas,2157,613,-12,-5,2145,608,21,18,2166,590,415,41,61,80,0,,0,0.0,0.0,0.0,0.0,0.0
2024,12,29,7,2024-12-29,AS,3041,DFW,EWR,"Dallas/Fort Worth, TX",Texas,"Newark, NJ",New Jersey,1810,869,8,0,1818,869,29,16,1847,853,2493,307,327,352,0,,0,0.0,0.0,0.0,0.0,0.0
2024,5,9,4,2024-05-09,9E,256,IAH,ATL,"Houston, TX",Texas,"Atlanta, GA",Georgia,1352,1677,-14,-10,1338,1667,27,3,1365,1664,2205,276,296,306,0,,0,0.0,0.0,0.0,0.0,0.0
2024,3,24,7,2024-03-24,YX,7098,DEN,DTW,"Denver, CO",Colorado,"Detroit, MI",Michigan,586,2036,19,15,605,2051,16,4,621,2047,1139,149,169,169,0,,0,0.0,0.0,0.0,0.0,0.0
2024,9,27,5,2024-09-27,G4,860,DCA,DFW,"Washington, DC",District of Columbia,"Dallas/Fort Worth, TX",Texas,1604,1754,-11,-5,1593,1749,12,15,1605,1734,2973,380,400,407,0,,0,0.0,0.0,0.0,0.0,0.0
2024,8,31,6,2024-08-31,G4,9065,BOS,PDX,"Boston, MA",Massachusetts,"Portland, OR",Oregon,1033,2233,-4,-10,1029,2223,22,10,1051,2213,801,97,117,129,0,,0,0.0,0.0,0.0,0.0,0.0
2024,8,1,4,2024-08-01,NK,6507,EWR,ATL,"Newark, NJ",New Jersey,"Atlanta, GA",Georgia,1775,1312,8,0,1783,1312,7,11,1790,1301,1288,163,183,181,0,,0,0.0,0.0,0.0,0.0,0.0
2024,11,1,5,2024-11-01,OH,9844,SFO,PHX,"San Francisco, CA",California,"Phoenix, AZ",Arizona,689,1471,-16,-10,673,1461,29,12,702,1449,2072,254,274,295,0,,0,0.0,0.0,0.0,0.0,0.0
2024,6,14,5,2024-06-14,YX,6831,HNL,STL,"Honolulu, HI",Hawaii,"St. Louis, MO",Missouri,1323,2356,5,5,1328,2361,8,12,1336,2349,2330,300,320,320,0,,0,0.0,0.0,0.0,0.0,0.0
2024,10,5,6,2024-10-05,9E,1057,SFO,ORD,"San Francisco, CA",California,"Chicago, IL",Illinois,2121,2140,-7,0,2114,2140,25,18,2139,2122,2560,319,339,362,0,,0,0.0,0.0,0.0,0.0,0.0
2024,2,28,3,2024-02-28,G4,353,LAX,IAH,"Los Angeles, CA",California,"Houston, TX",Texas,2007,1228,-12,-15,1995,1213,29,11,2024,1202,377,49,69,89,0,,0,0.0,0.0,0.0,0.0,0.0
2024,3,30,6,2024-03-30,B6,7985,LAX,MCO,"Los Angeles, CA",California,"Orlando, FL",Florida,878,900,-22,-15,856,885,12,8,868,877,891,119,139,139,0,,0,0.0,0.0,0.0,0.0,0.0
2024,11,26,2,2024-11-26,B6,1669,TPA,EWR,"Tampa, FL",Florida,"Newark, NJ",New Jersey,955,1303,-22,-15,933,1288,9,14,942,1274,1874,225,245,248,0,,0,0.0,0.0,0.0,0.0,0.0
2024,7,12,5,2024-07-12,YX,7593,SLC,HNL,"Salt Lake City, UT",Utah,"Honolulu, HI",Hawaii,1531,1026,-24,-15,1507,1011,15,19,1522,992,2277,286,306,320,0,,0,0.0,0.0,0.0,0.0,0.0
2024,5,2,4,2024-05-02,F9,7605,PDX,MSP,"Portland, OR",Oregon,"Minneapolis, MN",Minnesota,817,715,-9,-5,808,710,6,12,814,698,1909,240,260,258,0,,0,0.0,0.0,0.0,0.0,0.0
2024,5,15,3,2024-05-15,9E,6983,EWR,HNL,"Newark, NJ",New Jersey,"Honolulu, HI",Hawaii,833,835,18,10,851,845,23,13,874,832,926,124,144,160,1,,0,0.0,0.0,0.0,0.0,0.0
2024,5,18,6,2024-05-18,WN,5106,DEN,DCA,"Denver, CO",Colorado,"Washington, DC",District of Columbia,729,2186,-25,-15,704,2171,7,11,711,2160,1601,209,229,227,0,,0,0.0,0.0,0.0,0.0,0.0
2024,8,16,5,2024-08-16,G4,9099,JFK,SLC,"New York, NY",New York,"Salt Lake City, UT",Utah,1163,612,-14,-15,1149,597,16,5,1165,592,2134,268,288,289,0,,0,0.0,0.0,0.0,0.0,0.0
2024,9,30,1,2024-09-30,NK,5868,PHX,MIA,"Phoenix, AZ",Arizona,"Miami, FL",Florida,1007,1841,3,-5,1010,1836,11,7,1021,1829,2307,290,310,308,0,,0,0.0,0.0,0.0,0.0,0.0
2024,2,19,1,2024-02-19,NK,5016,STL,DEN,"St. Louis, MO",Missouri,"Denver, CO",Colorado,1289,1952,1,0,1290,1952,10,7,1300,1945,2253,282,302,299,0,,0,0.0,0.0,0.0,0.0,0.0
2024,4,27,6,2024-04-27,MQ,9513,LAX,SAN,"Los Angeles, CA",California,"San Diego, CA",California,2050,667,3,5,2053,672,27,7,2080,665,1957,250,270,284,0,,0,0.0,0.0,0.0,0.0,0.0
2024,7,20,6,2024-07-20,HA,7641,DFW,MDW,"Dallas/Fort Worth, TX",Texas,"Chicago, IL",Illinois,1998,1342,11,15,2009,1357,12,13,2021,1344,2252,278,298,303,0,,0,0.0,0.0,0.0,0.0,0.0
2024,7,9,2,2024-07-09,UA,6807,BWI,SLC,"Baltimore, MD",Maryland,"Salt Lake City, UT",Utah,1423,1436,-15,-5,1408,1431,9,6,1417,1425,1141,137,157,152,0,,0,0.0,0.0,0.0,0.0,0.0
2024,12,29,7,2024-12-29,WN,3300,DFW,SFO,"Dallas/Fort Worth, TX",Texas,"San Francisco, CA",California,1929,990,-20,-15,1909,975,17,7,1926,968,1389,163,183,187,0,,0,0.0,0.0,0.0,0.0,0.0
2024,11,18,1,2024-11-18,NK,6657,DFW,JFK,"Dallas/Fort Worth, TX",Texas,"New York, NY",New York,1810,1715,-11,-10,1799,1705,17,13,1816,1692,1662,212,232,242,0,,0,0.0,0.0,0.0,0.0,0.0
2024,6,29,6,2024-06-29,OO,7647,BWI,IAH,"Baltimore, MD",Maryland,"Houston, TX",Texas,1468,703,-20,-10,1448,693,26,14,1474,679,263,24,44,64,0,,0,0.0,0.0,0.0,0.0,0.0
2024,3,18,1,2024-03-18,OO,9171,ORD,MCO,"Chicago, IL",Illinois,"Orlando, FL",Florida,1259,2213,12,5,1271,2218,5,19,1276,2199,2381,304,324,328,0,,0,0.0,0.0,0.0,0.0,0.0
2024,3,15,5,2024-03-15,OH,5188,BWI,IAD,"Baltimore, MD",Maryland,"Washington, DC",District of Columbia,2290,2049,-3,5,2287,2054,18,17,2305,2037,1237,153,173,188,0,,0,0.0,0.0,0.0,0.0,0.0
2024,10,21,1,2024-10-21,B6,100,SAN,LAS,"San Diego, CA",California,"Las Vegas, NV",Nevada,945,1213,-10,-10,935,1203,8,4,943,1199,763,96,116,108,0,,0,0.0,0.0,0.0,0.0,0.0
2024,10,7,1,2024-10-07,YX,266,TPA,IAD,"Tampa, FL",Florida,"Washington, DC",District of Columbia,1866,1372,13,10,1879,1382,26,3,1905,1379,1401,177,197,206,0,,0,0.0,0.0,0.0,0.0,0.0
2024,1,21,7,2024-01-21,UA,2163,JFK,ATL,"New York, NY",New York,"Atlanta, GA",Georgia,824,903,5,10,829,913,24,8,853,905,879,117,137,149,0,,0,0.0,0.0,0.0,0.0,0.0
2024,6,19,3,2024-06-19,AA,8403,HNL,BOS,"Honolulu, HI",Hawaii,"Boston, MA",Massachusetts,1376,978,10,10,1386,988,5,3,1391,985,2795,345,365,353,0,,0,0.0,0.0,0.0,0.0,0.0
2024,1,15,1,2024-01-15,NK,1225,CLT,MSP,"Charlotte, NC",North Carolina,"Minneapolis, MN",Minnesota,666,1971,-14,-10,652,1961,18,17,670,1944,546,70,90,105,0,,0,0.0,0.0,0.0,0.0,0.0
2024,7,29,1,2024-07-29,AS,2741,IAD,STL,"Washington, DC",District of Columbia,"St. Louis, MO",Missouri,2116,1798,-18,-15,2098,1783,23,4,2121,1779,1784,227,247,254,0,,0,0.0,0.0,0.0,0.0,0.0
2024,2,17,6,2024-02-17,9E,1529,SAN,LGA,"San Diego, CA",California,"New York, NY",New York,1819,2015,-21,-15,1798,2000,23,10,1821,1990,384,46,66,79,0,,0,0.0,0.0,0.0,0.0,0.0
2024,3,26,2,2024-03-26,HA,6201,PHL,DEN,"Philadelphia, PA",Pennsylvania,"Denver, CO",Colorado,1080,2028,2,-5,1082,2023,7,18,1089,2005,789,99,119,124,0,,0,0.0,0.0,0.0,0.0,0.0
2024,5,28,2,2024-05-28,NK,1734,STL,TPA,"St. Louis, MO",Missouri,"Tampa, FL",Florida,1706,687,-1,-5,1705,682,24,18,1729,664,670,78,98,120,0,,0,0.0,0.0,0.0,0.0,0.0
2024,7,6,6,2024-07-06,HA,8962,LAS,PHX,"Las Vegas, NV",Nevada,"Phoenix, AZ",Arizona,1338,1229,17,10,1355,1239,15,18,1370,1221,2355,303,323,336,0,,0,0.0,0.0,0.0,0.0,0.0
2024,11,1,5,2024-11-01,OH,3211,TPA,CLT,"Tampa, FL",Florida,"Charlotte, NC",North Carolina,2099,2276,-18,-10,2081,2266,13,4,2094,2262,1838,228,248,245,0,,0,0.0,0.0,0.0,0.0,0.0
2024,5,30,4,2024-05-30,DL,1790,BWI,SEA,"Baltimore, MD",Maryland,"Seattle, WA",Washington,2299,1224,-1,0,2298,1224,29,16,2327,1208,1942,251,271,296,0,,0,0.0,0.0,0.0,0.0,0.0
2024,5,20,1,2024-05-20,MQ,7815,SAN,TPA,"San Diego, CA",California,"Tampa, FL",Florida,1609,1872,9,5,1618,1877,28,4,1646,1873,2678,335,355,367,0,,0,0.0,0.0,0.0,0.0,0.0
2024,3,9,6,2024-03-09,YX,6740,SLC,SAN,"Salt Lake City, UT",Utah,"San Diego, CA",California,2079,965,-13,-10,2066,955,23,4,2089,951,2835,351,371,378,0,,0,0.0,0.0,0.0,0.0,0.0
2024,9,16,1,2024-09-16,WN,4057,STL,DEN,"St. Louis, MO",Missouri,"Denver, CO",Colorado,1305,1712,-13,-10,1292,1702,6,19,1298,1683,1155,142,162,167,0,,0,0.0,0.0,0.0,0.0,0.0
2024,11,29,5,2024-11-29,DL,9256,PDX,PHX,"Portland, OR",Oregon,"Phoenix, AZ",Arizona,1672,1476,8,5,1680,1481,17,16,1697,1465,1967,238,258,271,0,,0,0.0,0.0,0.0,0.0,0.0
2024,1,9,2,2024-01-09,F9,380,SFO,SAN,"San Francisco, CA",California,"San Diego, CA",California,1271,1331,4,5,1275,1336,7,19,1282,1317,485,57,77,83,0,,0,0.0,0.0,0.0,0.0,0.0
2024,4,30,2,2024-04-30,NK,4546,CLT,BOS,"Charlotte, NC",North Carolina,"Boston, MA",Massachusetts,1427,1598,22,20,1449,1618,15,18,1464,1600,2663,324,344,357,0,,0,0.0,4.0,0.0,0.0,16.0
2024,4,10,3,2024-04-10,AA,2908,BWI,EWR,"Baltimore, MD",Maryland,"Newark, NJ",New Jersey,1360,1055,9,10,1369,1065,18,19,1387,1046,1986,247,267,284,0,,0,0.0,0.0,0.0,0.0,0.0
2024,5,28,2,2024-05-28,DL,5502,MSP,SAN,"Minneapolis, MN",Minnesota,"San Diego, CA",California,1455,1014,5,10,1460,1024,19,14,1479,1010,923,122,142,155,0,,0,0.0,0.0,0.0,0.0,0.0
2024,5,25,6,2024-05-25,DL,2064,PHX,DCA,"Phoenix, AZ",Arizona,"Washington, DC",District of Columbia,558,1054,12,5,570,1059,9,6,579,1053,2112,259,279,274,0,,0,0.0,0.0,0.0,0.0,0.0
2024,12,18,3,2024-12-18,WN,922,DTW,SLC,"Detroit, MI",Michigan,"Salt Lake City, UT",Utah,1105,2186,-10,-15,1095,2171,11,10,1106,2161,2823,346,366,367,0,,0,0.0,0.0,0.0,0.0,0.0
2024,8,30,5,2024-08-30,UA,9729,PHX,DFW,"Phoenix, AZ",Arizona,"Dallas/Fort Worth, TX",Texas,504,1110,17,10,521,1120,6,3,527,1117,2241,287,307,296,0,,0,0.0,0.0,0.0,0.0,0.0
2024,8,28,3,2024-08-28,AA,2161,SLC,PHL,"Salt Lake City, UT",Utah,"Philadelphia, PA",Pennsylvania,582,1798,24,15,606,1813,10,16,616,1797,611,70,90,96,0,,0,0.0,0.0,0.0,0.0,0.0
2024,12,2,1,2024-12-02,YX,5275,JFK,BOS,"New York, NY",New York,"Boston, MA",Massachusetts,1339,1534,-10,-5,1329,1529,15,11,1344,1518,714,94,114,120,0,,0,0.0,0.0,0.0,0.0,0.0
2024,2,12,1,2024-02-12,OH,3965,PDX,DFW,"Portland, OR",Oregon,"Dallas/Fort Worth, TX",Texas,1906,808,-7,-5,1899,803,6,14,1905,789,1666,198,218,218,0,,0,0.0,0.0,0.0,0.0,0.0
2024,4,4,4,2024-04-04,DL,4394,CLT,LAX,"Charlotte, NC",North Carolina,"Los Angeles, CA",California,1048,2252,5,0,1053,2252,17,4,1070,2248,2395,296,316,317,0,,0,0.0,0.0,0.0,0.0,0.0
2024,8,13,2,2024-08-13,OO,9756,CLT,SFO,"Charlotte, NC",North Carolina,"San Francisco, CA",California,2002,1936,15,20,2017,1956,5,8,2022,1948,1322,156,176,169,0,,0,0.0,3.0,3.0,0.0,14.0
2024,1,6,6,2024-01-06,G4,177,MCO,TPA,"Orlando, FL",Florida,"Tampa, FL",Florida,1550,970,-15,-15,1535,955,7,7,1542,948,1669,211,231,225,0,,0,0.0,0.0,0.0,0.0,0.0
2024,8,1,4,2024-08-01,MQ,2259,SLC,TPA,"Salt Lake City, UT",Utah,"Tampa, FL",Florida,1024,1936,-3,5,1021,1941,24,16,1045,1925,2694,329,349,369,0,,0,0.0,0.0,0.0,0.0,0.0
2024,7,24,3,2024-07-24,AA,3287,PDX,BOS,"Portland, OR",Oregon,"Boston, MA",Massachusetts,1501,1402,7,10,1508,1412,6,17,1514,1395,1101,144,164,167,0,,0,0.0,0.0,0.0,0.0,0.0
2024,3,7,4,2024-03-07,G4,9457,BOS,JFK,"Boston, MA",Massachusetts,"New York, NY",New York,2100,2127,-5,5,2095,2132,23,15,2118,2117,2706,338,358,376,0,,0,0.0,0.0,0.0,0.0,0.0
2024,4,9,2,2024-04-09,NK,7235,MIA,PHX,"Miami, FL",Florida,"Phoenix, AZ",Arizona,913,685,4,0,917,685,26,11,943,674,269,42,62,79,0,,0,0.0,0.0,0.0,0.0,0.0
2024,1,12,5,2024-01-12,DL,889,STL,DCA,"St. Louis, MO",Missouri,"Washington, DC",District of Columbia,1214,1246,19,15,1233,1261,13,3,1246,1258,1718,222,242,238,0,,0,0.0,0.0,0.0,0.0,0.0
2024,8,24,6,2024-08-24,DL,1663,LAS,LGA,"Las Vegas, NV",Nevada,"New York, NY",New York,679,1420,-7,-15,672,1405,22,10,694,1395,1669,212,232,244,0,,0,0.0,0.0,0.0,0.0,0.0
2024,11,17,7,2024-11-17,B6,1422,JFK,DFW,"New York, NY",New York,"Dallas/Fort Worth, TX",Texas,1987,1889,-11,-10,1976,1879,27,18,2003,1861,1416,169,189,214,0,,0,0.0,0.0,0.0,0.0,0.0
2024,9,14,6,2024-09-14,MQ,6773,ORD,TPA,"Chicago, IL",Illinois,"Tampa, FL",Florida,1282,1843,3,-5,1285,1838,5,9,1290,1829,2685,337,357,351,0,,0,0.0,0.0,0.0,0.0,0.0
2024,12,2,1,2024-12-02,B6,1602,ORD,CLT,"Chicago, IL",Illinois,"Charlotte, NC",North Carolina,1400,894,-22,-20,1378,874,24,18,1402,856,2628,322,342,364,0,,0,0.0,0.0,0.0,0.0,0.0
2024,5,14,2,2024-05-14,WN,7216,SAN,IAH,"San Diego, CA",California,"Houston, TX",Texas,1026,2321,-9,-5,1017,2316,18,15,1035,2301,2069,251,271,284,0,,0,0.0,0.0,0.0,0.0,0.0
2024,8,9,5,2024-08-09,YX,9783,EWR,PHL,"Newark, NJ",New Jersey,"Philadelphia, PA",Pennsylvania,500,1105,-7,-10,493,1095,18,15,511,1080,1254,160,180,193,0,,0,0.0,0.0,0.0,0.0,0.0
2024,6,4,2,2024-06-04,9E,1759,MIA,SEA,"Miami, FL",Florida,"Seattle, WA",Washington,770,1786,-4,5,766,1791,22,13,788,1778,2804,340,360,375,0,,0,0.0,0.0,0.0,0.0,0.0
2024,5,21,2,2024-05-21,9E,9607,MDW,STL,"Chicago, IL",Illinois,"St. Louis, MO",Missouri,983,1750,-3,-5,980,1745,17,18,997,1727,1965,244,264,279,0,,0,0.0,0.0,0.0,0.0,0.0
2024,6,6,4,2024-06-06,MQ,3162,LGA,MDW,"New York, NY",New York,"Chicago, IL",Illinois,1455,1426,14,5,1469,1431,8,11,1477,1420,1448,173,193,192,0,,0,0.0,0.0,0.0,0.0,0.0
2024,11,21,4,2024-11-21,YX,8416,STL,MIA,"St. Louis, MO",Missouri,"Miami, FL",Florida,1571,716,-17,-10,1554,706,22,15,1576,691,791,92,112,129,0,,0,0.0,0.0,0.0,0.0,0.0
2024,12,9,1,2024-12-09,UA,3162,BWI,IAH,"Baltimore, MD",Maryland,"Houston, TX",Texas,1193,2029,-19,-15,1174,2014,23,12,1197,2002,1243,164,184,199,0,,0,0.0,0.0,0.0,0.0,0.0
2024,9,18,3,2024-09-18,WN,8810,ATL,DCA,"Atlanta, GA",Georgia,"Washington, DC",District of Columbia,1706,1248,-18,-15,1688,1233,28,9,1716,1224,2167,275,295,312,0,,0,0.0,0.0,0.0,0.0,0.0
2024,10,9,3,2024-10-09,9E,2170,DTW,ATL,"Detroit, MI",Michigan,"Atlanta, GA",Georgia,1339,955,-5,-10,1334,945,8,19,1342,926,2141,269,289,296,1,,0,0.0,0.0,0.0,0.0,0.0
2024,12,3,2,2024-12-03,WN,4357,BWI,ORD,"Baltimore, MD",Maryland,"Chicago, IL",Illinois,872,1375,-6,-15,866,1360,10,12,876,1348,2159,275,295,297,0,,0,0.0,0.0,0.0,0.0,0.0
2024,12,9,1,2024-12-09,DL,2653,HNL,BWI,"Honolulu, HI",Hawaii,"Baltimore, MD",Maryland,2249,1622,-12,-10,2237,1612,16,4,2253,1608,377,41,61,61,0,,0,0.0,0.0,0.0,0.0,0.0
2024,8,16,5,2024-08-16,B6,1144,JFK,DEN,"New York, NY",New York,"Denver, CO",Colorado,1038,1845,0,0,1038,1845,13,18,1051,1827,2861,363,383,394,0,,0,0.0,0.0,0.0,0.0,0.0
2024,10,6,7,2024-10-06,HA,6057,IAH,ORD,"Houston, TX",Texas,"Chicago, IL",Illinois,2030,1999,-7,-10,2023,1989,17,5,2040,1984,1201,152,172,174,0,,0,0.0,0.0,0.0,0.0,0.0
2024,12,23,1,2024-12-23,B6,4678,EWR,SAN,"Newark, NJ",New Jersey,"San Diego, CA",California,2261,1937,-12,-5,2249,1932,28,3,2277,1929,1424,175,195,206,0,,0,0.0,0.0,0.0,0.0,0.0
2024,10,16,3,2024-10-16,B6,5721,DEN,ORD,"Denver, CO",Colorado,"Chicago, IL",Illinois,1169,1773,-7,-15,1162,1758,18,7,1180,1751,2582,326,346,351,0,,0,0.0,0.0,0.0,0.0,0.0
2024,6,16,7,2024-06-16,OO,2066,LGA,EWR,"New York, NY",New York,"Newark, NJ",New Jersey,2029,835,14,10,2043,845,19,3,2062,842,379,48,68,70,0,,0,0.0,0.0,0.0,0.0,0.0
2024,2,16,5,2024-02-16,HA,5069,DFW,HNL,"Dallas/Fort Worth, TX",Texas,"Honolulu, HI",Hawaii,1071,1791,-12,-15,1059,1776,18,9,1077,1767,2549,313,333,340,0,,0,0.0,0.0,0.0,0.0,0.0
2024,7,21,7,2024-07-21,OO,2350,PHX,DCA,"Phoenix, AZ",Arizona,"Washington, DC",District of Columbia,565,2118,0,-5,565,2113,22,6,587,2107,277,30,50,58,0,,0,0.0,0.0,0.0,0.0,0.0
2024,8,1,4,2024-08-01,9E,8433,PDX,PHL,"Portland, OR",Oregon,"Philadelphia, PA",Pennsylvania,2209,2035,4,-5,2213,2030,6,11,2219,2019,1680,212,232,229,0,,0,0.0,0.0,0.0,0.0,0.0
2024,9,2,1,2024-09-02,AA,9295,STL,BWI,"St. Louis, MO",Missouri,"Baltimore, MD",Maryland,551,1541,-3,5,548,1546,7,3,555,1543,2896,368,388,378,0,,0,0.0,0.0,0.0,0.0,0.0
2024,1,24,3,2024-01-24,AS,2114,PHX,LAS,"Phoenix, AZ",Arizona,"Las Vegas, NV",Nevada,969,668,-5,0,964,668,22,3,986,665,616,84,104,109,0,,0,0.0,0.0,0.0,0.0,0.0
2024,11,16,6,2024-11-16,OO,4724,SLC,DEN,"Salt Lake City, UT",Utah,"Denver, CO",Colorado,742,2344,-12,-5,730,2339,23,8,753,2331,1280,167,187,198,0,,0,0.0,0.0,0.0,0.0,0.0
2024,9,30,1,2024-09-30,DL,3708,PHX,SAN,"Phoenix, AZ",Arizona,"San Diego, CA",California,836,2187,-5,5,831,2192,22,19,853,2173,956,111,131,152,0,,0,0.0,0.0,0.0,0.0,0.0
2024,2,13,2,2024-02-13,NK,6819,IAD,PDX,"Washington, DC",District of Columbia,"Portland, OR",Oregon,1255,866,7,0,1262,866,19,18,1281,848,1990,242,262,279,0,,0,0.0,0.0,0.0,0.0,0.0
2024,11,27,3,2024-11-27,WN,9260,IAH,TPA,"Houston, TX",Texas,"Tampa, FL",Florida,1644,1773,-18,-15,1626,1758,26,6,1652,1752,1986,250,270,282,0,,0,0.0,0.0,0.0,0.0,0.0
2024,11,8,5,2024-11-08,HA,4025,MDW,BOS,"Chicago, IL",Illinois,"Boston, MA",Massachusetts,1053,1414,0,-5,1053,1409,29,12,1082,1397,494,63,83,104,0,,0,0.0,0.0,0.0,0.0,0.0
2024,12,28,6,2024-12-28,B6,5968,DTW,IAD,"Detroit, MI",Michigan,"Washington, DC",District of Columbia,2219,2148,29,20,2248,2168,28,18,2276,2150,1164,140,160,186,0,,0,5.0,0.0,3.0,0.0,12.0
2024,6,4,2,2024-06-04,B6,904,CLT,DFW,"Charlotte, NC",North Carolina,"Dallas/Fort Worth, TX",Texas,1568,981,5,0,1573,981,10,9,1583,972,921,117,137,136,0,,0,0.0,0.0,0.0,0.0,0.0
2024,7,17,3,2024-07-17,B6,1434,IAD,STL,"Washington, DC",District of Columbia,"St. Louis, MO",Missouri,551,2235,-1,-5,550,2230,8,4,558,2226,1916,243,263,255,0,,0,0.0,0.0,0.0,0.0,0.0
2024,6,10,1,2024-06-10,DL,767,LAX,TPA,"Los Angeles, CA",California,"Tampa, FL",Florida,1674,973,-24,-15,1650,958,14,9,1664,949,552,77,97,100,0,,0,0.0,0.0,0.0,0.0,0.0
2024,8,21,3,2024-08-21,B6,484,LGA,DEN,"New York, NY",New York,"Denver, CO",Colorado,912,1284,11,10,923,1294,16,9,939,1285,1592,194,214,219,0,,0,0.0,0.0,0.0,0.0,0.0
2024,6,11,2,2024-06-11,UA,9900,MIA,JFK,"Miami, FL",Florida,"New York, NY",New York,2064,1105,-22,-15,2042,1090,9,7,2051,1083,537,62,82,78,0,,0,0.0,0.0,0.0,0.0,0.0
2024,4,25,4,2024-04-25,WN,3354,CLT,PHX,"Charlotte, NC",North Carolina,"Phoenix, AZ",Arizona,1068,836,-15,-15,1053,821,24,17,1077,804,2579,321,341,362,0,,0,0.0,0.0,0.0,0.0,0.0
2024,4,2,2,2024-04-02,MQ,3540,DFW,ORD,"Dallas/Fort Worth, TX",Texas,"Chicago, IL",Illinois,2021,2210,-14,-5,2007,2205,9,12,2016,2193,672,76,96,97,0,,0,0.0,0.0,0.0,0.0,0.0
2024,2,11,7,2024-02-11,DL,2848,SLC,BWI,"Salt Lake City, UT",Utah,"Baltimore, MD",Maryland,1732,924,-10,-5,1722,919,20,7,1742,912,1031,137,157,164,0,,0,0.0,0.0,0.0,0.0,0.0
2024,10,10,4,2024-10-10,WN,112,IAD,EWR,"Washington, DC",District of Columbia,"Newark, NJ",New Jersey,507,1873,36,30,543,1903,22,7,565,1896,1085,144,164,173,0,,0,11.0,0.0,1.0,0.0,18.0
2024,7,28,7,2024-07-28,MQ,7826,CLT,MSP,"Charlotte, NC",North Carolina,"Minneapolis, MN",Minnesota,1445,1189,-7,-15,1438,1174,19,6,1457,1168,1250,162,182,187,0,,0,0.0,0.0,0.0,0.0,0.0
2024,7,24,3,2024-07-24,G4,5503,ORD,PHX,"Chicago, IL",Illinois,"Phoenix, AZ",Arizona,1914,1389,-2,0,1912,1389,12,16,1924,1373,816,104,124,132,0,,0,0.0,0.0,0.0,0.0,0.0
2024,8,7,3,2024-08-07,F9,7554,PDX,STL,"Portland, OR",Oregon,"St. Louis, MO",Missouri,746,2074,-16,-10,730,2064,5,11,735,2053,444,60,80,76,0,,0,0.0,0.0,0.0,0.0,0.0
2024,10,6,7,2024-10-06,MQ,6251,MCO,MDW,"Orlando, FL",Florida,"Chicago, IL",Illinois,1918,1353,8,5,1926,1358,13,19,1939,1339,2000,256,276,288,0,,0,0.0,0.0,0.0,0.0,0.0
2024,5,15,3,2024-05-15,OH,6330,LAX,BWI,"Los Angeles, CA",California,"Baltimore, MD",Maryland,2230,2045,0,-5,2230,2040,16,14,2246,2026,888,104,124,134,0,,0,0.0,0.0,0.0,0.0,0.0
2024,4,15,1,2024-04-15,HA,200,PHL,PHX,"Philadelphia, PA",Pennsylvania,"Phoenix, AZ",Arizona,1333,1839,-10,0,1323,1839,5,18,1328,1821,2439,301,321,324,0,,0,0.0,0.0,0.0,0.0,0.0
2024,4,27,6,2024-04-27,OO,5078,DTW,JFK,"Detroit, MI",Michigan,"New York, NY",New York,1862,1331,4,-5,1866,1326,9,5,1875,1321,404,48,68,62,0,,0,0.0,0.0,0.0,0.0,0.0
2024,8,24,6,2024-08-24,YX,9604,PHX,SAN,"Phoenix, AZ",Arizona,"San Diego, CA",California,911,620,-8,0,903,620,13,12,916,608,774,97,117,122,0,,0,0.0,0.0,0.0,0.0,0.0
2024,11,4,1,2024-11-04,UA,6634,STL,PDX,"St. Louis, MO",Missouri,"Portland, OR",Oregon,1451,904,-1,0,1450,904,5,9,1455,895,824,104,124,118,0,,0,0.0,0.0,0.0,0.0,0.0
2024,4,9,2,2024-04-09,AA,4804,MIA,ATL,"Miami, FL",Florida,"Atlanta, GA",Georgia,2063,1976,-1,-5,2062,1971,18,3,2080,1968,201,33,53,54,0,,0,0.0,0.0,0.0,0.0,0.0
2024,9,17,2,2024-09-17,AA,549,TPA,ORD,"Tampa, FL",Florida,"Chicago, IL",Illinois,1868,1203,-8,0,1860,1203,21,3,1881,1200,878,99,119,123,0,,0,0.0,0.0,0.0,0.0,0.0
2024,10,31,4,2024-10-31,AS,3267,LAX,ATL,"Los Angeles, CA",California,"Atlanta, GA",Georgia,1342,1406,-15,-5,1327,1401,7,17,1334,1384,2454,299,319,323,0,,0,0.0,0.0,0.0,0.0,0.0
2024,12,19,4,2024-12-19,UA,5480,LAS,MCO,"Las Vegas, NV",Nevada,"Orlando, FL",Florida,1819,1609,12,10,1831,1619,20,3,1851,1616,1541,183,203,206,0,,0,0.0,0.0,0.0,0.0,0.0
2024,10,12,6,2024-10-12,WN,8412,LAS,HNL,"Las Vegas, NV",Nevada,"Honolulu, HI",Hawaii,734,1044,4,0,738,1044,12,11,750,1033,980,118,138,141,0,,0,0.0,0.0,0.0,0.0,0.0
2024,11,23,6,2024-11-23,AA,3956,DEN,LAX,"Denver, CO",Colorado,"Los Angeles, CA",California,1141,2235,14,15,1155,2250,23,16,1178,2234,1088,128,148,167,0,,0,0.0,0.0,0.0,0.0,0.0
2024,4,12,5,2024-04-12,F9,1175,PHL,JFK,"Philadelphia, PA",Pennsylvania,"New York, NY",New York,1087,865,-18,-10,1069,855,19,15,1088,840,2356,291,311,325,0,,0,0.0,0.0,0.0,0.0,0.0
2024,3,3,7,2024-03-03,AA,4513,CLT,IAD,"Charlotte, NC",North Carolina,"Washington, DC",District of Columbia,1968,1596,-8,-15,1960,1581,6,18,1966,1563,2550,316,336,340,0,,0,0.0,0.0,0.0,0.0,0.0
2024,6,23,7,2024-06-23,B6,801,HNL,IAD,"Honolulu, HI",Hawaii,"Washington, DC",District of Columbia,732,1791,3,-5,735,1786,10,19,745,1767,894,120,140,149,0,,0,0.0,0.0,0.0,0.0,0.0
2024,10,8,2,2024-10-08,AS,3448,IAD,MCO,"Washington, DC",District of Columbia,"Orlando, FL",Florida,1241,1681,-16,-10,1225,1671,14,11,1239,1660,354,34,54,59,0,,0,0.0,0.0,0.0,0.0,0.0
2024,10,19,6,2024-10-19,HA,8285,JFK,BOS,"New York, NY",New York,"Boston, MA",Massachusetts,1496,1200,-6,-5,1490,1195,25,16,1515,1179,1329,166,186,207,0,,0,0.0,0.0,0.0,0.0,0.0
2024,8,13,2,2024-08-13,DL,6936,ATL,DTW,"Atlanta, GA",Georgia,"Detroit, MI",Michigan,809,2308,-5,-10,804,2298,17,5,821,2293,2200,266,286,288,0,,0,0.0,0.0,0.0,0.0,0.0
2024,1,7,7,2024-01-07,NK,8312,SFO,SLC,"San Francisco, CA",California,"Salt Lake City, UT",Utah,1443,2280,19,10,1462,2290,19,11,1481,2279,1638,202,222,232,0,,0,0.0,0.0,0.0,0.0,0.0
2024,5,6,1,2024-05-06,NK,5934,PHX,DFW,"Phoenix, AZ",Arizona,"Dallas/Fort Worth, TX",Texas,1407,1232,7,0,1414,1232,15,3,1429,1229,1057,128,148,146,0,,0,0.0,0.0,0.0,0.0,0.0
2024,4,1,1,2024-04-01,AA,2349,MIA,ATL,"Miami, FL",Florida,"Atlanta, GA",Georgia,1200,1356,-3,0,1197,1356,13,7,1210,1349,733,95,115,115,0,,0,0.0,0.0,0.0,0.0,0.0
2024,7,8,1,2024-07-08,WN,3322,SFO,MDW,"San Francisco, CA",California,"Chicago, IL",Illinois,977,923,7,5,984,928,18,8,1002,920,2279,289,309,315,0,,0,0.0,0.0,0.0,0.0,0.0
2024,12,24,2,2024-12-24,YX,5091,BWI,EWR,"Baltimore, MD",Maryland,"Newark, NJ",New Jersey,2037,1889,-18,-15,2019,1874,7,16,2026,1858,2567,321,341,344,0,,0,0.0,0.0,0.0,0.0,0.0
2024,2,22,4,2024-02-22,MQ,9474,STL,SFO,"St. Louis, MO",Missouri,"San Francisco, CA",California,835,1685,12,10,847,1695,24,12,871,1683,1245,154,174,190,0,,0,0.0,0.0,0.0,0.0,0.0
2024,8,29,4,2024-08-29,WN,8218,SAN,PHX,"San Diego, CA",California,"Phoenix, AZ",Arizona,2100,688,1,0,2101,688,20,10,2121,678,1925,238,258,268,0,,0,0.0,0.0,0.0,0.0,0.0
2024,5,11,6,2024-05-11,B6,2651,DFW,PHX,"Dallas/Fort Worth, TX",Texas,"Phoenix, AZ",Arizona,551,1015,-13,-15,538,1000,12,17,550,983,1187,153,173,182,0,,0,0.0,0.0,0.0,0.0,0.0
2024,12,29,7,2024-12-29,AA,8357,MSP,HNL,"Minneapolis, MN",Minnesota,"Honolulu, HI",Hawaii,1045,2207,16,10,1061,2217,15,3,1076,2214,1214,152,172,170,0,,0,0.0,0.0,0.0,0.0,0.0
2024,4,21,7,2024-04-21,AA,8202,MSP,IAD,"Minneapolis, MN",Minnesota,"Washington, DC",District of Columbia,800,1281,4,0,804,1281,6,18,810,1263,2737,341,361,365,0,,0,0.0,0.0,0.0,0.0,0.0
2024,1,7,7,2024-01-07,NK,8763,LAS,LAX,"Las Vegas, NV",Nevada,"Los Angeles, CA",California,2275,2308,-2,0,2273,2308,9,9,2282,2299,1270,167,187,185,0,,0,0.0,0.0,0.0,0.0,0.0
2024,8,17,6,2024-08-17,G4,2314,IAH,PDX,"Houston, TX",Texas,"Portland, OR",Oregon,1140,1699,19,10,1159,1709,16,3,1175,1706,200,27,47,46,0,,0,0.0,0.0,0.0,0.0,0.0
2024,6,4,2,2024-06-04,AA,8634,TPA,DEN,"Tampa, FL",Florida,"Denver, CO",Colorado,1766,1004,3,10,1769,1014,13,7,1782,1007,237,31,51,51,0,,0,0.0,0.0,0.0,0.0,0.0
2024,7,15,1,2024-07-15,DL,817,PDX,PHL,"Portland, OR",Oregon,"Philadelphia, PA",Pennsylvania,855,964,11,10,866,974,15,12,881,962,1648,214,234,241,0,,0,0.0,0.0,0.0,0.0,0.0
2024,11,18,1,2024-11-18,AS,2560,DEN,EWR,"Denver, CO",Colorado,"Newark, NJ",New Jersey,1319,2293,-12,-5,1307,2288,20,7,1327,2281,2731,343,363,370,0,,0,0.0,0.0,0.0,0.0,0.0
2024,12,29,7,2024-12-29,HA,3355,SEA,BOS,"Seattle, WA",Washington,"Boston, MA",Massachusetts,1334,2348,7,5,1341,2353,29,10,1370,2343,2645,337,357,376,0,,0,0.0,0.0,0.0,0.0,0.0
2024,8,10,6,2024-08-10,HA,5890,SEA,PDX,"Seattle, WA",Washington,"Portland, OR",Oregon,2133,984,-18,-10,2115,974,14,8,2129,966,2482,312,332,334,0,,0,0.0,0.0,0.0,0.0,0.0
2024,9,6,5,2024-09-06,AS,5434,CLT,IAD,"Charlotte, NC",North Carolina,"Washington, DC",District of Columbia,1087,608,4,10,1091,618,29,12,1120,606,2610,324,344,365,1,,0,0.0,0.0,0.0,0.0,0.0
2024,3,23,6,2024-03-23,DL,6930,SEA,BOS,"Seattle, WA",Washington,"Boston, MA",Massachusetts,1965,1114,-3,-5,1962,1109,15,16,1977,1093,1738,223,243,254,1,,0,0.0,0.0,0.0,0.0,0.0
2024,8,27,2,2024-08-27,G4,7854,MIA,SEA,"Miami, FL",Florida,"Seattle, WA",Washington,1376,1992,3,0,1379,1992,5,10,1384,1982,2383,296,316,311,0,,0,0.0,0.0,0.0,0.0,0.0
2024,12,25,3,2024-12-25,WN,7040,MIA,DCA,"Miami, FL",Florida,"Washington, DC",District of Columbia,1230,908,7,10,1237,918,5,8,1242,910,1541,196,216,209,0,,0,0.0,0.0,0.0,0.0,0.0
2024,11,18,1,2024-11-18,MQ,3732,BOS,CLT,"Boston, MA",Massachusetts,"Charlotte, NC",North Carolina,2136,769,10,10,2146,779,5,11,2151,768,1993,246,266,262,0,,0,0.0,0.0,0.0,0.0,0.0
2024,9,19,4,2024-09-19,NK,9347,PHX,MIA,"Phoenix, AZ",Arizona,"Miami, FL",Florida,1642,746,17,20,1659,766,28,17,1687,749,2323,297,317,342,0,,0,2.0,4.0,0.0,0.0,14.0
2024,7,7,7,2024-07-07,AS,114,STL,HNL,"St. Louis, MO",Missouri,"Honolulu, HI",Hawaii,1932,2141,-4,-5,1928,2136,24,18,1952,2118,1309,166,186,208,0,,0,0.0,0.0,0.0,0.0,0.0
2024,10,16,3,2024-10-16,OO,8308,TPA,STL,"Tampa, FL",Florida,"St. Louis, MO",Missouri,2175,2306,-10,-10,2165,2296,19,3,2184,2293,2459,312,332,334,0,,0,0.0,0.0,0.0,0.0,0.0
2024,12,27,5,2024-12-27,MQ,2049,MIA,PDX,"Miami, FL",Florida,"Portland, OR",Oregon,1894,679,21,15,1915,694,13,16,1928,678,2136,263,283,292,0,,0,0.0,0.0,0.0,0.0,0.0
2024,2,27,2,2024-02-27,OO,8372,ORD,CLT,"Chicago, IL",Illinois,"Charlotte, NC",North Carolina,1236,1403,2,0,1238,1403,10,9,1248,1394,2755,350,370,369,0,,0,0.0,0.0,0.0,0.0,0.0
2024,1,9,2,2024-01-09,UA,6899,IAD,TPA,"Washington, DC",District of Columbia,"Tampa, FL",Florida,2290,1051,3,10,2293,1061,23,14,2316,1047,2510,316,336,353,0,,0,0.0,0.0,0.0,0.0,0.0
2024,10,30,3,2024-10-30,F9,6679,SLC,ORD,"Salt Lake City, UT",Utah,"Chicago, IL",Illinois,1596,2089,7,5,1603,2094,12,12,1615,2082,1564,187,207,211,0,,0,0.0,0.0,0.0,0.0,0.0
2024,4,24,3,2024-04-24,NK,3179,TPA,SFO,"Tampa, FL",Florida,"San Francisco, CA",California,1972,1577,8,10,1980,1587,21,17,2001,1570,515,63,83,101,0,,0,0.0,0.0,0.0,0.0,0.0
2024,7,28,7,2024-07-28,G4,8227,MCO,LAS,"Orlando, FL",Florida,"Las Vegas, NV",Nevada,1323,1406,8,5,1331,1411,16,9,1347,1402,221,17,37,42,0,,0,0.0,0.0,0.0,0.0,0.0
2024,2,10,6,2024-02-10,UA,9310,MIA,JFK,"Miami, FL",Florida,"New York, NY",New York,1994,2178,11,10,2005,2188,6,7,2011,2181,1117,139,159,152,0,,0,0.0,0.0,0.0,0.0,0.0
2024,10,30,3,2024-10-30,AA,9071,MSP,MDW,"Minneapolis, MN",Minnesota,"Chicago, IL",Illinois,655,1356,-13,-15,642,1341,12,13,654,1328,1628,201,221,226,0,,0,0.0,0.0,0.0,0.0,0.0
2024,6,21,5,2024-06-21,DL,1924,EWR,PHL,"Newark, NJ",New Jersey,"Philadelphia, PA",Pennsylvania,1270,2035,17,20,1287,2055,5,5,1292,2050,708,81,101,91,0,,0,4.0,3.0,2.0,0.0,11.0
2024,8,21,3,2024-08-21,YX,6429,EWR,IAH,"Newark, NJ",New Jersey,"Houston, TX",Texas,1433,2185,-16,-10,1417,2175,17,6,1434,2169,1236,148,168,171,0,,0,0.0,0.0,0.0,0.0,0.0
2024,10,7,1,2024-10-07,OO,3964,SLC,MDW,"Salt Lake City, UT",Utah,"Chicago, IL",Illinois,1075,894,-20,-20,1055,874,15,13,1070,861,2484,318,338,346,0,,0,0.0,0.0,0.0,0.0,0.0
2024,3,18,1,2024-03-18,HA,2613,SLC,BWI,"Salt Lake City, UT",Utah,"Baltimore, MD",Maryland,1833,1753,9,0,1842,1753,25,17,1867,1736,1933,241,261,283,0,,0,0.0,0.0,0.0,0.0,0.0
2024,4,17,3,2024-04-17,YX,6810,PDX,DEN,"Portland, OR",Oregon,"Denver, CO",Colorado,1559,1788,0,5,1559,1793,23,17,1582,1776,2720,335,355,375,0,,0,0.0,0.0,0.0,0.0,0.0
2024,10,7,1,2024-10-07,AA,8616,JFK,LAX,"New York, NY",New York,"Los Angeles, CA",California,747,1212,1,5,748,1217,6,19,754,1198,2886,361,381,386,0,,0,0.0,0.0,0.0,0.0,0.0
2024,2,8,4,2024-02-08,OO,3590,PHL,EWR,"Philadelphia, PA",Pennsylvania,"Newark, NJ",New Jersey,1951,1482,-1,-5,1950,1477,24,13,1974,1464,243,32,52,69,0,,0,0.0,0.0,0.0,0.0,0.0
2024,4,28,7,2024-04-28,B6,8968,MDW,LAS,"Chicago, IL",Illinois,"Las Vegas, NV",Nevada,1567,1049,-1,5,1566,1054,22,8,1588,1046,480,66,86,96,0,,0,0.0,0.0,0.0,0.0,0.0
2024,11,30,6,2024-11-30,HA,6225,ATL,LAS,"Atlanta, GA",Georgia,"Las Vegas, NV",Nevada,952,2130,8,10,960,2140,25,9,985,2131,1278,149,169,183,0,,0,0.0,0.0,0.0,0.0,0.0
2024,12,1,7,2024-12-01,9E,8179,BWI,DTW,"Baltimore, MD",Maryland,"Detroit, MI",Michigan,1642,668,9,0,1651,668,28,13,1679,655,1975,241,261,282,0,,0,0.0,0.0,0.0,0.0,0.0
2024,1,27,6,2024-01-27,OH,4988,CLT,PHX,"Charlotte, NC",North Carolina,"Phoenix, AZ",Arizona,1872,1155,3,-5,1875,1150,8,7,1883,1143,2026,259,279,274,0,,0,0.0,0.0,0.0,0.0,0.0
2024,4,13,6,2024-04-13,DL,2804,SAN,LGA,"San Diego, CA",California,"New York, NY",New York,1192,1508,-6,0,1186,1508,11,3,1197,1505,1043,129,149,143,0,,0,0.0,0.0,0.0,0.0,0.0
2024,3,14,4,2024-03-14,UA,9486,HNL,MDW,"Honolulu, HI",Hawaii,"Chicago, IL",Illinois,1408,2285,12,10,1420,2295,9,3,1429,2292,2964,366,386,378,0,,0,0.0,0.0,0.0,0.0,0.0
2024,7,9,2,2024-07-09,F9,6360,LGA,DFW,"New York, NY",New York,"Dallas/Fort Worth, TX",Texas,1439,1099,16,15,1455,1114,13,15,1468,1099,2835,359,379,387,0,,0,0.0,0.0,0.0,0.0,0.0
2024,11,19,2,2024-11-19,HA,9196,DTW,MCO,"Detroit, MI",Michigan,"Orlando, FL",Florida,1911,1758,-26,-20,1885,1738,17,4,1902,1734,523,61,81,82,0,,0,0.0,0.0,0.0,0.0,0.0
2024,5,26,7,2024-05-26,9E,4697,ATL,SLC,"Atlanta, GA",Georgia,"Salt Lake City, UT",Utah,1593,1429,-19,-15,1574,1414,22,8,1596,1406,2961,372,392,402,0,,0,0.0,0.0,0.0,0.0,0.0
2024,9,11,3,2024-09-11,OH,3004,ATL,STL,"Atlanta, GA",Georgia,"St. Louis, MO",Missouri,1446,1101,-28,-20,1418,1081,19,16,1437,1065,1143,135,155,170,0,,0,0.0,0.0,0.0,0.0,0.0
2024,10,10,4,2024-10-10,B6,1223,DTW,TPA,"Detroit, MI",Michigan,"Tampa, FL",Florida,953,1573,2,0,955,1573,22,13,977,1560,1267,162,182,197,0,,0,0.0,0.0,0.0,0.0,0.0
2024,7,31,3,2024-07-31,WN,7035,BOS,MSP,"Boston, MA",Massachusetts,"Minneapolis, MN",Minnesota,766,1968,-5,-5,761,1963,5,7,766,1956,2359,299,319,311,0,,0,0.0,0.0,0.0,0.0,0.0
2024,5,2,4,2024-05-02,B6,4416,STL,IAH,"St. Louis, MO",Missouri,"Houston, TX",Texas,1230,1329,-1,0,1229,1329,8,15,1237,1314,2515,312,332,335,0,,0,0.0,0.0,0.0,0.0,0.0
2024,7,24,3,2024-07-24,9E,2370,ORD,SAN,"Chicago, IL",Illinois,"San Diego, CA",California,1961,1500,3,5,1964,1505,17,14,1981,1491,1539,185,205,216,0,,0,0.0,0.0,0.0,0.0,0.0
2024,8,27,2,2024-08-27,AS,2824,MIA,SAN,"Miami, FL",Florida,"San Diego, CA",California,865,1259,-10,-5,855,1254,18,11,873,1243,1437,184,204,213,0,,0,0.0,0.0,0.0,0.0,0.0
2024,12,4,3,2024-12-04,YX,8221,PHL,IAD,"Philadelphia, PA",Pennsylvania,"Washington, DC",District of Columbia,2225,2261,-7,-10,2218,2251,12,6,2230,2245,1133,140,160,158,1,,0,0.0,0.0,0.0,0.0,0.0
2024,10,12,6,2024-10-12,NK,7771,ORD,TPA,"Chicago, IL",Illinois,"Tampa, FL",Florida,2291,1360,-6,-5,2285,1355,25,8,2310,1347,1730,215,235,248,0,,0,0.0,0.0,0.0,0.0,0.0
2024,1,22,1,2024-01-22,OH,2358,BWI,BOS,"Baltimore, MD",Maryland,"Boston, MA",Massachusetts,1710,653,-14,-20,1696,633,9,6,1705,627,1573,194,214,209,0,,0,0.0,0.0,0.0,0.0,0.0
2024,9,15,7,2024-09-15,MQ,3962,MCO,ATL,"Orlando, FL",Florida,"Atlanta, GA",Georgia,1750,931,1,10,1751,941,24,3,1775,938,214,34,54,61,0,,0,0.0,0.0,0.0,0.0,0.0
2024,12,22,7,2024-12-22,G4,9222,LGA,IAH,"New York, NY",New York,"Houston, TX",Texas,560,1558,-14,-5,546,1553,11,19,557,1534,2027,262,282,292,0,,0,0.0,0.0,0.0,0.0,0.0
2024,4,14,7,2024-04-14,AA,3746,ORD,IAD,"Chicago, IL",Illinois,"Washington, DC",District of Columbia,667,2043,-7,0,660,2043,28,19,688,2024,2828,355,375,402,0,,0,0.0,0.0,0.0,0.0,0.0
2024,9,14,6,2024-09-14,WN,7125,MSP,DEN,"Minneapolis, MN",Minnesota,"Denver, CO",Colorado,631,2358,-9,-5,622,2353,13,12,635,2341,1675,212,232,237,0,,0,0.0,0.0,0.0,0.0,0.0
2024,7,22,1,2024-07-22,YX,1371,BWI,DCA,"Baltimore, MD",Maryland,"Washington, DC",District of Columbia,654,2344,9,0,663,2344,10,16,673,2328,1394,168,188,194,0,,0,0.0,0.0,0.0,0.0,0.0
2024,11,5,2,2024-11-05,YX,9089,MCO,MIA,"Orlando, FL",Florida,"Miami, FL",Florida,1283,1255,-7,0,1276,1255,16,5,1292,1250,2837,349,369,370,0,,0,0.0,0.0,0.0,0.0,0.0
2024,9,18,3,2024-09-18,G4,3563,BWI,MSP,"Baltimore, MD",Maryland,"Minneapolis, MN",Minnesota,1221,912,-13,-10,1208,902,29,19,1237,883,1570,195,215,243,0,,0,0.0,0.0,0.0,0.0,0.0
2024,4,16,2,2024-04-16,B6,8708,PDX,JFK,"Portland, OR",Oregon,"New York, NY",New York,506,1761,3,0,509,1761,15,6,524,1755,2367,290,310,311,0,,0,0.0,0.0,0.0,0.0,0.0
2024,9,7,6,2024-09-07,F9,5041,PHL,DEN,"Philadelphia, PA",Pennsylvania,"Denver, CO",Colorado,1022,954,-6,-15,1016,939,19,4,1035,935,1389,172,192,195,0,,0,0.0,0.0,0.0,0.0,0.0
2024,8,8,4,2024-08-08,YX,997,DEN,MCO,"Denver, CO",Colorado,"Orlando, FL",Florida,2235,2125,-8,0,2227,2125,21,17,2248,2108,481,50,70,88,0,,0,0.0,0.0,0.0,0.0,0.0
2024,8,9,5,2024-08-09,AA,8344,STL,DEN,"St. Louis, MO",Missouri,"Denver, CO",Colorado,750,824,5,5,755,829,7,8,762,821,1841,235,255,250,0,,0,0.0,0.0,0.0,0.0,0.0
2024,9,14,6,2024-09-14,WN,705,IAD,CLT,"Washington, DC",District of Columbia,"Charlotte, NC",North Carolina,2099,1213,-8,0,2091,1213,21,11,2112,1202,1438,188,208,220,0,,0,0.0,0.0,0.0,0.0,0.0
2024,7,19,5,2024-07-19,YX,3777,HNL,BWI,"Honolulu, HI",Hawaii,"Baltimore, MD",Maryland,1191,698,-1,5,1190,703,25,9,1215,694,561,66,86,100,0,,0,0.0,0.0,0.0,0.0,0.0
2024,9,14,6,2024-09-14,OH,4647,EWR,DEN,"Newark, NJ",New Jersey,"Denver, CO",Colorado,2163,906,-5,-10,2158,896,12,12,2170,884,697,84,104,108,0,,0,0.0,0.0,0.0,0.0,0.0
2024,12,14,6,2024-12-14,YX,8752,BOS,DTW,"Boston, MA",Massachusetts,"Detroit, MI",Michigan,1785,1394,-20,-20,1765,1374,26,4,1791,1370,2168,274,294,304,0,,0,0.0,0.0,0.0,0.0,0.0
2024,8,12,1,2024-08-12,G4,874,BWI,SEA,"Baltimore, MD",Maryland,"Seattle, WA",Washington,619,990,-25,-15,594,975,16,16,610,959,2749,340,360,372,0,,0,0.0,0.0,0.0,0.0,0.0
2024,7,20,6,2024-07-20,MQ,5356,ORD,MIA,"Chicago, IL",Illinois,"Miami, FL",Florida,547,1714,-12,-10,535,1704,17,8,552,1696,1428,170,190,195,0,,0,0.0,0.0,0.0,0.0,0.0
2024,8,13,2,2024-08-13,AA,5591,PDX,MDW,"Portland, OR",Oregon,"Chicago, IL",Illinois,1592,973,-11,-5,1581,968,16,7,1597,961,1875,227,247,250,0,,0,0.0,0.0,0.0,0.0,0.0
2024,8,23,5,2024-08-23,AA,4130,BWI,MIA,"Baltimore, MD",Maryland,"Miami, FL",Florida,1785,803,9,0,1794,803,9,7,1803,796,2607,334,354,350,0,,0,0.0,0.0,0.0,0.0,0.0
2024,7,1,1,2024-07-01,WN,5256,JFK,ORD,"New York, NY",New York,"Chicago, IL",Illinois,1241,1208,5,5,1246,1213,5,14,1251,1199,2032,256,276,275,0,,0,0.0,0.0,0.0,0.0,0.0
2024,7,18,4,2024-07-18,OH,5873,MDW,MSP,"Chicago, IL",Illinois,"Minneapolis, MN",Minnesota,2287,1232,1,10,2288,1242,21,10,2309,1232,2915,359,379,390,0,,0,0.0,0.0,0.0,0.0,0.0
2024,12,22,7,2024-12-22,UA,7275,TPA,DCA,"Tampa, FL",Florida,"Washington, DC",District of Columbia,1968,1740,4,5,1972,1745,9,9,1981,1736,2166,263,283,281,0,,0,0.0,0.0,0.0,0.0,0.0
2024,9,2,1,2024-09-02,NK,3618,HNL,LGA,"Honolulu, HI",Hawaii,"New York, NY",New York,2002,665,-6,0,1996,665,25,18,2021,647,1663,207,227,250,0,,0,0.0,0.0,0.0,0.0,0.0
2024,12,18,3,2024-12-18,OO,6875,IAD,SEA,"Washington, DC",District of Columbia,"Seattle, WA",Washington,1754,730,-4,-10,1750,720,12,18,1762,702,946,126,146,156,0,,0,0.0,0.0,0.0,0.0,0.0
2024,4,20,6,2024-04-20,UA,7706,MCO,DEN,"Orlando, FL",Florida,"Denver, CO",Colorado,723,1378,-4,-5,719,1373,6,12,725,1361,941,125,145,143,0,,0,0.0,0.0,0.0,0.0,0.0
2024,1,6,6,2024-01-06,AA,5478,BWI,DTW,"Baltimore, MD",Maryland,"Detroit, MI",Michigan,956,1500,-18,-10,938,1490,27,11,965,1479,1238,160,180,198,0,,0,0.0,0.0,0.0,0.0,0.0
2024,8,23,5,2024-08-23,YX,6773,ATL,EWR,"Atlanta, GA",Georgia,"Newark, NJ",New Jersey,1218,1427,-4,0,1214,1427,9,8,1223,1419,341,35,55,52,0,,0,0.0,0.0,0.0,0.0,0.0
2024,5,6,1,2024-05-06,HA,6544,DFW,DTW,"Dallas/Fort Worth, TX",Texas,"Detroit, MI",Michigan,1352,2009,10,10,1362,2019,18,5,1380,2014,2903,370,390,393,0,,0,0.0,0.0,0.0,0.0,0.0
2024,4,13,6,2024-04-13,OO,8776,DCA,DFW,"Washington, DC",District of Columbia,"Dallas/Fort Worth, TX",Texas,1889,691,0,0,1889,691,6,16,1895,675,674,91,111,113,0,,0,0.0,0.0,0.0,0.0,0.0
2024,8,24,6,2024-08-24,9E,9479,DTW,ORD,"Detroit, MI",Michigan,"Chicago, IL",Illinois,1448,1700,-19,-20,1429,1680,25,7,1454,1673,2239,278,298,310,0,,0,0.0,0.0,0.0,0.0,0.0
2024,6,3,1,2024-06-03,DL,3827,MIA,TPA,"Miami, FL",Florida,"Tampa, FL",Florida,527,1875,9,15,536,1890,16,16,552,1874,483,58,78,90,0,,0,0.0,0.0,0.0,0.0,0.0
2024,9,13,5,2024-09-13,9E,4096,IAD,LAS,"Washington, DC",District of Columbia,"Las Vegas, NV",Nevada,1376,1338,-11,-10,1365,1328,29,5,1394,1323,2965,364,384,398,0,,0,0.0,0.0,0.0,0.0,0.0
2024,8,22,4,2024-08-22,MQ,6481,MDW,PHX,"Chicago, IL",Illinois,"Phoenix, AZ",Arizona,2254,1943,16,15,2270,1958,18,9,2288,1949,1617,205,225,232,0,,0,0.0,0.0,0.0,0.0,0.0
2024,10,15,2,2024-10-15,WN,6912,IAH,ATL,"Houston, TX",Texas,"Atlanta, GA",Georgia,1400,1252,13,10,1413,1262,9,4,1422,1258,1910,237,257,250,0,,0,0.0,0.0,0.0,0.0,0.0
2024,2,9,5,2024-02-09,AA,2089,PHL,BOS,"Philadelphia, PA",Pennsylvania,"Boston, MA",Massachusetts,1348,653,-15,-5,1333,648,25,8,1358,640,2429,296,316,329,0,,0,0.0,0.0,0.0,0.0,0.0
2024,10,14,1,2024-10-14,AA,4445,SEA,PDX,"Seattle, WA",Washington,"Portland, OR",Oregon,600,2275,-12,-15,588,2260,22,12,610,2248,1616,211,231,245,0,,0,0.0,0.0,0.0,0.0,0.0
2024,7,15,1,2024-07-15,YX,8274,MIA,EWR,"Miami, FL",Florida,"Newark, NJ",New Jersey,557,1257,11,15,568,1272,29,15,597,1257,2467,301,321,345,0,,0,0.0,0.0,0.0,0.0,0.0
2024,9,29,7,2024-09-29,OH,2814,HNL,EWR,"Honolulu, HI",Hawaii,"Newark, NJ",New Jersey,1547,1768,4,5,1551,1773,22,13,1573,1760,581,78,98,113,0,,0,0.0,0.0,0.0,0.0,0.0
2024,9,20,5,2024-09-20,F9,7146,PDX,IAH,"Portland, OR",Oregon,"Houston, TX",Texas,914,1278,-9,-10,905,1268,20,11,925,1257,1671,209,229,240,0,,0,0.0,0.0,0.0,0.0,0.0
2024,2,26,1,2024-02-26,NK,4286,EWR,MCO,"Newark, NJ",New Jersey,"Orlando, FL",Florida,1750,1709,-5,0,1745,1709,9,19,1754,1690,2836,354,374,382,0,,0,0.0,0.0,0.0,0.0,0.0
2024,10,24,4,2024-10-24,OH,438,BOS,ATL,"Boston, MA",Massachusetts,"Atlanta, GA",Georgia,1692,1764,5,0,1697,1764,6,13,1703,1751,2175,274,294,293,0,,0,0.0,0.0,0.0,0.0,0.0
2024,4,7,7,2024-04-07,F9,9953,MDW,LAX,"Chicago, IL",Illinois,"Los Angeles, CA",California,2012,644,-11,-10,2001,634,22,15,2023,619,378,45,65,82,0,,0,0.0,0.0,0.0,0.0,0.0
2024,5,16,4,2024-05-16,MQ,6068,BWI,LAS,"Baltimore, MD",Maryland,"Las Vegas, NV",Nevada,1769,2263,-6,-15,1763,2248,26,5,1789,2243,1006,119,139,150,0,,0,0.0,0.0,0.0,0.0,0.0
2024,3,27,3,2024-03-27,WN,7784,MDW,JFK,"Chicago, IL",Illinois,"New York, NY",New York,2247,716,-9,-10,2238,706,7,12,2245,694,2043,264,284,283,0,,0,0.0,0.0,0.0,0.0,0.0
2024,8,29,4,2024-08-29,AS,6821,DTW,DCA,"Detroit, MI",Michigan,"Washington, DC",District of Columbia,862,746,-21,-20,841,726,13,3,854,723,2566,318,338,334,0,,0,0.0,0.0,0.0,0.0,0.0
2024,7,17,3,2024-07-17,HA,8461,SEA,IAH,"Seattle, WA",Washington,"Houston, TX",Texas,1988,1258,-16,-15,1972,1243,10,7,1982,1236,2564,327,347,344,0,,0,0.0,0.0,0.0,0.0,0.0
2024,11,5,2,2024-11-05,MQ,6605,TPA,IAD,"Tampa, FL",Florida,"Washington, DC",District of Columbia,1953,1644,-10,-10,1943,1634,22,14,1965,1620,522,66,86,102,0,,0,0.0,0.0,0.0,0.0,0.0
2024,3,24,7,2024-03-24,UA,6487,LGA,TPA,"New York, NY",New York,"Tampa, FL",Florida,920,1135,-12,-10,908,1125,5,9,913,1116,2275,281,301,295,0,,0,0.0,0.0,0.0,0.0,0.0
2024,8,29,4,2024-08-29,OO,8110,BWI,CLT,"Baltimore, MD",Maryland,"Charlotte, NC",North Carolina,520,1781,-12,-10,508,1771,22,14,530,1757,213,19,39,55,0,,0,0.0,0.0,0.0,0.0,0.0
2024,10,7,1,2024-10-07,MQ,6576,MIA,HNL,"Miami, FL",Florida,"Honolulu, HI",Hawaii,1135,2099,16,15,1151,2114,26,9,1177,2105,445,57,77,92,0,,0,0.0,0.0,0.0,0.0,0.0
2024,11,18,1,2024-11-18,F9,3112,CLT,IAH,"Charlotte, NC",North Carolina,"Houston, TX",Texas,1892,1671,-9,0,1883,1671,6,14,1889,1657,1900,230,250,250,0,,0,0.0,0.0,0.0,0.0,0.0
2024,9,8,7,2024-09-08,WN,7584,DTW,SEA,"Detroit, MI",Michigan,"Seattle, WA",Washington,963,1018,-2,-5,961,1013,27,6,988,1007,1847,220,240,253,0,,0,0.0,0.0,0.0,0.0,0.0
2024,7,8,1,2024-07-08,UA,2710,PDX,MSP,"Portland, OR",Oregon,"Minneapolis, MN",Minnesota,596,1733,-2,0,594,1733,27,19,621,1714,891,114,134,160,0,,0,0.0,0.0,0.0,0.0,0.0
2024,5,31,5,2024-05-31,WN,2573,SLC,SEA,"Salt Lake City, UT",Utah,"Seattle, WA",Washington,2173,1612,-13,-20,2160,1592,21,18,2181,1574,1757,224,244,263,0,,0,0.0,0.0,0.0,0.0,0.0
2024,10,28,1,2024-10-28,AS,5355,EWR,DCA,"Newark, NJ",New Jersey,"Washington, DC",District of Columbia,2015,1170,12,10,2027,1180,16,4,2043,1176,2470,299,319,319,0,,0,0.0,0.0,0.0,0.0,0.0
2024,10,4,5,2024-10-04,OO,2788,MSP,DCA,"Minneapolis, MN",Minnesota,"Washington, DC",District of Columbia,1876,1597,5,0,1881,1597,26,19,1907,1578,1974,240,260,285,0,,0,0.0,0.0,0.0,0.0,0.0
2024,5,18,6,2024-05-18,NK,4904,BWI,PDX,"Baltimore, MD",Maryland,"Portland, OR",Oregon,2128,2152,2,0,2130,2152,25,12,2155,2140,915,122,142,159,0,,0,0.0,0.0,0.0,0.0,0.0
2024,6,24,1,2024-06-24,NK,1390,BWI,DFW,"Baltimore, MD",Maryland,"Dallas/Fort Worth, TX",Texas,1618,1927,12,15,1630,1942,28,18,1658,1924,1183,154,174,200,0,,0,0.0,0.0,0.0,0.0,0.0
2024,1,8,1,2024-01-08,OH,8398,DTW,LGA,"Detroit, MI",Michigan,"New York, NY",New York,523,1081,6,5,529,1086,28,9,557,1077,1277,158,178,195,0,,0,0.0,0.0,0.0,0.0,0.0
2024,10,21,1,2024-10-21,HA,2707,LAX,PHX,"Los Angeles, CA",California,"Phoenix, AZ",Arizona,879,2190,3,-5,882,2185,29,16,911,2169,311,44,64,89,0,,0,0.0,0.0,0.0,0.0,0.0
2024,8,22,4,2024-08-22,YX,8178,MCO,BOS,"Orlando, FL",Florida,"Boston, MA",Massachusetts,895,1760,14,15,909,1775,6,17,915,1758,674,90,110,113,0,,0,0.0,0.0,0.0,0.0,0.0
2024,6,11,2,2024-06-11,WN,1788,SLC,SAN,"Salt Lake City, UT",Utah,"San Diego, CA",California,1927,1700,1,10,1928,1710,5,12,1933,1698,1308,160,180,177,0,,0,0.0,0.0,0.0,0.0,0.0
2024,2,18,7,2024-02-18,F9,6611,IAD,BWI,"Washington, DC",District of Columbia,"Baltimore, MD",Maryland,2171,869,24,20,2195,889,14,10,2209,879,1983,256,276,280,0,,0,7.0,5.0,1.0,0.0,7.0
2024,10,28,1,2024-10-28,NK,8297,TPA,PHL,"Tampa, FL",Florida,"Philadelphia, PA",Pennsylvania,1656,1521,-9,-15,1647,1506,26,4,1673,1502,326,43,63,73,0,,0,0.0,0.0,0.0,0.0,0.0
2024,2,7,3,2024-02-07,DL,8814,DEN,DTW,"Denver, CO",Colorado,"Detroit, MI",Michigan,553,1291,15,20,568,1311,6,19,574,1292,393,47,67,72,0,,0,5.0,2.0,1.0,0.0,12.0
2024,5,15,3,2024-05-15,MQ,6772,MCO,DCA,"Orlando, FL",Florida,"Washington, DC",District of Columbia,1815,1708,-8,0,1807,1708,9,11,1816,1697,2204,281,301,301,0,,0,0.0,0.0,0.0,0.0,0.0
2024,11,5,2,2024-11-05,F9,3443,MSP,PDX,"Minneapolis, MN",Minnesota,"Portland, OR",Oregon,1513,1411,5,5,1518,1416,21,11,1539,1405,846,108,128,140,0,,0,0.0,0.0,0.0,0.0,0.0
2024,8,6,2,2024-08-06,G4,165,LAS,PHX,"Las Vegas, NV",Nevada,"Phoenix, AZ",Arizona,1635,2091,-16,-10,1619,2081,5,17,1624,2064,2348,286,306,308,0,,0,0.0,0.0,0.0,0.0,0.0
2024,12,13,5,2024-12-13,B6,3510,SFO,DTW,"San Francisco, CA",California,"Detroit, MI",Michigan,921,2274,-13,-15,908,2259,18,15,926,2244,1294,161,181,194,0,,0,0.0,0.0,0.0,0.0,0.0
2024,10,22,2,2024-10-22,HA,3081,SFO,PHL,"San Francisco, CA",California,"Philadelphia, PA",Pennsylvania,630,2305,-10,-15,620,2290,25,11,645,2279,1289,157,177,193,0,,0,0.0,0.0,0.0,0.0,0.0
2024,2,3,6,2024-02-03,WN,5688,LAS,BOS,"Las Vegas, NV",Nevada,"Boston, MA",Massachusetts,919,841,-6,-5,913,836,10,6,923,830,2451,309,329,325,0,,0,0.0,0.0,0.0,0.0,0.0
2024,12,17,2,2024-12-17,WN,2915,IAD,BWI,"Washington, DC",District of Columbia,"Baltimore, MD",Maryland,1801,1530,-8,-10,1793,1520,15,11,1808,1509,1096,146,166,172,0,,0,0.0,0.0,0.0,0.0,0.0
2024,3,19,2,2024-03-19,MQ,5196,MSP,MDW,"Minneapolis, MN",Minnesota,"Chicago, IL",Illinois,1275,1687,-15,-15,1260,1672,11,11,1271,1661,2378,300,320,322,0,,0,0.0,0.0,0.0,0.0,0.0
2024,8,23,5,2024-08-23,WN,2117,JFK,LAX,"New York, NY",New York,"Los Angeles, CA",California,2113,1863,25,20,2138,1883,24,17,2162,1866,1224,159,179,200,0,,0,4.0,5.0,3.0,0.0,8.0
2024,9,29,7,2024-09-29,AS,6773,PDX,SFO,"Portland, OR",Oregon,"San Francisco, CA",California,1274,1718,0,5,1274,1723,24,13,1298,1710,2282,289,309,326,0,,0,0.0,0.0,0.0,0.0,0.0
2024,6,9,7,2024-06-09,OO,1842,PHX,SEA,"Phoenix, AZ",Arizona,"Seattle, WA",Washington,1591,2281,-10,0,1581,2281,25,15,1606,2266,983,131,151,171,0,,0,0.0,0.0,0.0,0.0,0.0
2024,6,23,7,2024-06-23,WN,5820,LAS,SLC,"Las Vegas, NV",Nevada,"Salt Lake City, UT",Utah,2097,997,2,5,2099,1002,26,19,2125,983,698,90,110,135,0,,0,0.0,0.0,0.0,0.0,0.0
2024,11,3,7,2024-11-03,NK,3609,LGA,MCO,"New York, NY",New York,"Orlando, FL",Florida,1926,1487,9,0,1935,1487,28,3,1963,1484,1884,232,252,263,0,,0,0.0,0.0,0.0,0.0,0.0
2024,8,8,4,2024-08-08,NK,6486,IAH,PHL,"Houston, TX",Texas,"Philadelphia, PA",Pennsylvania,1374,648,-4,-10,1370,638,13,5,1383,633,1210,142,162,160,0,,0,0.0,0.0,0.0,0.0,0.0
2024,1,9,2,2024-01-09,B6,3634,ATL,IAH,"Atlanta, GA",Georgia,"Houston, TX",Texas,674,2076,-1,0,673,2076,27,5,700,2071,2559,317,337,349,0,,0,0.0,0.0,0.0,0.0,0.0
2024,10,15,2,2024-10-15,MQ,5236,DTW,LAX,"Detroit, MI",Michigan,"Los Angeles, CA",California,1803,744,-4,5,1799,749,7,17,1806,732,2241,283,303,307,0,,0,0.0,0.0,0.0,0.0,0.0
2024,4,22,1,2024-04-22,B6,5685,SAN,HNL,"San Diego, CA",California,"Honolulu, HI",Hawaii,963,1516,-2,-10,961,1506,10,7,971,1499,1510,190,210,207,0,,0,0.0,0.0,0.0,0.0,0.0
2024,7,23,2,2024-07-23,HA,8654,LGA,BOS,"New York, NY",New York,"Boston, MA",Massachusetts,889,997,-10,-5,879,992,13,6,892,986,1313,159,179,178,0,,0,0.0,0.0,0.0,0.0,0.0
2024,7,4,4,2024-07-04,9E,7258,SLC,SAN,"Salt Lake City, UT",Utah,"San Diego, CA",California,1247,1370,-14,-5,1233,1365,10,3,1243,1362,1480,177,197,190,0,,0,0.0,0.0,0.0,0.0,0.0
2024,12,6,5,2024-12-06,F9,1734,LAS,SFO,"Las Vegas, NV",Nevada,"San Francisco, CA",California,635,1270,7,0,642,1270,14,6,656,1264,596,67,87,87,0,,0,0.0,0.0,0.0,0.0,0.0
2024,7,15,1,2024-07-15,NK,624,JFK,SEA,"New York, NY",New York,"Seattle, WA",Washington,908,2352,-12,-15,896,2337,28,10,924,2327,1767,216,236,254,0,,0,0.0,0.0,0.0,0.0,0.0
2024,9,22,7,2024-09-22,OH,5026,HNL,IAD,"Honolulu, HI",Hawaii,"Washington, DC",District of Columbia,723,1926,0,5,723,1931,12,9,735,1922,2843,350,370,371,0,,0,0.0,0.0,0.0,0.0,0.0
2024,9,18,3,2024-09-18,NK,1822,PHX,MSP,"Phoenix, AZ",Arizona,"Minneapolis, MN",Minnesota,1100,1027,-4,-5,1096,1022,24,3,1120,1019,1614,195,215,222,0,,0,0.0,0.0,0.0,0.0,0.0
2024,9,4,3,2024-09-04,AS,8711,PDX,IAD,"Portland, OR",Oregon,"Washington, DC",District of Columbia,1469,1640,14,5,1483,1645,20,7,1503,1638,2627,328,348,355,0,,0,0.0,0.0,0.0,0.0,0.0
2024,4,24,3,2024-04-24,NK,7029,PHL,TPA,"Philadelphia, PA",Pennsylvania,"Tampa, FL",Florida,1118,680,12,15,1130,695,11,15,1141,680,1511,184,204,210,0,,0,0.0,0.0,0.0,0.0,0.0
2024,4,30,2,2024-04-30,NK,6257,PHX,TPA,"Phoenix, AZ",Arizona,"Tampa, FL",Florida,2076,783,2,10,2078,793,27,14,2105,779,693,88,108,129,0,,0,0.0,0.0,0.0,0.0,0.0
2024,5,20,1,2024-05-20,9E,3964,ATL,BWI,"Atlanta, GA",Georgia,"Baltimore, MD",Maryland,2221,1066,-1,5,2220,1071,27,10,2247,1061,217,21,41,58,0,,0,0.0,0.0,0.0,0.0,0.0
2024,3,5,2,2024-03-05,OH,1167,HNL,MDW,"Honolulu, HI",Hawaii,"Chicago, IL",Illinois,1711,882,-4,-10,1707,872,28,19,1735,853,2421,307,327,354,0,,0,0.0,0.0,0.0,0.0,0.0
2024,10,2,3,2024-10-02,DL,9692,CLT,MDW,"Charlotte, NC",North Carolina,"Chicago, IL",Illinois,1377,1694,14,5,1391,1699,22,4,1413,1695,719,93,113,119,0,,0,0.0,0.0,0.0,0.0,0.0
2024,11,8,5,2024-11-08,OH,6538,DCA,LGA,"Washington, DC",District of Columbia,"New York, NY",New York,1910,689,-6,0,1904,689,22,11,1926,678,2468,305,325,338,0,,0,0.0,0.0,0.0,0.0,0.0
2024,8,26,1,2024-08-26,9E,1519,IAH,MIA,"Houston, TX",Texas,"Miami, FL",Florida,508,1308,8,5,516,1313,19,11,535,1302,2529,309,329,339,0,,0,0.0,0.0,0.0,0.0,0.0
2024,10,28,1,2024-10-28,DL,7371,HNL,DTW,"Honolulu, HI",Hawaii,"Detroit, MI",Michigan,1703,1241,19,10,1722,1251,26,15,1748,1236,1013,128,148,169,0,,0,0.0,0.0,0.0,0.0,0.0
2024,1,10,3,2024-01-10,OH,4102,LAS,DTW,"Las Vegas, NV",Nevada,"Detroit, MI",Michigan,2221,2215,-2,-5,2219,2210,10,19,2229,2191,1865,240,260,269,0,,0,0.0,0.0,0.0,0.0,0.0
2024,8,20,2,2024-08-20,9E,729,MCO,LAX,"Orlando, FL",Florida,"Los Angeles, CA",California,1967,1988,-2,0,1965,1988,9,9,1974,1979,2226,282,302,300,0,,0,0.0,0.0,0.0,0.0,0.0
2024,7,13,6,2024-07-13,NK,1934,ATL,HNL,"Atlanta, GA",Georgia,"Honolulu, HI",Hawaii,1093,802,-13,-10,1080,792,22,9,1102,783,641,71,91,102,0,,0,0.0,0.0,0.0,0.0,0.0
2024,1,12,5,2024-01-12,OH,5418,SAN,DEN,"San Diego, CA",California,"Denver, CO",Colorado,2212,1854,-5,-5,2207,1849,12,4,2219,1845,543,61,81,77,0,,0,0.0,0.0,0.0,0.0,0.0
2024,6,25,2,2024-06-25,9E,5100,MDW,IAD,"Chicago, IL",Illinois,"Washington, DC",District of Columbia,1105,1198,7,0,1112,1198,7,18,1119,1180,1501,179,199,204,0,,0,0.0,0.0,0.0,0.0,0.0
2024,6,25,2,2024-06-25,NK,4231,MIA,DCA,"Miami, FL",Florida,"Washington, DC",District of Columbia,1969,605,-7,-5,1962,600,20,4,1982,596,809,109,129,133,0,,0,0.0,0.0,0.0,0.0,0.0
2024,8,4,7,2024-08-04,NK,6829,TPA,CLT,"Tampa, FL",Florida,"Charlotte, NC",North Carolina,615,956,-9,0,606,956,21,17,627,939,2727,334,354,372,0,,0,0.0,0.0,0.0,0.0,0.0
2024,1,11,4,2024-01-11,B6,2453,STL,PHL,"St. Louis, MO",Missouri,"Philadelphia, PA",Pennsylvania,2195,2072,-4,5,2191,2077,21,18,2212,2059,2346,288,308,327,0,,0,0.0,0.0,0.0,0.0,0.0
2024,4,27,6,2024-04-27,AA,3155,DFW,SAN,"Dallas/Fort Worth, TX",Texas,"San Diego, CA",California,744,1769,-5,0,739,1769,16,18,755,1751,2656,340,360,374,0,,0,0.0,0.0,0.0,0.0,0.0
2024,6,12,3,2024-06-12,OH,8303,JFK,PHX,"New York, NY",New York,"Phoenix, AZ",Arizona,1806,654,15,20,1821,674,27,8,1848,666,910,110,130,145,0,,0,5.0,2.0,0.0,0.0,13.0
2024,2,8,4,2024-02-08,DL,9723,PHX,HNL,"Phoenix, AZ",Arizona,"Honolulu, HI",Hawaii,1736,1690,5,5,1741,1695,11,13,1752,1682,2837,351,371,375,0,,0,0.0,0.0,0.0,0.0,0.0
2024,2,22,4,2024-02-22,MQ,3257,MIA,SEA,"Miami, FL",Florida,"Seattle, WA",Washington,2187,2320,29,30,2216,2350,26,11,2242,2339,356,37,57,74,0,,0,6.0,0.0,4.0,0.0,20.0
2024,8,5,1,2024-08-05,G4,6182,LAX,SEA,"Los Angeles, CA",California,"Seattle, WA",Washington,2201,746,7,5,2208,751,26,8,2234,743,2220,286,306,320,0,,0,0.0,0.0,0.0,0.0,0.0
2024,7,24,3,2024-07-24,F9,5963,BWI,PDX,"Baltimore, MD",Maryland,"Portland, OR",Oregon,950,1185,8,0,958,1185,25,6,983,1179,1196,142,162,173,0,,0,0.0,0.0,0.0,0.0,0.0
2024,11,7,4,2024-11-07,F9,9726,DEN,DTW,"Denver, CO",Colorado,"Detroit, MI",Michigan,2178,1579,-14,-5,2164,1574,10,4,2174,1570,2766,340,360,354,0,,0,0.0,0.0,0.0,0.0,0.0
2024,12,25,3,2024-12-25,9E,1056,IAH,BOS,"Houston, TX",Texas,"Boston, MA",Massachusetts,1548,2274,14,5,1562,2279,6,15,1568,2264,1192,157,177,178,0,,0,0.0,0.0,0.0,0.0,0.0
2024,2,25,7,2024-02-25,AA,3958,CLT,PDX,"Charlotte, NC",North Carolina,"Portland, OR",Oregon,2235,1335,8,5,2243,1340,9,3,2252,1337,583,67,87,79,0,,0,0.0,0.0,0.0,0.0,0.0
2024,4,27,6,2024-04-27,AS,4908,STL,LGA,"St. Louis, MO",Missouri,"New York, NY",New York,732,1855,-5,5,727,1860,6,11,733,1849,1504,182,202,199,0,,0,0.0,0.0,0.0,0.0,0.0
2024,9,9,1,2024-09-09,HA,6238,DFW,DCA,"Dallas/Fort Worth, TX",Texas,"Washington, DC",District of Columbia,2039,2091,6,5,2045,2096,7,16,2052,2080,2767,338,358,361,0,,0,0.0,0.0,0.0,0.0,0.0
2024,10,12,6,2024-10-12,HA,8532,EWR,STL,"Newark, NJ",New Jersey,"St. Louis, MO",Missouri,1811,1294,17,10,1828,1304,9,6,1837,1298,1171,149,169,164,0,,0,0.0,0.0,0.0,0.0,0.0
2024,9,24,2,2024-09-24,G4,7984,DTW,PDX,"Detroit, MI",Michigan,"Portland, OR",Oregon,1184,1719,-5,-10,1179,1709,21,6,1200,1703,2534,325,345,352,0,,0,0.0,0.0,0.0,0.0,0.0
2024,10,17,4,2024-10-17,HA,7141,LAX,STL,"Los Angeles, CA",California,"St. Louis, MO",Missouri,683,2114,-6,0,677,2114,23,17,700,2097,655,89,109,129,0,,0,0.0,0.0,0.0,0.0,0.0
2024,11,28,4,2024-11-28,F9,2055,IAH,DEN,"Houston, TX",Texas,"Denver, CO",Colorado,750,1453,8,0,758,1453,14,17,772,1436,999,127,147,158,0,,0,0.0,0.0,0.0,0.0,0.0
2024,6,28,5,2024-06-28,UA,5091,LGA,LAX,"New York, NY",New York,"Los Angeles, CA",California,790,847,-7,-10,783,837,16,15,799,822,2382,304,324,335,0,,0,0.0,0.0,0.0,0.0,0.0
2024,12,23,1,2024-12-23,WN,4165,JFK,DCA,"New York, NY",New York,"Washington, DC",District of Columbia,1448,731,30,30,1478,761,26,16,1504,745,341,37,57,79,0,,0,6.0,3.0,2.0,0.0,19.0
2024,8,22,4,2024-08-22,HA,2903,ATL,SAN,"Atlanta, GA",Georgia,"San Diego, CA",California,1297,2148,11,5,1308,2153,22,3,1330,2150,1641,208,228,233,0,,0,0.0,0.0,0.0,0.0,0.0
2024,12,8,7,2024-12-08,UA,1124,STL,LGA,"St. Louis, MO",Missouri,"New York, NY",New York,1882,1693,-1,-5,1881,1688,23,3,1904,1685,1420,167,187,193,0,,0,0.0,0.0,0.0,0.0,0.0
2024,7,14,7,2024-07-14,AS,8892,DEN,JFK,"Denver, CO",Colorado,"New York, NY",New York,1123,948,0,-5,1123,943,17,3,1140,940,1747,213,233,233,0,,0,0.0,0.0,0.0,0.0,0.0
2024,11,3,7,2024-11-03,OH,2429,TPA,JFK,"Tampa, FL",Florida,"New York, NY",New York,804,1041,8,5,812,1046,29,17,841,1029,2284,279,299,325,0,,0,0.0,0.0,0.0,0.0,0.0
2024,3,20,3,2024-03-20,G4,2798,JFK,IAH,"New York, NY",New York,"Houston, TX",Texas,849,855,-14,-20,835,835,12,3,847,832,482,51,71,66,0,,0,0.0,0.0,0.0,0.0,0.0
2024,5,14,2,2024-05-14,HA,4794,SFO,DEN,"San Francisco, CA",California,"Denver, CO",Colorado,1862,2009,-7,0,1855,2009,7,8,1862,2001,284,35,55,50,0,,0,0.0,0.0,0.0,0.0,0.0
2024,1,22,1,2024-01-22,F9,3126,IAD,DCA,"Washington, DC",District of Columbia,"Washington, DC",District of Columbia,978,1104,-2,-5,976,1099,27,9,1003,1090,2624,322,342,358,0,,0,0.0,0.0,0.0,0.0,0.0
2024,11,26,2,2024-11-26,HA,7947,MIA,LGA,"Miami, FL",Florida,"New York, NY",New York,1988,2323,3,10,1991,2333,16,4,2007,2329,788,103,123,123,0,,0,0.0,0.0,0.0,0.0,0.0
2024,8,12,1,2024-08-12,HA,9434,STL,PDX,"St. Louis, MO",Missouri,"Portland, OR",Oregon,1515,2224,-3,5,1512,2229,8,11,1520,2218,2848,357,377,376,0,,0,0.0,0.0,0.0,0.0,0.0
2024,2,27,2,2024-02-27,MQ,1111,SAN,MIA,"San Diego, CA",California,"Miami, FL",Florida,629,1015,-12,-5,617,1010,18,6,635,1004,2793,350,370,374,0,,0,0.0,0.0,0.0,0.0,0.0
2024,4,2,2,2024-04-02,9E,7143,PDX,SAN,"Portland, OR",Oregon,"San Diego, CA",California,686,918,5,10,691,928,11,17,702,911,1009,132,152,160,0,,0,0.0,0.0,0.0,0.0,0.0
2024,7,10,3,2024-07-10,WN,5724,MCO,BOS,"Orlando, FL",Florida,"Boston, MA",Massachusetts,1944,915,8,15,1952,930,25,10,1977,920,2055,250,270,285,0,,0,0.0,0.0,0.0,0.0,0.0
2024,4,12,5,2024-04-12,HA,9395,EWR,SFO,"Newark, NJ",New Jersey,"San Francisco, CA",California,2019,2289,-4,0,2015,2289,17,9,2032,2280,1783,212,232,238,0,,0,0.0,0.0,0.0,0.0,0.0
2024,1,7,7,2024-01-07,DL,9938,SAN,IAD,"San Diego, CA",California,"Washington, DC",District of Columbia,2064,1585,-14,-10,2050,1575,16,10,2066,1565,1240,152,172,178,0,,0,0.0,0.0,0.0,0.0,0.0
2024,5,7,2,2024-05-07,MQ,1800,DTW,TPA,"Detroit, MI",Michigan,"Tampa, FL",Florida,1169,1597,12,5,1181,1602,19,15,1200,1587,737,96,116,130,0,,0,0.0,0.0,0.0,0.0,0.0
2024,2,24,6,2024-02-24,F9,318,BOS,DTW,"Boston, MA",Massachusetts,"Detroit, MI",Michigan,734,2285,-4,-5,730,2280,6,5,736,2275,2152,269,289,280,0,,0,0.0,0.0,0.0,0.0,0.0
2024,8,18,7,2024-08-18,F9,8178,ORD,STL,"Chicago, IL",Illinois,"St. Louis, MO",Missouri,777,929,5,0,782,929,26,8,808,921,2346,293,313,327,0,,0,0.0,0.0,0.0,0.0,0.0
2024,12,27,5,2024-12-27,OH,9018,PHX,EWR,"Phoenix, AZ",Arizona,"Newark, NJ",New Jersey,1625,1755,-25,-20,1600,1735,5,9,1605,1726,1363,165,185,179,0,,0,0.0,0.0,0.0,0.0,0.0
2024,3,2,6,2024-03-02,YX,7252,STL,MCO,"St. Louis, MO",Missouri,"Orlando, FL",Florida,1982,1767,-6,0,1976,1767,10,7,1986,1760,707,93,113,110,0,,0,0.0,0.0,0.0,0.0,0.0
2024,8,27,2,2024-08-27,OO,5926,SAN,LAS,"San Diego, CA",California,"Las Vegas, NV",Nevada,2260,1870,-6,-5,2254,1865,5,17,2259,1848,2269,290,310,312,0,,0,0.0,0.0,0.0,0.0,0.0
2024,3,30,6,2024-03-30,AS,5685,PDX,CLT,"Portland, OR",Oregon,"Charlotte, NC",North Carolina,1286,1686,11,5,1297,1691,23,4,1320,1687,2193,281,301,308,0,,0,0.0,0.0,0.0,0.0,0.0
2024,8,19,1,2024-08-19,OH,8158,LAS,HNL,"Las Vegas, NV",Nevada,"Honolulu, HI",Hawaii,1334,2305,-28,-20,1306,2285,14,12,1320,2273,2475,313,333,339,0,,0,0.0,0.0,0.0,0.0,0.0
2024,8,20,2,2024-08-20,F9,911,ORD,PDX,"Chicago, IL",Illinois,"Portland, OR",Oregon,1755,2126,-2,0,1753,2126,27,6,1780,2120,2089,251,271,284,0,,0,0.0,0.0,0.0,0.0,0.0
2024,12,19,4,2024-12-19,G4,5556,IAD,DTW,"Washington, DC",District of Columbia,"Detroit, MI",Michigan,773,1859,4,5,777,1864,18,14,795,1850,1140,141,161,173,0,,0,0.0,0.0,0.0,0.0,0.0
2024,11,28,4,2024-11-28,MQ,7777,EWR,LGA,"Newark, NJ",New Jersey,"New York, NY",New York,864,2020,-21,-20,843,2000,6,17,849,1983,2638,321,341,344,0,,0,0.0,0.0,0.0,0.0,0.0
2024,10,18,5,2024-10-18,AA,5009,CLT,SAN,"Charlotte, NC",North Carolina,"San Diego, CA",California,2001,1400,0,5,2001,1405,13,13,2014,1392,2498,303,323,329,0,,0,0.0,0.0,0.0,0.0,0.0
2024,12,10,2,2024-12-10,G4,4809,MSP,TPA,"Minneapolis, MN",Minnesota,"Tampa, FL",Florida,967,722,-22,-15,945,707,7,16,952,691,902,112,132,135,0,,0,0.0,0.0,0.0,0.0,0.0
2024,5,31,5,2024-05-31,DL,4621,MCO,LAS,"Orlando, FL",Florida,"Las Vegas, NV",Nevada,2148,869,5,5,2153,874,23,9,2176,865,1763,227,247,259,0,,0,0.0,0.0,0.0,0.0,0.0
2024,5,24,5,2024-05-24,OH,9875,IAH,PDX,"Houston, TX",Texas,"Portland, OR",Oregon,1150,607,9,0,1159,607,18,16,1177,591,2713,329,349,363,0,,0,0.0,0.0,0.0,0.0,0.0
2024,5,9,4,2024-05-09,MQ,4137,MDW,DFW,"Chicago, IL",Illinois,"Dallas/Fort Worth, TX",Texas,2251,1329,-2,0,2249,1329,20,10,2269,1319,1829,237,257,267,0,,0,0.0,0.0,0.0,0.0,0.0
2024,5,20,1,2024-05-20,AA,9174,BOS,MSP,"Boston, MA",Massachusetts,"Minneapolis, MN",Minnesota,1325,941,-4,-5,1321,936,11,16,1332,920,2180,268,288,295,0,,0,0.0,0.0,0.0,0.0,0.0
2024,4,2,2,2024-04-02,F9,8111,SLC,MSP,"Salt Lake City, UT",Utah,"Minneapolis, MN",Minnesota,1797,1285,-11,-10,1786,1275,5,8,1791,1267,2553,323,343,336,0,,0,0.0,0.0,0.0,0.0,0.0
2024,4,23,2,2024-04-23,F9,531,TPA,PHL,"Tampa, FL",Florida,"Philadelphia, PA",Pennsylvania,1851,2261,-20,-15,1831,2246,9,16,1840,2230,564,76,96,101,0,,0,0.0,0.0,0.0,0.0,0.0
2024,10,10,4,2024-10-10,OO,8275,LAS,JFK,"Las Vegas, NV",Nevada,"New York, NY",New York,1360,1938,12,10,1372,1948,7,10,1379,1938,1829,220,240,237,0,,0,0.0,0.0,0.0,0.0,0.0
2024,5,22,3,2024-05-22,WN,9239,SLC,EWR,"Salt Lake City, UT",Utah,"Newark, NJ",New Jersey,683,1427,-6,0,677,1427,21,6,698,1421,1687,215,235,242,0,,0,0.0,0.0,0.0,0.0,0.0
2024,8,10,6,2024-08-10,F9,9959,DCA,TPA,"Washington, DC",District of Columbia,"Tampa, FL",Florida,1417,2184,23,30,1440,2214,27,14,1467,2200,1489,194,214,235,0,,0,7.0,7.0,2.0,0.0,14.0
2024,8,19,1,2024-08-19,NK,6648,LGA,DFW,"New York, NY",New York,"Dallas/Fort Worth, TX",Texas,1717,935,2,10,1719,945,18,7,1737,938,992,116,136,141,0,,0,0.0,0.0,0.0,0.0,0.0
2024,2,2,5,2024-02-02,MQ,2639,DEN,PDX,"Denver, CO",Colorado,"Portland, OR",Oregon,771,1347,4,10,775,1357,20,15,795,1342,2131,267,287,302,0,,0,0.0,0.0,0.0,0.0,0.0
2024,10,2,3,2024-10-02,DL,490,MCO,PHL,"Orlando, FL",Florida,"Philadelphia, PA",Pennsylvania,1823,1460,7,0,1830,1460,11,14,1841,1446,2735,350,370,375,0,,0,0.0,0.0,0.0,0.0,0.0
2024,6,18,2,2024-06-18,B6,182,LGA,PHL,"New York, NY",New York,"Philadelphia, PA",Pennsylvania,2107,855,-23,-15,2084,840,13,8,2097,832,1296,171,191,192,0,,0,0.0,0.0,0.0,0.0,0.0
2024,5,19,7,2024-05-19,OH,1102,ORD,IAD,"Chicago, IL",Illinois,"Washington, DC",District of Columbia,695,715,9,15,704,730,11,8,715,722,1435,169,189,188,0,,0,0.0,0.0,0.0,0.0,0.0
2024,12,22,7,2024-12-22,9E,8772,PDX,LAX,"Portland, OR",Oregon,"Los Angeles, CA",California,1281,1390,-17,-15,1264,1375,19,19,1283,1356,1005,121,141,159,0,,0,0.0,0.0,0.0,0.0,0.0
2024,7,19,5,2024-07-19,WN,9068,STL,MCO,"St. Louis, MO",Missouri,"Orlando, FL",Florida,1404,2012,-5,0,1399,2012,24,18,1423,1994,2980,366,386,408,0,,0,0.0,0.0,0.0,0.0,0.0
2024,1,23,2,2024-01-23,UA,7496,TPA,DCA,"Tampa, FL",Florida,"Washington, DC",District of Columbia,830,1708,14,10,844,1718,7,14,851,1704,1388,169,189,190,0,,0,0.0,0.0,0.0,0.0,0.0
2024,8,11,7,2024-08-11,AA,9540,LAS,LGA,"Las Vegas, NV",Nevada,"New York, NY",New York,2275,2255,7,0,2282,2255,26,7,2308,2248,642,70,90,103,0,,0,0.0,0.0,0.0,0.0,0.0
2024,9,26,4,2024-09-26,B6,9428,SLC,HNL,"Salt Lake City, UT",Utah,"Honolulu, HI",Hawaii,2009,649,-13,-10,1996,639,20,16,2016,623,2104,261,281,297,0,,0,0.0,0.0,0.0,0.0,0.0
2024,12,12,4,2024-12-12,9E,3356,LGA,MIA,"New York, NY",New York,"Miami, FL",Florida,1119,1787,-4,-5,1115,1782,26,18,1141,1764,595,75,95,119,0,,0,0.0,0.0,0.0,0.0,0.0
2024,6,1,6,2024-06-01,F9,9827,PHX,SEA,"Phoenix, AZ",Arizona,"Seattle, WA",Washington,998,1771,25,30,1023,1801,22,7,1045,1794,2771,336,356,365,0,,1,4.0,2.0,3.0,0.0,21.0
2024,11,28,4,2024-11-28,YX,3344,BOS,DTW,"Boston, MA",Massachusetts,"Detroit, MI",Michigan,1923,1154,117,120,2040,1274,11,10,2051,1264,1791,227,247,248,0,,0,38.0,18.0,12.0,0.0,52.0
2024,3,25,1,2024-03-25,G4,6107,LAS,MCO,"Las Vegas, NV",Nevada,"Orlando, FL",Florida,1920,1759,9,5,1929,1764,21,9,1950,1755,1535,196,216,226,0,,0,0.0,0.0,0.0,0.0,0.0
2024,4,18,4,2024-04-18,NK,622,PHX,PDX,"Phoenix, AZ",Arizona,"Portland, OR",Oregon,1623,1841,15,10,1638,1851,29,15,1667,1836,1730,220,240,264,0,,0,0.0,0.0,0.0,0.0,0.0
2024,1,31,3,2024-01-31,YX,1794,ATL,DFW,"Atlanta, GA",Georgia,"Dallas/Fort Worth, TX",Texas,580,1105,-26,-20,554,1085,22,5,576,1080,2354,300,320,327,0,,0,0.0,0.0,0.0,0.0,0.0
2024,8,16,5,2024-08-16,OO,2352,PDX,DCA,"Portland, OR",Oregon,"Washington, DC",District of Columbia,1360,1995,-10,-10,1350,1985,7,16,1357,1969,1768,229,249,252,0,,0,0.0,0.0,0.0,0.0,0.0
2024,8,27,2,2024-08-27,AA,4937,SFO,SLC,"San Francisco, CA",California,"Salt Lake City, UT",Utah,1517,833,1,-5,1518,828,26,19,1544,809,1119,141,161,186,0,,0,0.0,0.0,0.0,0.0,0.0
2024,12,28,6,2024-12-28,AA,7426,ATL,MIA,"Atlanta, GA",Georgia,"Miami, FL",Florida,1540,1374,-18,-20,1522,1354,15,9,1537,1345,2918,365,385,389,0,,0,0.0,0.0,0.0,0.0,0.0
2024,11,5,2,2024-11-05,HA,8569,MDW,PHX,"Chicago, IL",Illinois,"Phoenix, AZ",Arizona,2228,1738,4,-5,2232,1733,27,11,2259,1722,1413,183,203,221,0,,0,0.0,0.0,0.0,0.0,0.0
2024,5,20,1,2024-05-20,AA,247,PHX,PDX,"Phoenix, AZ",Arizona,"Portland, OR",Oregon,1735,788,-10,-15,1725,773,18,12,1743,761,2213,266,286,296,0,,0,0.0,0.0,0.0,0.0,0.0
2024,6,4,2,2024-06-04,DL,8248,PDX,DEN,"Portland, OR",Oregon,"Denver, CO",Colorado,625,2040,7,0,632,2040,21,12,653,2028,1697,215,235,248,0,,0,0.0,0.0,0.0,0.0,0.0
2024,10,25,5,2024-10-25,AA,3720,JFK,SLC,"New York, NY",New York,"Salt Lake City, UT",Utah,2161,1820,-18,-20,2143,1800,23,15,2166,1785,1275,159,179,197,0,,0,0.0,0.0,0.0,0.0,0.0
2024,12,10,2,2024-12-10,WN,9231,TPA,STL,"Tampa, FL",Florida,"St. Louis, MO",Missouri,629,1149,-18,-10,611,1139,26,12,637,1127,2840,364,384,402,0,,0,0.0,0.0,0.0,0.0,0.0
2024,4,8,1,2024-04-08,9E,3809,DTW,LAX,"Detroit, MI",Michigan,"Los Angeles, CA",California,2180,1123,2,10,2182,1133,24,8,2206,1125,840,106,126,138,0,,0,0.0,0.0,0.0,0.0,0.0
2024,2,16,5,2024-02-16,G4,4437,TPA,DCA,"Tampa, FL",Florida,"Washington, DC",District of Columbia,2291,2259,-15,-10,2276,2249,9,16,2285,2233,1574,187,207,212,0,,0,0.0,0.0,0.0,0.0,0.0
2024,11,22,5,2024-11-22,YX,5194,PDX,MIA,"Portland, OR",Oregon,"Miami, FL",Florida,2058,2179,-11,-15,2047,2164,7,7,2054,2157,579,66,86,80,0,,0,0.0,0.0,0.0,0.0,0.0
2024,3,7,4,2024-03-07,WN,9515,ORD,EWR,"Chicago, IL",Illinois,"Newark, NJ",New Jersey,713,1420,-2,-10,711,1410,20,15,731,1395,292,30,50,65,0,,0,0.0,0.0,0.0,0.0,0.0
2024,3,2,6,2024-03-02,MQ,7572,IAH,DTW,"Houston, TX",Texas,"Detroit, MI",Michigan,1652,613,2,10,1654,623,28,10,1682,613,2706,336,356,374,0,,0,0.0,0.0,0.0,0.0,0.0
2024,4,18,4,2024-04-18,WN,3463,PHL,BWI,"Philadelphia, PA",Pennsylvania,"Baltimore, MD",Maryland,2047,1566,-8,0,2039,1566,5,11,2044,1555,692,91,111,107,0,,0,0.0,0.0,0.0,0.0,0.0
2024,6,15,6,2024-06-15,NK,3123,DCA,PHL,"Washington, DC",District of Columbia,"Philadelphia, PA",Pennsylvania,2176,1459,-8,0,2168,1459,15,12,2183,1447,1355,165,185,192,0,,0,0.0,0.0,0.0,0.0,0.0
2024,2,6,2,2024-02-06,OH,1917,DCA,SFO,"Washington, DC",District of Columbia,"San Francisco, CA",California,1985,2187,-13,-20,1972,2167,14,3,1986,2164,1067,134,154,151,0,,0,0.0,0.0,0.0,0.0,0.0
2024,4,28,7,2024-04-28,OO,783,ORD,BOS,"Chicago, IL",Illinois,"Boston, MA",Massachusetts,1469,1868,-3,0,1466,1868,11,7,1477,1861,207,29,49,47,0,,0,0.0,0.0,0.0,0.0,0.0
2024,3,26,2,2024-03-26,G4,5607,MSP,PHL,"Minneapolis, MN",Minnesota,"Philadelphia, PA",Pennsylvania,1580,2315,-5,-10,1575,2305,20,6,1595,2299,555,60,80,86,0,,0,0.0,0.0,0.0,0.0,0.0
2024,2,21,3,2024-02-21,NK,6831,DEN,PHL,"Denver, CO",Colorado,"Philadelphia, PA",Pennsylvania,1097,1925,-13,-5,1084,1920,6,3,1090,1917,1142,137,157,146,0,,0,0.0,0.0,0.0,0.0,0.0
2024,3,31,7,2024-03-31,AA,9524,ORD,MSP,"Chicago, IL",Illinois,"Minneapolis, MN",Minnesota,1797,2087,0,0,1797,2087,12,17,1809,2070,860,106,126,135,0,,0,0.0,0.0,0.0,0.0,0.0
2024,10,15,2,2024-10-15,AA,8908,DCA,IAH,"Washington, DC",District of Columbia,"Houston, TX",Texas,1114,2265,15,10,1129,2275,19,13,1148,2262,2578,312,332,344,0,,0,0.0,0.0,0.0,0.0,0.0
2024,12,2,1,2024-12-02,WN,3010,LAX,PDX,"Los Angeles, CA",California,"Portland, OR",Oregon,1862,1032,-19,-10,1843,1022,20,7,1863,1015,1619,193,213,220,0,,0,0.0,0.0,0.0,0.0,0.0
2024,10,24,4,2024-10-24,WN,2117,DTW,LAX,"Detroit, MI",Michigan,"Los Angeles, CA",California,1666,1211,-5,5,1661,1216,7,5,1668,1211,1570,203,223,215,0,,0,0.0,0.0,0.0,0.0,0.0
2024,7,22,1,2024-07-22,AA,4323,ORD,HNL,"Chicago, IL",Illinois,"Honolulu, HI",Hawaii,922,1061,-23,-20,899,1041,24,19,923,1022,1937,248,268,291,0,,0,0.0,0.0,0.0,0.0,0.0
2024,8,25,7,2024-08-25,AS,2284,SLC,MCO,"Salt Lake City, UT",Utah,"Orlando, FL",Florida,833,1477,-4,-5,829,1472,6,18,835,1454,1985,253,273,277,0,,0,0.0,0.0,0.0,0.0,0.0
2024,6,3,1,2024-06-03,9E,1457,SFO,SLC,"San Francisco, CA",California,"Salt Lake City, UT",Utah,1187,883,-2,-10,1185,873,19,10,1204,863,1582,192,212,221,0,,0,0.0,0.0,0.0,0.0,0.0
2024,8,27,2,2024-08-27,DL,6791,BWI,MSP,"Baltimore, MD",Maryland,"Minneapolis, MN",Minnesota,1656,1222,22,15,1678,1237,18,5,1696,1232,2580,326,346,349,0,,0,0.0,0.0,0.0,0.0,0.0
2024,5,15,3,2024-05-15,OO,6631,LAS,MDW,"Las Vegas, NV",Nevada,"Chicago, IL",Illinois,763,1399,-3,-10,760,1389,25,14,785,1375,2328,294,314,333,0,,0,0.0,0.0,0.0,0.0,0.0
2024,12,27,5,2024-12-27,B6,4766,BOS,DFW,"Boston, MA",Massachusetts,"Dallas/Fort Worth, TX",Texas,646,2227,0,0,646,2227,13,10,659,2217,2311,280,300,303,0,,0,0.0,0.0,0.0,0.0,0.0
2024,3,4,1,2024-03-04,F9,7497,JFK,SEA,"New York, NY",New York,"Seattle, WA",Washington,1959,2211,-3,-10,1956,2201,8,17,1964,2184,654,79,99,104,0,,0,0.0,0.0,0.0,0.0,0.0
2024,5,2,4,2024-05-02,HA,2568,EWR,LAS,"Newark, NJ",New Jersey,"Las Vegas, NV",Nevada,511,1316,-5,0,506,1316,27,13,533,1303,1706,210,230,250,0,,0,0.0,0.0,0.0,0.0,0.0
2024,9,10,2,2024-09-10,UA,7391,SEA,JFK,"Seattle, WA",Washington,"New York, NY",New York,554,1133,-15,-5,539,1128,12,15,551,1113,2724,336,356,363,0,,0,0.0,0.0,0.0,0.0,0.0
2024,4,23,2,2024-04-23,G4,7355,ORD,MSP,"Chicago, IL",Illinois,"Minneapolis, MN",Minnesota,729,1281,-22,-20,707,1261,14,10,721,1251,502,65,85,89,0,,0,0.0,0.0,0.0,0.0,0.0
2024,1,20,6,2024-01-20,NK,4020,SEA,MSP,"Seattle, WA",Washington,"Minneapolis, MN",Minnesota,1645,1991,19,10,1664,2001,21,15,1685,1986,2908,357,377,393,0,,0,0.0,0.0,0.0,0.0,0.0
2024,1,16,2,2024-01-16,G4,4336,PHX,EWR,"Phoenix, AZ",Arizona,"Newark, NJ",New Jersey,1360,1620,10,5,1370,1625,10,18,1380,1607,663,90,110,118,0,,0,0.0,0.0,0.0,0.0,0.0
2024,5,24,5,2024-05-24,AA,2039,IAD,PHL,"Washington, DC",District of Columbia,"Philadelphia, PA",Pennsylvania,1756,1780,-16,-10,1740,1770,9,18,1749,1752,487,64,84,91,0,,0,0.0,0.0,0.0,0.0,0.0
2024,7,26,5,2024-07-26,B6,3956,STL,ORD,"St. Louis, MO",Missouri,"Chicago, IL",Illinois,661,1333,8,0,669,1333,14,15,683,1318,1567,195,215,224,0,,0,0.0,0.0,0.0,0.0,0.0
2024,1,19,5,2024-01-19,YX,150,ATL,MCO,"Atlanta, GA",Georgia,"Orlando, FL",Florida,2117,2086,1,-5,2118,2081,21,16,2139,2065,1625,194,214,231,0,,0,0.0,0.0,0.0,0.0,0.0
2024,6,14,5,2024-06-14,MQ,7230,PHL,STL,"Philadelphia, PA",Pennsylvania,"St. Louis, MO",Missouri,2082,2203,2,5,2084,2208,20,10,2104,2198,2431,297,317,327,0,,0,0.0,0.0,0.0,0.0,0.0
2024,2,7,3,2024-02-07,UA,1460,ATL,DCA,"Atlanta, GA",Georgia,"Washington, DC",District of Columbia,1302,760,13,5,1315,765,29,4,1344,761,1075,128,148,161,0,,0,0.0,0.0,0.0,0.0,0.0
2024,6,29,6,2024-06-29,WN,6905,BOS,LAX,"Boston, MA",Massachusetts,"Los Angeles, CA",California,2023,773,-8,-15,2015,758,27,10,2042,748,1681,202,222,239,0,,0,0.0,0.0,0.0,0.0,0.0
2024,12,14,6,2024-12-14,WN,8657,TPA,DFW,"Tampa, FL",Florida,"Dallas/Fort Worth, TX",Texas,2195,1504,11,10,2206,1514,21,8,2227,1506,1956,245,265,274,0,,0,0.0,0.0,0.0,0.0,0.0
2024,4,14,7,2024-04-14,OO,6130,MSP,HNL,"Minneapolis, MN",Minnesota,"Honolulu, HI",Hawaii,678,2122,-5,-10,673,2112,22,15,695,2097,1744,209,229,246,0,,0,0.0,0.0,0.0,0.0,0.0
2024,4,9,2,2024-04-09,YX,3145,SLC,ATL,"Salt Lake City, UT",Utah,"Atlanta, GA",Georgia,1885,2173,-7,-10,1878,2163,24,5,1902,2158,2274,275,295,304,0,,0,0.0,0.0,0.0,0.0,0.0
2024,3,30,6,2024-03-30,NK,357,LAS,DTW,"Las Vegas, NV",Nevada,"Detroit, MI",Michigan,1731,1959,-2,5,1729,1964,13,9,1742,1955,1871,234,254,256,0,,0,0.0,0.0,0.0,0.0,0.0
2024,10,26,6,2024-10-26,9E,144,SLC,CLT,"Salt Lake City, UT",Utah,"Charlotte, NC",North Carolina,1404,625,-13,-10,1391,615,15,8,1406,607,1969,240,260,263,0,,0,0.0,0.0,0.0,0.0,0.0
2024,11,27,3,2024-11-27,OO,8560,SFO,TPA,"San Francisco, CA",California,"Tampa, FL",Florida,1051,2127,-14,-15,1037,2112,6,7,1043,2105,2705,343,363,356,0,,0,0.0,0.0,0.0,0.0,0.0
2024,3,19,2,2024-03-19,F9,1434,STL,CLT,"St. Louis, MO",Missouri,"Charlotte, NC",North Carolina,1225,1922,-5,-5,1220,1917,18,18,1238,1899,981,123,143,159,0,,0,0.0,0.0,0.0,0.0,0.0
2024,3,13,3,2024-03-13,OO,771,MDW,MIA,"Chicago, IL",Illinois,"Miami, FL",Florida,1955,1036,12,10,1967,1046,19,5,1986,1041,224,18,38,42,0,,0,0.0,0.0,0.0,0.0,0.0
2024,6,24,1,2024-06-24,9E,7100,LGA,TPA,"New York, NY",New York,"Tampa, FL",Florida,1979,1358,-13,-10,1966,1348,5,7,1971,1341,2928,370,390,382,0,,0,0.0,0.0,0.0,0.0,0.0
2024,4,5,5,2024-04-05,B6,3738,IAD,SEA,"Washington, DC",District of Columbia,"Seattle, WA",Washington,2027,610,2,-5,2029,605,5,5,2034,600,661,72,92,82,0,,0,0.0,0.0,0.0,0.0,0.0
2024,12,10,2,2024-12-10,MQ,6185,LGA,IAH,"New York, NY",New York,"Houston, TX",Texas,1677,1861,-8,-10,1669,1851,13,17,1682,1834,1425,180,200,210,1,,0,0.0,0.0,0.0,0.0,0.0
2024,4,12,5,2024-04-12,MQ,334,TPA,PDX,"Tampa, FL",Florida,"Portland, OR",Oregon,1861,1218,-12,-5,1849,1213,16,4,1865,1209,2959,374,394,394,0,,0,0.0,0.0,0.0,0.0,0.0
2024,8,11,7,2024-08-11,YX,6934,PDX,LAX,"Portland, OR",Oregon,"Los Angeles, CA",California,792,2033,-5,5,787,2038,21,17,808,2021,2893,369,389,407,0,,0,0.0,0.0,0.0,0.0,0.0
2024,1,6,6,2024-01-06,9E,3307,STL,MCO,"St. Louis, MO",Missouri,"Orlando, FL",Florida,935,1957,-6,-5,929,1952,19,15,948,1937,1996,248,268,282,0,,0,0.0,0.0,0.0,0.0,0.0
2024,5,1,3,2024-05-01,NK,5664,STL,MIA,"St. Louis, MO",Missouri,"Miami, FL",Florida,895,1936,0,5,895,1941,8,4,903,1937,1116,133,153,145,0,,0,0.0,0.0,0.0,0.0,0.0
2024,8,23,5,2024-08-23,UA,2500,DCA,BOS,"Washington, DC",District of Columbia,"Boston, MA",Massachusetts,665,1624,0,0,665,1624,9,12,674,1612,2284,289,309,310,0,,0,0.0,0.0,0.0,0.0,0.0
2024,4,25,4,2024-04-25,UA,9709,HNL,DCA,"Honolulu, HI",Hawaii,"Washington, DC",District of Columbia,1493,1122,-9,-5,1484,1117,18,6,1502,1111,1400,183,203,207,0,,0,0.0,0.0,0.0,0.0,0.0
2024,6,11,2,2024-06-11,UA,5189,EWR,JFK,"Newark, NJ",New Jersey,"New York, NY",New York,1975,2293,-6,-5,1969,2288,10,4,1979,2284,838,111,131,125,0,,0,0.0,0.0,0.0,0.0,0.0
2024,8,13,2,2024-08-13,YX,7651,PHL,MIA,"Philadelphia, PA",Pennsylvania,"Miami, FL",Florida,1283,687,6,5,1289,692,10,16,1299,676,2139,272,292,298,0,,0,0.0,0.0,0.0,0.0,0.0
2024,8,17,6,2024-08-17,WN,5105,SEA,SFO,"Seattle, WA",Washington,"San Francisco, CA",California,1456,841,-5,0,1451,841,23,5,1474,836,1143,134,154,162,0,,0,0.0,0.0,0.0,0.0,0.0
2024,6,30,7,2024-06-30,AS,7590,STL,DTW,"St. Louis, MO",Missouri,"Detroit, MI",Michigan,2059,1608,5,10,2064,1618,27,14,2091,1604,2002,246,266,287,0,,0,0.0,0.0,0.0,0.0,0.0
2024,9,5,4,2024-09-05,HA,7840,ATL,IAD,"Atlanta, GA",Georgia,"Washington, DC",District of Columbia,900,1755,8,15,908,1770,28,7,936,1763,790,98,118,133,0,,0,0.0,0.0,0.0,0.0,0.0
2024,11,13,3,2024-11-13,B6,8731,TPA,PDX,"Tampa, FL",Florida,"Portland, OR",Oregon,614,1197,-4,5,610,1202,5,4,615,1198,2343,288,308,297,0,,0,0.0,0.0,0.0,0.0,0.0
2024,7,28,7,2024-07-28,F9,5282,SEA,LAS,"Seattle, WA",Washington,"Las Vegas, NV",Nevada,850,2245,26,30,876,2275,13,16,889,2259,1362,173,193,202,0,,0,10.0,4.0,1.0,0.0,15.0
2024,5,23,4,2024-05-23,OH,750,DEN,CLT,"Denver, CO",Colorado,"Charlotte, NC",North Carolina,1783,1951,-4,0,1779,1951,26,7,1805,1944,420,46,66,79,0,,0,0.0,0.0,0.0,0.0,0.0
2024,12,10,2,2024-12-10,OH,133,HNL,JFK,"Honolulu, HI",Hawaii,"New York, NY",New York,1317,710,-29,-20,1288,690,5,9,1293,681,687,76,96,90,0,,0,0.0,0.0,0.0,0.0,0.0
2024,4,5,5,2024-04-05,YX,3132,STL,DCA,"St. Louis, MO",Missouri,"Washington, DC",District of Columbia,1375,2343,-1,0,1374,2343,29,17,1403,2326,494,63,83,109,0,,0,0.0,0.0,0.0,0.0,0.0
2024,12,11,3,2024-12-11,MQ,7744,TPA,JFK,"Tampa, FL",Florida,"New York, NY",New York,1749,888,-7,-10,1742,878,8,19,1750,859,584,63,83,90,0,,0,0.0,0.0,0.0,0.0,0.0
2024,8,31,6,2024-08-31,B6,1210,BOS,CLT,"Boston, MA",Massachusetts,"Charlotte, NC",North Carolina,1113,2040,-11,-5,1102,2035,29,18,1131,2017,775,104,124,151,0,,0,0.0,0.0,0.0,0.0,0.0
2024,3,26,2,2024-03-26,OO,8753,MDW,SEA,"Chicago, IL",Illinois,"Seattle, WA",Washington,2009,673,9,0,2018,673,20,10,2038,663,758,100,120,130,0,,0,0.0,0.0,0.0,0.0,0.0
2024,7,2,2,2024-07-02,YX,8613,MSP,TPA,"Minneapolis, MN",Minnesota,"Tampa, FL",Florida,630,707,-13,-10,617,697,9,15,626,682,2082,264,284,288,0,,0,0.0,0.0,0.0,0.0,0.0
2024,4,30,2,2024-04-30,B6,4610,BOS,LGA,"Boston, MA",Massachusetts,"New York, NY",New York,763,2139,4,-5,767,2134,20,13,787,2121,1359,164,184,197,0,,0,0.0,0.0,0.0,0.0,0.0
2024,11,27,3,2024-11-27,OH,1974,IAH,SLC,"Houston, TX",Texas,"Salt Lake City, UT",Utah,2047,2350,2,-5,2049,2345,26,3,2075,2342,2323,295,315,324,0,,0,0.0,0.0,0.0,0.0,0.0
2024,4,1,1,2024-04-01,9E,3139,LGA,MCO,"New York, NY",New York,"Orlando, FL",Florida,1333,2314,-16,-10,1317,2304,18,9,1335,2295,2373,299,319,326,0,,0,0.0,0.0,0.0,0.0,0.0
2024,3,10,7,2024-03-10,DL,1356,BOS,MCO,"Boston, MA",Massachusetts,"Orlando, FL",Florida,680,2290,-17,-10,663,2280,13,5,676,2275,547,61,81,79,0,,0,0.0,0.0,0.0,0.0,0.0
2024,5,12,7,2024-05-12,YX,3340,JFK,CLT,"New York, NY",New York,"Charlotte, NC",North Carolina,848,1400,13,5,861,1405,18,18,879,1387,666,78,98,114,0,,0,0.0,0.0,0.0,0.0,0.0
2024,10,5,6,2024-10-05,OO,4363,MIA,ATL,"Miami, FL",Florida,"Atlanta, GA",Georgia,970,1336,-5,-5,965,1331,20,6,985,1325,2353,287,307,313,0,,0,0.0,0.0,0.0,0.0,0.0
2024,5,16,4,2024-05-16,OO,5369,MCO,SEA,"Orlando, FL",Florida,"Seattle, WA",Washington,660,1728,4,10,664,1738,10,15,674,1723,1073,128,148,153,0,,0,0.0,0.0,0.0,0.0,0.0
2024,11,9,6,2024-11-09,B6,7817,ATL,BOS,"Atlanta, GA",Georgia,"Boston, MA",Massachusetts,613,2005,15,10,628,2015,21,3,649,2012,2629,320,340,344,0,,0,0.0,0.0,0.0,0.0,0.0
2024,7,5,5,2024-07-05,HA,1509,MCO,IAD,"Orlando, FL",Florida,"Washington, DC",District of Columbia,517,2219,3,5,520,2224,5,3,525,2221,2473,307,327,315,0,,0,0.0,0.0,0.0,0.0,0.0
2024,8,8,4,2024-08-08,YX,1932,PDX,SAN,"Portland, OR",Oregon,"San Diego, CA",California,1627,676,-10,-5,1617,671,22,14,1639,657,602,81,101,117,0,,0,0.0,0.0,0.0,0.0,0.0
2024,2,15,4,2024-02-15,NK,2124,DCA,CLT,"Washington, DC",District of Columbia,"Charlotte, NC",North Carolina,1709,802,2,5,1711,807,15,15,1726,792,287,29,49,59,0,,0,0.0,0.0,0.0,0.0,0.0
2024,10,4,5,2024-10-04,DL,5836,SEA,STL,"Seattle, WA",Washington,"St. Louis, MO",Missouri,1865,1450,-20,-10,1845,1440,15,9,1860,1431,2473,311,331,335,0,,0,0.0,0.0,0.0,0.0,0.0
2024,7,10,3,2024-07-10,OH,5093,ORD,BOS,"Chicago, IL",Illinois,"Boston, MA",Massachusetts,1985,2124,-5,5,1980,2129,16,5,1996,2124,2215,283,303,304,0,,0,0.0,0.0,0.0,0.0,0.0
2024,1,8,1,2024-01-08,MQ,7734,MIA,BWI,"Miami, FL",Florida,"Baltimore, MD",Maryland,2128,1864,-11,-5,2117,1859,6,6,2123,1853,2569,316,336,328,0,,0,0.0,0.0,0.0,0.0,0.0
2024,10,2,3,2024-10-02,AS,5057,PHL,TPA,"Philadelphia, PA",Pennsylvania,"Tampa, FL",Florida,642,1399,12,5,654,1404,20,3,674,1401,2087,252,272,275,0,,0,0.0,0.0,0.0,0.0,0.0
2024,6,27,4,2024-06-27,NK,3313,SFO,CLT,"San Francisco, CA",California,"Charlotte, NC",North Carolina,1154,1306,-2,5,1152,1311,26,7,1178,1304,2063,266,286,299,0,,0,0.0,0.0,0.0,0.0,0.0
2024,11,29,5,2024-11-29,B6,6308,ORD,JFK,"Chicago, IL",Illinois,"New York, NY",New York,1463,1995,5,0,1468,1995,14,13,1482,1982,1332,175,195,202,0,,0,0.0,0.0,0.0,0.0,0.0
2024,2,8,4,2024-02-08,G4,9744,BOS,ORD,"Boston, MA",Massachusetts,"Chicago, IL",Illinois,2135,1828,9,0,2144,1828,25,5,2169,1823,580,79,99,109,0,,0,0.0,0.0,0.0,0.0,0.0
2024,10,19,6,2024-10-19,OH,6553,PHL,DCA,"Philadelphia, PA",Pennsylvania,"Washington, DC",District of Columbia,952,1011,-2,-10,950,1001,18,19,968,982,2622,333,353,370,0,,0,0.0,0.0,0.0,0.0,0.0
2024,6,26,3,2024-06-26,WN,2853,DCA,SFO,"Washington, DC",District of Columbia,"San Francisco, CA",California,950,1837,-4,0,946,1837,11,16,957,1821,996,132,152,159,0,,0,0.0,0.0,0.0,0.0,0.0
2024,6,10,1,2024-06-10,OH,7428,PHL,TPA,"Philadelphia, PA",Pennsylvania,"Tampa, FL",Florida,561,1040,4,0,565,1040,12,3,577,1037,1294,165,185,180,0,,0,0.0,0.0,0.0,0.0,0.0
2024,11,26,2,2024-11-26,OH,405,JFK,LGA,"New York, NY",New York,"New York, NY",New York,1095,2154,2,-5,1097,2149,14,19,1111,2130,1383,173,193,206,0,,1,0.0,0.0,0.0,0.0,0.0
2024,4,13,6,2024-04-13,MQ,1484,TPA,ORD,"Tampa, FL",Florida,"Chicago, IL",Illinois,1439,2294,-7,-5,1432,2289,14,9,1446,2280,1583,197,217,220,0,,0,0.0,0.0,0.0,0.0,0.0
2024,6,9,7,2024-06-09,9E,3467,SFO,PHL,"San Francisco, CA",California,"Philadelphia, PA",Pennsylvania,1799,1835,-9,-5,1790,1830,14,18,1804,1812,970,120,140,152,0,,0,0.0,0.0,0.0,0.0,0.0
2024,10,13,7,2024-10-13,HA,1674,PHL,LGA,"Philadelphia, PA",Pennsylvania,"New York, NY",New York,2202,652,-15,-5,2187,647,18,3,2205,644,2769,343,363,364,0,,0,0.0,0.0,0.0,0.0,0.0
2024,5,2,4,2024-05-02,AA,972,PDX,IAD,"Portland, OR",Oregon,"Washington, DC",District of Columbia,1818,2134,7,5,1825,2139,23,17,1848,2122,2876,351,371,391,0,,0,0.0,0.0,0.0,0.0,0.0
2024,2,23,5,2024-02-23,OH,8460,SEA,IAH,"Seattle, WA",Washington,"Houston, TX",Texas,1652,1711,-7,0,1645,1711,13,4,1658,1707,544,58,78,75,0,,0,0.0,0.0,0.0,0.0,0.0
2024,2,3,6,2024-02-03,F9,5678,CLT,PHX,"Charlotte, NC",North Carolina,"Phoenix, AZ",Arizona,863,1271,-29,-20,834,1251,21,4,855,1247,685,94,114,119,0,,0,0.0,0.0,0.0,0.0,0.0
2024,8,29,4,2024-08-29,HA,9895,SFO,PHL,"San Francisco, CA",California,"Philadelphia, PA",Pennsylvania,1590,608,-21,-20,1569,588,23,7,1592,581,2065,253,273,283,0,,0,0.0,0.0,0.0,0.0,0.0
2024,4,22,1,2024-04-22,F9,1130,SLC,LAS,"Salt Lake City, UT",Utah,"Las Vegas, NV",Nevada,546,1290,-6,0,540,1290,6,6,546,1284,2453,304,324,316,0,,0,0.0,0.0,0.0,0.0,0.0
2024,11,13,3,2024-11-13,NK,7864,BOS,SAN,"Boston, MA",Massachusetts,"San Diego, CA",California,1468,682,2,10,1470,692,19,5,1489,687,1914,245,265,269,0,,0,0.0,0.0,0.0,0.0,0.0
2024,1,23,2,2024-01-23,F9,6831,LAX,SFO,"Los Angeles, CA",California,"San Francisco, CA",California,1897,2286,-26,-20,1871,2266,10,10,1881,2256,2866,364,384,384,0,,0,0.0,0.0,0.0,0.0,0.0
2024,2,15,4,2024-02-15,DL,7005,ORD,DFW,"Chicago, IL",Illinois,"Dallas/Fort Worth, TX",Texas,1321,1648,0,0,1321,1648,20,16,1341,1632,1690,211,231,247,0,,0,0.0,0.0,0.0,0.0,0.0
2024,11,7,4,2024-11-07,UA,4542,SLC,DCA,"Salt Lake City, UT",Utah,"Washington, DC",District of Columbia,1159,824,17,10,1176,834,21,8,1197,826,2377,289,309,318,0,,0,0.0,0.0,0.0,0.0,0.0
2024,5,14,2,2024-05-14,G4,3767,PHX,IAH,"Phoenix, AZ",Arizona,"Houston, TX",Texas,1261,2120,-11,-20,1250,2100,28,13,1278,2087,1853,240,260,281,0,,0,0.0,0.0,0.0,0.0,0.0
2024,4,27,6,2024-04-27,AA,1376,SEA,ATL,"Seattle, WA",Washington,"Atlanta, GA",Georgia,1660,1029,-19,-10,1641,1019,14,7,1655,1012,804,104,124,125,0,,0,0.0,0.0,0.0,0.0,0.0
2024,7,7,7,2024-07-07,F9,6653,ORD,LAS,"Chicago, IL",Illinois,"Las Vegas, NV",Nevada,1618,2051,20,15,1638,2066,16,7,1654,2059,281,37,57,60,0,,0,0.0,0.0,0.0,0.0,0.0
2024,5,10,5,2024-05-10,F9,642,STL,MSP,"St. Louis, MO",Missouri,"Minneapolis, MN",Minnesota,737,1817,-8,-15,729,1802,16,16,745,1786,309,40,60,72,0,,0,0.0,0.0,0.0,0.0,0.0
2024,7,30,2,2024-07-30,NK,8646,STL,IAH,"St. Louis, MO",Missouri,"Houston, TX",Texas,1295,1741,-5,0,1290,1741,23,19,1313,1722,209,24,44,66,0,,0,0.0,0.0,0.0,0.0,0.0
2024,4,22,1,2024-04-22,MQ,4908,DEN,SFO,"Denver, CO",Colorado,"San Francisco, CA",California,534,1434,4,0,538,1434,10,13,548,1421,2989,368,388,391,0,,0,0.0,0.0,0.0,0.0,0.0
2024,2,13,2,2024-02-13,OH,7831,LAS,IAD,"Las Vegas, NV",Nevada,"Washington, DC",District of Columbia,1819,1494,-9,-10,1810,1484,6,9,1816,1475,1622,209,229,224,0,,0,0.0,0.0,0.0,0.0,0.0
2024,5,7,2,2024-05-07,OO,683,MSP,LGA,"Minneapolis, MN",Minnesota,"New York, NY",New York,1369,1359,-27,-20,1342,1339,25,15,1367,1324,925,121,141,161,0,,0,0.0,0.0,0.0,0.0,0.0
2024,12,29,7,2024-12-29,B6,610,ATL,BOS,"Atlanta, GA",Georgia,"Boston, MA",Massachusetts,991,1594,1,0,992,1594,22,18,1014,1576,2786,347,367,387,0,,0,0.0,0.0,0.0,0.0,0.0
2024,6,6,4,2024-06-06,WN,6776,ATL,LGA,"Atlanta, GA",Georgia,"New York, NY",New York,757,677,5,5,762,682,11,14,773,668,1693,202,222,227,0,,0,0.0,0.0,0.0,0.0,0.0
2024,9,29,7,2024-09-29,9E,6771,SFO,HNL,"San Francisco, CA",California,"Honolulu, HI",Hawaii,886,1775,-12,-10,874,1765,9,17,883,1748,2908,353,373,379,0,,0,0.0,0.0,0.0,0.0,0.0
2024,11,10,7,2024-11-10,9E,9238,MIA,DEN,"Miami, FL",Florida,"Denver, CO",Colorado,769,1679,-5,5,764,1684,28,3,792,1681,1638,207,227,238,0,,0,0.0,0.0,0.0,0.0,0.0
2024,12,20,5,2024-12-20,MQ,7795,SEA,MSP,"Seattle, WA",Washington,"Minneapolis, MN",Minnesota,1366,956,7,0,1373,956,26,13,1399,943,1924,237,257,276,0,,0,0.0,0.0,0.0,0.0,0.0
2024,12,5,4,2024-12-05,HA,3573,MIA,LAX,"Miami, FL",Florida,"Los Angeles, CA",California,1847,1882,-10,-5,1837,1877,12,9,1849,1868,1351,175,195,196,0,,0,0.0,0.0,0.0,0.0,0.0
2024,2,14,3,2024-02-14,9E,1298,PHX,SLC,"Phoenix, AZ",Arizona,"Salt Lake City, UT",Utah,1570,1134,6,5,1576,1139,16,18,1592,1121,1705,211,231,245,0,,0,0.0,0.0,0.0,0.0,0.0
2024,4,17,3,2024-04-17,OH,4095,DCA,SFO,"Washington, DC",District of Columbia,"San Francisco, CA",California,1105,1273,-18,-10,1087,1263,29,11,1116,1252,2516,318,338,358,0,,0,0.0,0.0,0.0,0.0,0.0
2024,8,6,2,2024-08-06,9E,4635,SEA,DTW,"Seattle, WA",Washington,"Detroit, MI",Michigan,1193,2217,-10,0,1183,2217,27,11,1210,2206,623,76,96,114,0,,0,0.0,0.0,0.0,0.0,0.0
2024,11,13,3,2024-11-13,AS,5971,PHL,BOS,"Philadelphia, PA",Pennsylvania,"Boston, MA",Massachusetts,1453,1170,-4,0,1449,1170,5,14,1454,1156,930,111,131,130,0,,0,0.0,0.0,0.0,0.0,0.0
2024,11,10,7,2024-11-10,YX,3403,SEA,MIA,"Seattle, WA",Washington,"Miami, FL",Florida,2225,1177,7,0,2232,1177,29,16,2261,1161,1091,133,153,178,0,,1,0.0,0.0,0.0,0.0,0.0
2024,6,25,2,2024-06-25,OO,2547,CLT,ORD,"Charlotte, NC",North Carolina,"Chicago, IL",Illinois,2010,1005,-4,-5,2006,1000,19,14,2025,986,642,79,99,112,0,,0,0.0,0.0,0.0,0.0,0.0
2024,8,15,4,2024-08-15,AA,9508,IAH,IAD,"Houston, TX",Texas,"Washington, DC",District of Columbia,2086,714,14,5,2100,719,17,11,2117,708,2470,316,336,344,0,,0,0.0,0.0,0.0,0.0,0.0
2024,7,9,2,2024-07-09,MQ,7839,TPA,IAD,"Tampa, FL",Florida,"Washington, DC",District of Columbia,2241,1073,10,5,2251,1078,29,14,2280,1064,625,78,98,121,0,,0,0.0,0.0,0.0,0.0,0.0
2024,6,8,6,2024-06-08,B6,6944,BWI,JFK,"Baltimore, MD",Maryland,"New York, NY",New York,910,1353,9,0,919,1353,14,15,933,1338,862,109,129,138,0,,0,0.0,0.0,0.0,0.0,0.0
2024,9,23,1,2024-09-23,OH,1390,LGA,DEN,"New York, NY",New York,"Denver, CO",Colorado,1344,1957,6,10,1350,1967,22,7,1372,1960,2613,325,345,354,0,,0,0.0,0.0,0.0,0.0,0.0
2024,12,23,1,2024-12-23,WN,5934,LAS,MSP,"Las Vegas, NV",Nevada,"Minneapolis, MN",Minnesota,624,2244,51,45,675,2289,22,7,697,2282,2557,323,343,352,0,,0,1.0,6.0,6.0,0.0,32.0
2024,11,21,4,2024-11-21,WN,7649,SFO,SEA,"San Francisco, CA",California,"Seattle, WA",Washington,711,1932,-7,0,704,1932,11,11,715,1921,1743,211,231,233,1,,0,0.0,0.0,0.0,0.0,0.0
2024,7,8,1,2024-07-08,NK,6787,DEN,PDX,"Denver, CO",Colorado,"Portland, OR",Oregon,1892,930,-6,-5,1886,925,19,8,1905,917,2344,296,316,323,0,,0,0.0,0.0,0.0,0.0,0.0
2024,6,23,7,2024-06-23,G4,8793,ATL,PDX,"Atlanta, GA",Georgia,"Portland, OR",Oregon,1444,2167,0,5,1444,2172,9,10,1453,2162,782,101,121,120,0,,0,0.0,0.0,0.0,0.0,0.0
2024,10,16,3,2024-10-16,F9,7528,TPA,DFW,"Tampa, FL",Florida,"Dallas/Fort Worth, TX",Texas,1419,1324,-24,-15,1395,1309,9,15,1404,1294,1195,147,167,171,0,,0,0.0,0.0,0.0,0.0,0.0
2024,12,22,7,2024-12-22,OO,486,IAH,DEN,"Houston, TX",Texas,"Denver, CO",Colorado,1789,1582,-7,0,1782,1582,5,18,1787,1564,596,73,93,96,0,,0,0.0,0.0,0.0,0.0,0.0
2024,5,24,5,2024-05-24,MQ,8703,LAX,SLC,"Los Angeles, CA",California,"Salt Lake City, UT",Utah,634,2127,7,0,641,2127,10,7,651,2120,2417,299,319,316,0,,0,0.0,0.0,0.0,0.0,0.0
2024,8,19,1,2024-08-19,OH,2106,STL,MSP,"St. Louis, MO",Missouri,"Minneapolis, MN",Minnesota,1284,687,20,30,1304,717,20,13,1324,704,1382,173,193,206,0,,0,4.0,7.0,3.0,0.0,16.0
2024,12,25,3,2024-12-25,YX,5313,IAH,PHX,"Houston, TX",Texas,"Phoenix, AZ",Arizona,1289,1507,35,45,1324,1552,12,19,1336,1533,2260,284,304,315,0,,0,4.0,10.0,1.0,1.0,29.0
2024,7,22,1,2024-07-22,F9,2247,IAH,ORD,"Houston, TX",Texas,"Chicago, IL",Illinois,814,1173,10,5,824,1178,8,12,832,1166,2026,249,269,269,0,,0,0.0,0.0,0.0,0.0,0.0
2024,7,31,3,2024-07-31,B6,3968,PDX,SAN,"Portland, OR",Oregon,"San Diego, CA",California,799,602,2,0,801,602,17,9,818,593,1529,184,204,210,0,,0,0.0,0.0,0.0,0.0,0.0
2024,2,9,5,2024-02-09,AS,9630,PHL,DCA,"Philadelphia, PA",Pennsylvania,"Washington, DC",District of Columbia,1821,2006,3,0,1824,2006,23,13,1847,1993,526,71,91,107,0,,0,0.0,0.0,0.0,0.0,0.0
2024,10,1,2,2024-10-01,DL,6137,IAD,MCO,"Washington, DC",District of Columbia,"Orlando, FL",Florida,778,2247,-5,-5,773,2242,14,10,787,2232,2653,322,342,346,0,,0,0.0,0.0,0.0,0.0,0.0
2024,11,18,1,2024-11-18,MQ,6737,LAS,EWR,"Las Vegas, NV",Nevada,"Newark, NJ",New Jersey,873,1123,19,10,892,1133,21,7,913,1126,2171,261,281,289,0,,0,0.0,0.0,0.0,0.0,0.0
2024,3,22,5,2024-03-22,OO,452,STL,SEA,"St. Louis, MO",Missouri,"Seattle, WA",Washington,1225,2188,2,5,1227,2193,24,18,1251,2175,2730,341,361,383,0,,0,0.0,0.0,0.0,0.0,0.0
2024,6,29,6,2024-06-29,OH,5064,LGA,PDX,"New York, NY",New York,"Portland, OR",Oregon,2011,1771,4,5,2015,1776,22,3,2037,1773,714,80,100,105,0,,0,0.0,0.0,0.0,0.0,0.0
2024,11,15,5,2024-11-15,UA,3288,DEN,MDW,"Denver, CO",Colorado,"Chicago, IL",Illinois,561,1105,-10,-15,551,1090,9,12,560,1078,2268,283,303,304,0,,0,0.0,0.0,0.0,0.0,0.0
2024,3,23,6,2024-03-23,B6,1402,TPA,SFO,"Tampa, FL",Florida,"San Francisco, CA",California,1378,1245,-9,-5,1369,1240,16,16,1385,1224,2496,309,329,341,1,,1,0.0,0.0,0.0,0.0,0.0
2024,10,29,2,2024-10-29,DL,7849,PDX,DTW,"Portland, OR",Oregon,"Detroit, MI",Michigan,1577,683,-6,0,1571,683,5,19,1576,664,2600,327,347,351,0,,0,0.0,0.0,0.0,0.0,0.0
2024,9,18,3,2024-09-18,UA,946,STL,MCO,"St. Louis, MO",Missouri,"Orlando, FL",Florida,837,2021,-16,-15,821,2006,29,15,850,1991,2513,309,329,353,0,,0,0.0,0.0,0.0,0.0,0.0
2024,9,28,6,2024-09-28,WN,7621,DCA,SEA,"Washington, DC",District of Columbia,"Seattle, WA",Washington,1898,783,2,-5,1900,778,29,18,1929,760,1963,243,263,290,0,,0,0.0,0.0,0.0,0.0,0.0
2024,7,18,4,2024-07-18,AS,8817,BWI,PDX,"Baltimore, MD",Maryland,"Portland, OR",Oregon,1376,768,-19,-15,1357,753,25,14,1382,739,601,82,102,121,0,,0,0.0,0.0,0.0,0.0,0.0
2024,8,27,2,2024-08-27,B6,2624,PHX,MIA,"Phoenix, AZ",Arizona,"Miami, FL",Florida,973,2184,13,20,986,2204,5,18,991,2186,1958,234,254,257,0,,0,2.0,0.0,1.0,0.0,17.0
2024,6,28,5,2024-06-28,9E,1978,SEA,MIA,"Seattle, WA",Washington,"Miami, FL",Florida,611,707,4,5,615,712,7,19,622,693,2996,376,396,402,0,,0,0.0,0.0,0.0,0.0,0.0
2024,6,19,3,2024-06-19,WN,4205,JFK,ORD,"New York, NY",New York,"Chicago, IL",Illinois,1489,792,7,0,1496,792,11,17,1507,775,687,78,98,106,0,,0,0.0,0.0,0.0,0.0,0.0
2024,10,21,1,2024-10-21,MQ,3730,SEA,STL,"Seattle, WA",Washington,"St. Louis, MO",Missouri,1792,1451,-3,-10,1789,1441,25,9,1814,1432,1480,178,198,212,0,,0,0.0,0.0,0.0,0.0,0.0
2024,6,25,2,2024-06-25,HA,7770,JFK,MSP,"New York, NY",New York,"Minneapolis, MN",Minnesota,823,1837,-13,-5,810,1832,15,7,825,1825,1126,144,164,166,0,,0,0.0,0.0,0.0,0.0,0.0
2024,8,24,6,2024-08-24,DL,6767,DFW,PDX,"Dallas/Fort Worth, TX",Texas,"Portland, OR",Oregon,1118,1983,-13,-15,1105,1968,29,17,1134,1951,749,100,120,146,0,,0,0.0,0.0,0.0,0.0,0.0
2024,5,17,5,2024-05-17,YX,2919,CLT,ATL,"Charlotte, NC",North Carolina,"Atlanta, GA",Georgia,1294,1718,3,0,1297,1718,24,17,1321,1701,2942,370,390,411,0,,0,0.0,0.0,0.0,0.0,0.0
2024,11,22,5,2024-11-22,OO,6079,LAS,DCA,"Las Vegas, NV",Nevada,"Washington, DC",District of Columbia,1382,2166,13,10,1395,2176,25,3,1420,2173,2835,360,380,388,0,,0,0.0,0.0,0.0,0.0,0.0
2024,11,6,3,2024-11-06,B6,8177,DFW,HNL,"Dallas/Fort Worth, TX",Texas,"Honolulu, HI",Hawaii,2203,1779,-30,-20,2173,1759,19,17,2192,1742,2162,277,297,313,0,,0,0.0,0.0,0.0,0.0,0.0
2024,5,8,3,2024-05-08,B6,9350,PDX,ATL,"Portland, OR",Oregon,"Atlanta, GA",Georgia,2109,2147,-21,-15,2088,2132,7,5,2095,2127,1266,158,178,170,0,,0,0.0,0.0,0.0,0.0,0.0
2024,2,18,7,2024-02-18,OO,2589,LGA,DCA,"New York, NY",New York,"Washington, DC",District of Columbia,1247,871,-11,-10,1236,861,12,17,1248,844,1155,146,166,175,0,,0,0.0,0.0,0.0,0.0,0.0
2024,6,12,3,2024-06-12,NK,5788,EWR,ORD,"Newark, NJ",New Jersey,"Chicago, IL",Illinois,2127,1786,8,5,2135,1791,7,10,2142,1781,1939,247,267,264,0,,0,0.0,0.0,0.0,0.0,0.0
2024,10,3,4,2024-10-03,AA,3364,HNL,SEA,"Honolulu, HI",Hawaii,"Seattle, WA",Washington,1608,1155,18,10,1626,1165,26,12,1652,1153,1265,162,182,200,0,,0,0.0,0.0,0.0,0.0,0.0
2024,10,19,6,2024-10-19,WN,6123,DEN,PDX,"Denver, CO",Colorado,"Portland, OR",Oregon,871,1505,1,5,872,1510,27,16,899,1494,2131,266,286,309,0,,0,0.0,0.0,0.0,0.0,0.0
2024,4,25,4,2024-04-25,OO,2393,CLT,IAD,"Charlotte, NC",North Carolina,"Washington, DC",District of Columbia,1598,1337,4,0,1602,1337,17,5,1619,1332,758,94,114,116,0,,0,0.0,0.0,0.0,0.0,0.0
2024,1,24,3,2024-01-24,B6,774,PHX,IAD,"Phoenix, AZ",Arizona,"Washington, DC",District of Columbia,1095,1364,-17,-15,1078,1349,6,11,1084,1338,765,88,108,105,0,,0,0.0,0.0,0.0,0.0,0.0
2024,11,6,3,2024-11-06,F9,6357,ATL,STL,"Atlanta, GA",Georgia,"St. Louis, MO",Missouri,2280,1344,4,5,2284,1349,27,12,2311,1337,1258,161,181,200,0,,0,0.0,0.0,0.0,0.0,0.0
2024,1,25,4,2024-01-25,YX,1111,PHX,PHL,"Phoenix, AZ",Arizona,"Philadelphia, PA",Pennsylvania,1007,1370,-18,-15,989,1355,7,4,996,1351,2627,327,347,338,0,,0,0.0,0.0,0.0,0.0,0.0
2024,5,6,1,2024-05-06,HA,9085,IAH,LGA,"Houston, TX",Texas,"New York, NY",New York,727,1398,-7,-5,720,1393,23,3,743,1390,728,93,113,119,0,,0,0.0,0.0,0.0,0.0,0.0
2024,8,21,3,2024-08-21,YX,332,PDX,SEA,"Portland, OR",Oregon,"Seattle, WA",Washington,1094,1803,-5,-5,1089,1798,19,13,1108,1785,586,78,98,110,0,,0,0.0,0.0,0.0,0.0,0.0
2024,7,27,6,2024-07-27,F9,3127,BOS,PDX,"Boston, MA",Massachusetts,"Portland, OR",Oregon,1917,1846,-8,-5,1909,1841,25,7,1934,1834,2320,287,307,319,0,,0,0.0,0.0,0.0,0.0,0.0
2024,4,2,2,2024-04-02,AA,3709,IAH,IAD,"Houston, TX",Texas,"Washington, DC",District of Columbia,514,715,2,-5,516,710,19,6,535,704,2179,272,292,297,0,,0,0.0,0.0,0.0,0.0,0.0
2024,4,3,3,2024-04-03,B6,2273,SLC,ATL,"Salt Lake City, UT",Utah,"Atlanta, GA",Georgia,1504,1560,-1,5,1503,1565,24,3,1527,1562,519,55,75,82,0,,0,0.0,0.0,0.0,0.0,0.0
2024,11,22,5,2024-11-22,9E,3484,PHX,STL,"Phoenix, AZ",Arizona,"St. Louis, MO",Missouri,1312,1628,-13,-10,1299,1618,11,6,1310,1612,2180,272,292,289,0,,0,0.0,0.0,0.0,0.0,0.0
2024,8,12,1,2024-08-12,AA,2428,STL,TPA,"St. Louis, MO",Missouri,"Tampa, FL",Florida,680,1372,1,10,681,1382,7,3,688,1379,1555,192,212,202,0,,0,0.0,0.0,0.0,0.0,0.0
2024,10,6,7,2024-10-06,AA,897,LGA,MIA,"New York, NY",New York,"Miami, FL",Florida,2031,665,17,10,2048,675,29,17,2077,658,2254,285,305,331,0,,0,0.0,0.0,0.0,0.0,0.0
2024,1,11,4,2024-01-11,DL,7221,SFO,ORD,"San Francisco, CA",California,"Chicago, IL",Illinois,837,1126,8,0,845,1126,21,4,866,1122,1700,221,241,246,0,,0,0.0,0.0,0.0,0.0,0.0
2024,11,24,7,2024-11-24,DL,3784,ORD,EWR,"Chicago, IL",Illinois,"Newark, NJ",New Jersey,1786,1048,-8,-15,1778,1033,6,16,1784,1017,517,66,86,88,0,,0,0.0,0.0,0.0,0.0,0.0
2024,1,12,5,2024-01-12,HA,4587,LAS,ORD,"Las Vegas, NV",Nevada,"Chicago, IL",Illinois,1425,1772,9,0,1434,1772,20,5,1454,1767,887,114,134,139,0,,0,0.0,0.0,0.0,0.0,0.0
2024,2,4,7,2024-02-04,HA,7790,IAH,JFK,"Houston, TX",Texas,"New York, NY",New York,577,700,15,10,592,710,15,6,607,704,210,33,53,54,0,,0,0.0,0.0,0.0,0.0,0.0
2024,8,15,4,2024-08-15,G4,2689,CLT,SAN,"Charlotte, NC",North Carolina,"San Diego, CA",California,728,1890,-17,-10,711,1880,13,3,724,1877,2017,260,280,276,0,,0,0.0,0.0,0.0,0.0,0.0
2024,8,7,3,2024-08-07,WN,4801,EWR,PHX,"Newark, NJ",New Jersey,"Phoenix, AZ",Arizona,2268,1329,16,10,2284,1339,15,13,2299,1326,1861,227,247,255,0,,0,0.0,0.0,0.0,0.0,0.0
2024,5,20,1,2024-05-20,UA,8800,HNL,MSP,"Honolulu, HI",Hawaii,"Minneapolis, MN",Minnesota,1553,1153,0,5,1553,1158,28,18,1581,1140,1370,178,198,224,0,,0,0.0,0.0,0.0,0.0,0.0
2024,1,23,2,2024-01-23,OO,7767,SLC,LGA,"Salt Lake City, UT",Utah,"New York, NY",New York,873,665,31,30,904,695,27,17,931,678,1154,152,172,196,0,,0,4.0,4.0,0.0,0.0,22.0
2024,3,23,6,2024-03-23,AA,6514,PHL,STL,"Philadelphia, PA",Pennsylvania,"St. Louis, MO",Missouri,654,1973,6,10,660,1983,29,19,689,1964,941,118,138,166,0,,0,0.0,0.0,0.0,0.0,0.0
2024,8,16,5,2024-08-16,YX,1563,BWI,PHX,"Baltimore, MD",Maryland,"Phoenix, AZ",Arizona,1316,719,-7,-10,1309,709,9,4,1318,705,1819,228,248,241,0,,0,0.0,0.0,0.0,0.0,0.0
2024,12,9,1,2024-12-09,DL,3210,ATL,IAH,"Atlanta, GA",Georgia,"Houston, TX",Texas,1708,844,-4,-5,1704,839,17,3,1721,836,320,40,60,60,0,,0,0.0,0.0,0.0,0.0,0.0
2024,3,20,3,2024-03-20,AS,1147,MCO,BWI,"Orlando, FL",Florida,"Baltimore, MD",Maryland,947,988,-6,-15,941,973,23,16,964,957,1288,162,182,201,0,,0,0.0,0.0,0.0,0.0,0.0
2024,12,18,3,2024-12-18,G4,4971,TPA,BWI,"Tampa, FL",Florida,"Baltimore, MD",Maryland,1368,886,-24,-15,1344,871,17,16,1361,855,2555,309,329,342,0,,0,0.0,0.0,0.0,0.0,0.0
2024,10,16,3,2024-10-16,B6,5389,CLT,TPA,"Charlotte, NC",North Carolina,"Tampa, FL",Florida,946,1671,-2,5,944,1676,6,8,950,1668,969,117,137,131,0,,0,0.0,0.0,0.0,0.0,0.0
2024,11,26,2,2024-11-26,WN,4535,BWI,DTW,"Baltimore, MD",Maryland,"Detroit, MI",Michigan,931,1399,12,15,943,1414,26,6,969,1408,2288,291,311,323,0,,0,0.0,0.0,0.0,0.0,0.0
2024,6,7,5,2024-06-07,MQ,8460,ORD,LAS,"Chicago, IL",Illinois,"Las Vegas, NV",Nevada,1266,1424,19,20,1285,1444,6,10,1291,1434,1311,164,184,180,0,,0,3.0,5.0,1.0,0.0,11.0
2024,5,7,2,2024-05-07,B6,1661,BWI,BOS,"Baltimore, MD",Maryland,"Boston, MA",Massachusetts,1692,1017,-4,-10,1688,1007,12,15,1700,992,2992,374,394,401,0,,0,0.0,0.0,0.0,0.0,0.0
2024,7,8,1,2024-07-08,G4,7959,STL,SLC,"St. Louis, MO",Missouri,"Salt Lake City, UT",Utah,1604,1569,-14,-10,1590,1559,9,9,1599,1550,2978,373,393,391,0,,0,0.0,0.0,0.0,0.0,0.0
2024,1,31,3,2024-01-31,YX,6905,MIA,MCO,"Miami, FL",Florida,"Orlando, FL",Florida,1297,950,-1,0,1296,950,15,12,1311,938,1509,180,200,207,0,,0,0.0,0.0,0.0,0.0,0.0
2024,12,24,2,2024-12-24,MQ,7912,LAX,ORD,"Los Angeles, CA",California,"Chicago, IL",Illinois,1733,754,-4,-10,1729,744,6,3,1735,741,2373,286,306,295,0,,0,0.0,0.0,0.0,0.0,0.0
2024,1,15,1,2024-01-15,NK,6386,JFK,LAX,"New York, NY",New York,"Los Angeles, CA",California,1782,1961,-5,-10,1777,1951,10,7,1787,1944,848,108,128,125,0,,0,0.0,0.0,0.0,0.0,0.0
2024,11,8,5,2024-11-08,F9,7943,LAS,SLC,"Las Vegas, NV",Nevada,"Salt Lake City, UT",Utah,1487,1884,12,10,1499,1894,26,4,1525,1890,812,92,112,122,0,,0,0.0,0.0,0.0,0.0,0.0
2024,3,15,5,2024-03-15,HA,674,DFW,IAD,"Dallas/Fort Worth, TX",Texas,"Washington, DC",District of Columbia,1048,2152,17,10,1065,2162,28,13,1093,2149,2519,313,333,354,0,,0,0.0,0.0,0.0,0.0,0.0
2024,2,3,6,2024-02-03,WN,4116,HNL,LAX,"Honolulu, HI",Hawaii,"Los Angeles, CA",California,1809,802,4,10,1813,812,16,18,1829,794,2083,261,281,295,0,,0,0.0,0.0,0.0,0.0,0.0
2024,12,24,2,2024-12-24,OO,7327,MSP,SEA,"Minneapolis, MN",Minnesota,"Seattle, WA",Washington,1577,1564,-3,0,1574,1564,10,9,1584,1555,1043,135,155,154,0,,0,0.0,0.0,0.0,0.0,0.0
2024,7,14,7,2024-07-14,F9,4124,BOS,CLT,"Boston, MA",Massachusetts,"Charlotte, NC",North Carolina,968,1039,-4,0,964,1039,20,16,984,1023,1043,139,159,175,0,,0,0.0,0.0,0.0,0.0,0.0
2024,11,26,2,2024-11-26,AS,8822,IAH,DEN,"Houston, TX",Texas,"Denver, CO",Colorado,868,1789,12,5,880,1794,23,3,903,1791,2148,267,287,293,0,,0,0.0,0.0,0.0,0.0,0.0
2024,1,29,1,2024-01-29,B6,1090,BWI,SEA,"Baltimore, MD",Maryland,"Seattle, WA",Washington,2247,978,-15,-10,2232,968,28,14,2260,954,1594,205,225,247,0,,0,0.0,0.0,0.0,0.0,0.0
2024,7,12,5,2024-07-12,MQ,2220,PDX,BOS,"Portland, OR",Oregon,"Boston, MA",Massachusetts,1353,2061,12,10,1365,2071,22,13,1387,2058,2938,374,394,409,0,,0,0.0,0.0,0.0,0.0,0.0
2024,1,16,2,2024-01-16,YX,5064,TPA,CLT,"Tampa, FL",Florida,"Charlotte, NC",North Carolina,1623,647,-22,-20,1601,627,13,19,1614,608,412,48,68,80,0,,0,0.0,0.0,0.0,0.0,0.0
2024,3,17,7,2024-03-17,NK,2541,LAX,STL,"Los Angeles, CA",California,"St. Louis, MO",Missouri,2120,828,2,5,2122,833,26,14,2148,819,856,100,120,140,0,,0,0.0,0.0,0.0,0.0,0.0
2024,10,19,6,2024-10-19,AS,5977,DFW,LGA,"Dallas/Fort Worth, TX",Texas,"New York, NY",New York,1483,2348,6,5,1489,2353,21,19,1510,2334,2025,250,270,290,0,,0,0.0,0.0,0.0,0.0,0.0
2024,3,21,4,2024-03-21,UA,2620,STL,IAD,"St. Louis, MO",Missouri,"Washington, DC",District of Columbia,1224,2351,-6,-5,1218,2346,24,18,1242,2328,1313,155,175,197,0,,0,0.0,0.0,0.0,0.0,0.0
2024,5,3,5,2024-05-03,B6,4508,TPA,LAX,"Tampa, FL",Florida,"Los Angeles, CA",California,2299,1589,1,5,2300,1594,21,3,2321,1591,2749,333,353,357,0,,0,0.0,0.0,0.0,0.0,0.0
2024,1,19,5,2024-01-19,G4,9753,LAX,SFO,"Los Angeles, CA",California,"San Francisco, CA",California,1481,1280,-14,-10,1467,1270,7,7,1474,1263,1113,142,162,156,0,,0,0.0,0.0,0.0,0.0,0.0
2024,4,11,4,2024-04-11,NK,1051,MCO,DEN,"Orlando, FL",Florida,"Denver, CO",Colorado,1097,1645,6,0,1103,1645,19,7,1122,1638,1837,222,242,248,0,,0,0.0,0.0,0.0,0.0,0.0
2024,3,17,7,2024-03-17,YX,1064,TPA,MCO,"Tampa, FL",Florida,"Orlando, FL",Florida,2098,1898,-1,5,2097,1903,14,18,2111,1885,1824,235,255,267,0,,0,0.0,0.0,0.0,0.0,0.0
2024,8,16,5,2024-08-16,WN,2234,MSP,LGA,"Minneapolis, MN",Minnesota,"New York, NY",New York,1970,1736,4,5,1974,1741,26,4,2000,1737,2170,274,294,304,0,,0,0.0,0.0,0.0,0.0,0.0
2024,10,23,3,2024-10-23,NK,4554,STL,DFW,"St. Louis, MO",Missouri,"Dallas/Fort Worth, TX",Texas,1715,1497,39,30,1754,1527,23,9,1777,1518,425,47,67,79,0,,0,5.0,7.0,1.0,0.0,17.0
2024,7,21,7,2024-07-21,B6,8986,SFO,MDW,"San Francisco, CA",California,"Chicago, IL",Illinois,913,2338,-6,-10,907,2328,9,18,916,2310,835,94,114,121,0,,0,0.0,0.0,0.0,0.0,0.0
2024,3,1,5,2024-03-01,OO,2344,JFK,MIA,"New York, NY",New York,"Miami, FL",Florida,2005,2168,2,0,2007,2168,28,5,2035,2163,249,23,43,56,0,,0,0.0,0.0,0.0,0.0,0.0
2024,1,26,5,2024-01-26,MQ,2903,LAS,DEN,"Las Vegas, NV",Nevada,"Denver, CO",Colorado,592,1568,13,10,605,1578,28,12,633,1566,759,99,119,139,0,,0,0.0,0.0,0.0,0.0,0.0
2024,3,11,1,2024-03-11,HA,4011,BOS,MCO,"Boston, MA",Massachusetts,"Orlando, FL",Florida,1776,1554,6,0,1782,1554,17,4,1799,1550,1524,183,203,204,0,,0,0.0,0.0,0.0,0.0,0.0
2024,4,12,5,2024-04-12,DL,1508,SAN,TPA,"San Diego, CA",California,"Tampa, FL",Florida,2173,1712,6,10,2179,1722,29,17,2208,1705,2326,293,313,339,0,,0,0.0,0.0,0.0,0.0,0.0
2024,11,21,4,2024-11-21,MQ,5337,IAH,HNL,"Houston, TX",Texas,"Honolulu, HI",Hawaii,1464,1245,-12,-5,1452,1240,8,18,1460,1222,2078,264,284,290,0,,0,0.0,0.0,0.0,0.0,0.0
2024,12,28,6,2024-12-28,AS,4693,DFW,EWR,"Dallas/Fort Worth, TX",Texas,"Newark, NJ",New Jersey,1060,610,3,5,1063,615,18,10,1081,605,1780,218,238,246,0,,0,0.0,0.0,0.0,0.0,0.0
2024,6,5,3,2024-06-05,NK,8151,MIA,TPA,"Miami, FL",Florida,"Tampa, FL",Florida,2156,1650,18,10,2174,1660,25,10,2199,1650,1037,129,149,164,0,,0,0.0,0.0,0.0,0.0,0.0
2024,12,28,6,2024-12-28,F9,8753,BWI,CLT,"Baltimore, MD",Maryland,"Charlotte, NC",North Carolina,1562,1055,13,10,1575,1065,24,19,1599,1046,1070,125,145,168,0,,0,0.0,0.0,0.0,0.0,0.0
2024,12,24,2,2024-12-24,AS,7763,STL,CLT,"St. Louis, MO",Missouri,"Charlotte, NC",North Carolina,1045,1654,2,10,1047,1664,11,16,1058,1648,2178,276,296,303,0,,0,0.0,0.0,0.0,0.0,0.0
2024,7,12,5,2024-07-12,F9,9909,TPA,MCO,"Tampa, FL",Florida,"Orlando, FL",Florida,1881,1202,-17,-10,1864,1192,29,18,1893,1174,833,101,121,148,0,,0,0.0,0.0,0.0,0.0,0.0
2024,10,1,2,2024-10-01,NK,7213,SAN,CLT,"San Diego, CA",California,"Charlotte, NC",North Carolina,1277,2070,-14,-5,1263,2065,10,8,1273,2057,2694,345,365,363,0,,0,0.0,0.0,0.0,0.0,0.0
2024,11,19,2,2024-11-19,DL,8242,JFK,MCO,"New York, NY",New York,"Orlando, FL",Florida,1532,2051,-13,-10,1519,2041,15,19,1534,2022,1822,229,249,263,0,,0,0.0,0.0,0.0,0.0,0.0
2024,7,4,4,2024-07-04,OH,6477,BOS,ATL,"Boston, MA",Massachusetts,"Atlanta, GA",Georgia,687,2304,-19,-10,668,2294,15,6,683,2288,1865,240,260,261,0,,0,0.0,0.0,0.0,0.0,0.0
2024,11,21,4,2024-11-21,AS,8708,CLT,DCA,"Charlotte, NC",North Carolina,"Washington, DC",District of Columbia,1107,2182,-7,0,1100,2182,22,9,1122,2173,1056,123,143,154,0,,0,0.0,0.0,0.0,0.0,0.0
2024,4,22,1,2024-04-22,G4,5701,STL,MSP,"St. Louis, MO",Missouri,"Minneapolis, MN",Minnesota,1144,1564,11,20,1155,1584,11,10,1166,1574,1203,140,160,161,0,,0,6.0,3.0,1.0,0.0,10.0
2024,11,8,5,2024-11-08,YX,1488,MDW,TPA,"Chicago, IL",Illinois,"Tampa, FL",Florida,1174,1190,-7,0,1167,1190,23,8,1190,1182,2834,360,380,391,0,,0,0.0,0.0,0.0,0.0,0.0
2024,6,13,4,2024-06-13,AS,6396,DFW,BOS,"Dallas/Fort Worth, TX",Texas,"Boston, MA",Massachusetts,638,1113,8,10,646,1123,28,14,674,1109,740,98,118,140,0,,0,0.0,0.0,0.0,0.0,0.0
2024,3,1,5,2024-03-01,WN,4467,BOS,EWR,"Boston, MA",Massachusetts,"Newark, NJ",New Jersey,797,998,6,15,803,1013,7,8,810,1005,259,30,50,45,0,,0,0.0,0.0,0.0,0.0,0.0
2024,4,1,1,2024-04-01,NK,4078,MDW,PHX,"Chicago, IL",Illinois,"Phoenix, AZ",Arizona,1603,2155,-6,-15,1597,2140,13,16,1610,2124,1292,169,189,198,0,,0,0.0,0.0,0.0,0.0,0.0
2024,10,12,6,2024-10-12,UA,4590,STL,SFO,"St. Louis, MO",Missouri,"San Francisco, CA",California,2126,986,-4,-10,2122,976,18,19,2140,957,1900,233,253,270,0,,0,0.0,0.0,0.0,0.0,0.0
2024,6,1,6,2024-06-01,B6,952,DCA,IAH,"Washington, DC",District of Columbia,"Houston, TX",Texas,1779,1217,-20,-10,1759,1207,21,14,1780,1193,795,100,120,135,0,,0,0.0,0.0,0.0,0.0,0.0
2024,8,12,1,2024-08-12,AA,6477,PHX,IAD,"Phoenix, AZ",Arizona,"Washington, DC",District of Columbia,2183,1953,-5,0,2178,1953,26,4,2204,1949,979,122,142,152,0,,0,0.0,0.0,0.0,0.0,0.0
2024,5,6,1,2024-05-06,HA,6601,MIA,IAD,"Miami, FL",Florida,"Washington, DC",District of Columbia,678,2225,-10,-15,668,2210,27,15,695,2195,1222,153,173,195,0,,0,0.0,0.0,0.0,0.0,0.0
2024,7,11,4,2024-07-11,9E,8214,PDX,JFK,"Portland, OR",Oregon,"New York, NY",New York,1780,737,-2,5,1778,742,7,7,1785,735,540,71,91,85,0,,0,0.0,0.0,0.0,0.0,0.0
2024,4,24,3,2024-04-24,UA,8528,MIA,HNL,"Miami, FL",Florida,"Honolulu, HI",Hawaii,717,2303,-21,-15,696,2288,10,8,706,2280,1900,233,253,251,0,,0,0.0,0.0,0.0,0.0,0.0
2024,9,18,3,2024-09-18,F9,1156,LGA,STL,"New York, NY",New York,"St. Louis, MO",Missouri,766,1252,-16,-10,750,1242,15,3,765,1239,1921,242,262,260,0,,0,0.0,0.0,0.0,0.0,0.0
2024,1,18,4,2024-01-18,G4,2360,TPA,PDX,"Tampa, FL",Florida,"Portland, OR",Oregon,1840,2348,-7,-5,1833,2343,17,10,1850,2333,2814,354,374,381,0,,0,0.0,0.0,0.0,0.0,0.0
2024,1,10,3,2024-01-10,G4,9317,DCA,BWI,"Washington, DC",District of Columbia,"Baltimore, MD",Maryland,1090,1081,-6,0,1084,1081,18,11,1102,1070,1593,199,219,228,0,,0,0.0,0.0,0.0,0.0,0.0
2024,4,1,1,2024-04-01,HA,1008,TPA,ATL,"Tampa, FL",Florida,"Atlanta, GA",Georgia,1178,899,1,10,1179,909,7,14,1186,895,1756,225,245,246,0,,0,0.0,0.0,0.0,0.0,0.0
2024,5,18,6,2024-05-18,9E,549,HNL,SEA,"Honolulu, HI",Hawaii,"Seattle, WA",Washington,1115,631,16,20,1131,651,13,12,1144,639,1699,216,236,241,0,,0,0.0,2.0,1.0,0.0,17.0
2024,11,28,4,2024-11-28,DL,668,DFW,PDX,"Dallas/Fort Worth, TX",Texas,"Portland, OR",Oregon,1349,1056,14,10,1363,1066,10,5,1373,1061,2639,326,346,341,0,,0,0.0,0.0,0.0,0.0,0.0
2024,12,22,7,2024-12-22,WN,3598,EWR,MIA,"Newark, NJ",New Jersey,"Miami, FL",Florida,1807,1141,-18,-15,1789,1126,15,12,1804,1114,2613,317,337,344,0,,0,0.0,0.0,0.0,0.0,0.0
2024,12,5,4,2024-12-05,B6,5970,TPA,EWR,"Tampa, FL",Florida,"Newark, NJ",New Jersey,1868,2008,-8,0,1860,2008,12,16,1872,1992,1574,200,220,228,0,,0,0.0,0.0,0.0,0.0,0.0
2024,2,21,3,2024-02-21,HA,1408,SLC,IAD,"Salt Lake City, UT",Utah,"Washington, DC",District of Columbia,1226,1955,-5,-5,1221,1950,24,7,1245,1943,1410,180,200,211,0,,0,0.0,0.0,0.0,0.0,0.0
2024,7,13,6,2024-07-13,UA,817,IAH,DEN,"Houston, TX",Texas,"Denver, CO",Colorado,574,643,-16,-15,558,628,12,7,570,621,2372,298,318,317,0,,0,0.0,0.0,0.0,0.0,0.0
2024,7,24,3,2024-07-24,MQ,9261,PHL,SAN,"Philadelphia, PA",Pennsylvania,"San Diego, CA",California,1236,1146,-7,0,1229,1146,25,15,1254,1131,540,61,81,101,0,,0,0.0,0.0,0.0,0.0,0.0
2024,10,13,7,2024-10-13,OO,3445,MIA,PHX,"Miami, FL",Florida,"Phoenix, AZ",Arizona,835,1583,-4,-5,831,1578,19,19,850,1559,2945,372,392,410,0,,0,0.0,0.0,0.0,0.0,0.0
2024,4,2,2,2024-04-02,AA,7314,MIA,DCA,"Miami, FL",Florida,"Washington, DC",District of Columbia,1303,1023,-3,-5,1300,1018,19,12,1319,1006,824,95,115,126,0,,0,0.0,0.0,0.0,0.0,0.0
2024,11,4,1,2024-11-04,AS,7782,EWR,SAN,"Newark, NJ",New Jersey,"San Diego, CA",California,1354,644,-19,-15,1335,629,12,4,1347,625,353,49,69,65,0,,0,0.0,0.0,0.0,0.0,0.0
2024,5,24,5,2024-05-24,OH,2818,DFW,SFO,"Dallas/Fort Worth, TX",Texas,"San Francisco, CA",California,2105,979,28,20,2133,999,17,17,2150,982,1748,217,237,251,0,,0,5.0,5.0,0.0,0.0,10.0
2024,3,26,2,2024-03-26,HA,9195,PHX,MDW,"Phoenix, AZ",Arizona,"Chicago, IL",Illinois,862,1096,10,5,872,1101,19,15,891,1086,440,54,74,88,0,,0,0.0,0.0,0.0,0.0,0.0
2024,6,1,6,2024-06-01,9E,9742,IAD,SLC,"Washington, DC",District of Columbia,"Salt Lake City, UT",Utah,689,1483,-11,-10,678,1473,20,7,698,1466,2408,306,326,333,0,,0,0.0,0.0,0.0,0.0,0.0
2024,1,2,2,2024-01-02,DL,1555,CLT,SFO,"Charlotte, NC",North Carolina,"San Francisco, CA",California,1995,1558,11,15,2006,1573,6,19,2012,1554,2278,290,310,315,0,,0,0.0,0.0,0.0,0.0,0.0
2024,12,7,6,2024-12-07,G4,7397,LGA,PHX,"New York, NY",New York,"Phoenix, AZ",Arizona,1629,737,7,15,1636,752,7,7,1643,745,1800,222,242,236,0,,0,0.0,0.0,0.0,0.0,0.0
2024,9,16,1,2024-09-16,AA,7135,SEA,DCA,"Seattle, WA",Washington,"Washington, DC",District of Columbia,569,2182,1,10,570,2192,20,16,590,2176,2429,310,330,346,0,,0,0.0,0.0,0.0,0.0,0.0
2024,6,12,3,2024-06-12,OO,4330,STL,DEN,"St. Louis, MO",Missouri,"Denver, CO",Colorado,1021,1007,-5,5,1016,1012,14,12,1030,1000,814,94,114,120,0,,0,0.0,0.0,0.0,0.0,0.0
2024,1,6,6,2024-01-06,G4,631,SFO,SLC,"San Francisco, CA",California,"Salt Lake City, UT",Utah,1737,784,0,-5,1737,779,24,17,1761,762,2876,351,371,392,0,,0,0.0,0.0,0.0,0.0,0.0
2024,5,28,2,2024-05-28,NK,2367,MIA,DFW,"Miami, FL",Florida,"Dallas/Fort Worth, TX",Texas,1482,1088,-3,-5,1479,1083,5,4,1484,1079,2390,307,327,316,0,,0,0.0,0.0,0.0,0.0,0.0
2024,7,23,2,2024-07-23,OO,432,TPA,MDW,"Tampa, FL",Florida,"Chicago, IL",Illinois,1016,617,-8,0,1008,617,9,7,1017,610,1563,186,206,202,0,,0,0.0,0.0,0.0,0.0,0.0
2024,4,27,6,2024-04-27,MQ,5349,PHL,BOS,"Philadelphia, PA",Pennsylvania,"Boston, MA",Massachusetts,527,2320,18,15,545,2335,7,8,552,2327,1403,169,189,184,0,,0,0.0,0.0,0.0,0.0,0.0
2024,3,29,5,2024-03-29,9E,7299,MDW,MIA,"Chicago, IL",Illinois,"Miami, FL",Florida,1838,1695,12,5,1850,1700,11,15,1861,1685,299,37,57,63,0,,0,0.0,0.0,0.0,0.0,0.0
2024,6,2,7,2024-06-02,DL,5821,HNL,ORD,"Honolulu, HI",Hawaii,"Chicago, IL",Illinois,1404,1234,-10,-10,1394,1224,22,10,1416,1214,1394,178,198,210,0,,0,0.0,0.0,0.0,0.0,0.0
2024,6,15,6,2024-06-15,OH,9613,HNL,TPA,"Honolulu, HI",Hawaii,"Tampa, FL",Florida,2276,770,8,0,2284,770,18,15,2302,755,2003,258,278,291,0,,0,0.0,0.0,0.0,0.0,0.0
2024,6,9,7,2024-06-09,AS,8112,SAN,DCA,"San Diego, CA",California,"Washington, DC",District of Columbia,2030,1700,-8,0,2022,1700,18,16,2040,1684,2764,351,371,385,0,,0,0.0,0.0,0.0,0.0,0.0
2024,9,26,4,2024-09-26,F9,8028,CLT,JFK,"Charlotte, NC",North Carolina,"New York, NY",New York,1759,999,19,10,1778,1009,18,18,1796,991,2226,287,307,323,0,,0,0.0,0.0,0.0,0.0,0.0
2024,2,25,7,2024-02-25,HA,6600,DFW,TPA,"Dallas/Fort Worth, TX",Texas,"Tampa, FL",Florida,591,1509,-24,-15,567,1494,5,3,572,1491,1357,176,196,184,0,,0,0.0,0.0,0.0,0.0,0.0
2024,8,15,4,2024-08-15,DL,500,EWR,STL,"Newark, NJ",New Jersey,"St. Louis, MO",Missouri,862,2144,0,5,862,2149,22,7,884,2142,628,82,102,111,0,,0,0.0,0.0,0.0,0.0,0.0
2024,12,2,1,2024-12-02,HA,7139,PDX,DCA,"Portland, OR",Oregon,"Washington, DC",District of Columbia,537,1824,-12,-5,525,1819,7,10,532,1809,750,89,109,106,0,,0,0.0,0.0,0.0,0.0,0.0
2024,5,28,2,2024-05-28,B6,4091,TPA,ORD,"Tampa, FL",Florida,"Chicago, IL",Illinois,2254,2204,-13,-15,2241,2189,25,4,2266,2185,438,61,81,90,0,,0,0.0,0.0,0.0,0.0,0.0
2024,2,15,4,2024-02-15,MQ,9770,JFK,SLC,"New York, NY",New York,"Salt Lake City, UT",Utah,1163,838,2,5,1165,843,26,5,1191,838,957,126,146,157,0,,0,0.0,0.0,0.0,0.0,0.0
2024,5,23,4,2024-05-23,YX,1157,TPA,ATL,"Tampa, FL",Florida,"Atlanta, GA",Georgia,1203,1940,-1,-5,1202,1935,28,4,1230,1931,2066,258,278,290,0,,0,0.0,0.0,0.0,0.0,0.0
2024,8,25,7,2024-08-25,OO,8033,EWR,LAX,"Newark, NJ",New Jersey,"Los Angeles, CA",California,2156,2146,-5,5,2151,2151,17,13,2168,2138,1698,209,229,239,0,,0,0.0,0.0,0.0,0.0,0.0
2024,9,28,6,2024-09-28,AS,3093,HNL,TPA,"Honolulu, HI",Hawaii,"Tampa, FL",Florida,990,919,-5,-10,985,909,24,6,1009,903,2775,355,375,385,0,,0,0.0,0.0,0.0,0.0,0.0
2024,4,29,1,2024-04-29,UA,8333,IAD,BWI,"Washington, DC",District of Columbia,"Baltimore, MD",Maryland,2206,2173,39,30,2245,2203,19,16,2264,2187,1076,130,150,165,0,,0,9.0,7.0,4.0,0.0,10.0
2024,12,5,4,2024-12-05,OH,126,SFO,JFK,"San Francisco, CA",California,"New York, NY",New York,1633,1121,4,10,1637,1131,24,16,1661,1115,2205,272,292,312,0,,0,0.0,0.0,0.0,0.0,0.0
2024,8,7,3,2024-08-07,YX,3633,HNL,PDX,"Honolulu, HI",Hawaii,"Portland, OR",Oregon,643,1127,-8,-10,635,1117,22,12,657,1105,359,47,67,81,0,,0,0.0,0.0,0.0,0.0,0.0
2024,1,8,1,2024-01-08,DL,2718,SFO,ATL,"San Francisco, CA",California,"Atlanta, GA",Georgia,2101,1076,11,5,2112,1081,7,6,2119,1075,1504,179,199,192,0,,0,0.0,0.0,0.0,0.0,0.0
2024,12,9,1,2024-12-09,HA,9462,LAS,IAH,"Las Vegas, NV",Nevada,"Houston, TX",Texas,1333,1948,-24,-15,1309,1933,23,9,1332,1924,2073,258,278,290,0,,1,0.0,0.0,0.0,0.0,0.0
2024,10,1,2,2024-10-01,OO,6739,SEA,HNL,"Seattle, WA",Washington,"Honolulu, HI",Hawaii,1720,2089,7,5,1727,2094,19,12,1746,2082,282,40,60,71,0,,0,0.0,0.0,0.0,0.0,0.0
2024,12,18,3,2024-12-18,AS,6729,MDW,DFW,"Chicago, IL",Illinois,"Dallas/Fort Worth, TX",Texas,1569,1358,-24,-15,1545,1343,22,5,1567,1338,1770,230,250,257,0,,0,0.0,0.0,0.0,0.0,0.0
2024,3,6,3,2024-03-06,UA,7727,DEN,TPA,"Denver, CO",Colorado,"Tampa, FL",Florida,1672,641,-5,-5,1667,636,5,7,1672,629,1909,246,266,258,0,,0,0.0,0.0,0.0,0.0,0.0
2024,3,19,2,2024-03-19,DL,7142,MSP,DTW,"Minneapolis, MN",Minnesota,"Detroit, MI",Michigan,2095,833,24,20,2119,853,22,6,2141,847,2183,267,287,295,0,,0,7.0,1.0,1.0,0.0,11.0
2024,3,26,2,2024-03-26,HA,9002,LGA,MSP,"New York, NY",New York,"Minneapolis, MN",Minnesota,637,1155,-17,-15,620,1140,9,19,629,1121,226,23,43,51,0,,0,0.0,0.0,0.0,0.0,0.0
2024,5,3,5,2024-05-03,AA,2118,CLT,EWR,"Charlotte, NC",North Carolina,"Newark, NJ",New Jersey,989,1036,8,0,997,1036,28,13,1025,1023,2713,336,356,377,0,,0,0.0,0.0,0.0,0.0,0.0
2024,7,20,6,2024-07-20,OH,4978,MSP,MCO,"Minneapolis, MN",Minnesota,"Orlando, FL",Florida,901,1275,-22,-15,879,1260,25,7,904,1253,1236,155,175,187,0,,0,0.0,0.0,0.0,0.0,0.0
2024,5,29,3,2024-05-29,F9,2998,LAX,SAN,"Los Angeles, CA",California,"San Diego, CA",California,1101,2285,11,5,1112,2290,16,14,1128,2276,2099,268,288,298,0,,0,0.0,0.0,0.0,0.0,0.0
2024,2,15,4,2024-02-15,AA,6175,TPA,SFO,"Tampa, FL",Florida,"San Francisco, CA",California,1223,1903,-6,-10,1217,1893,23,16,1240,1877,2662,326,346,365,0,,0,0.0,0.0,0.0,0.0,0.0
2024,4,22,1,2024-04-22,YX,2147,MSP,SEA,"Minneapolis, MN",Minnesota,"Seattle, WA",Washington,1180,1827,-9,-5,1171,1822,27,15,1198,1807,2876,360,380,402,0,,0,0.0,0.0,0.0,0.0,0.0
2024,3,31,7,2024-03-31,HA,5302,ATL,TPA,"Atlanta, GA",Georgia,"Tampa, FL",Florida,1431,1342,-3,-5,1428,1337,24,13,1452,1324,2698,329,349,366,0,,0,0.0,0.0,0.0,0.0,0.0
2024,5,20,1,2024-05-20,B6,1658,LAX,PDX,"Los Angeles, CA",California,"Portland, OR",Oregon,1124,1507,-13,-10,1111,1497,27,14,1138,1483,230,30,50,71,0,,0,0.0,0.0,0.0,0.0,0.0
2024,10,15,2,2024-10-15,OO,1822,EWR,SAN,"Newark, NJ",New Jersey,"San Diego, CA",California,840,1402,5,15,845,1417,28,9,873,1408,2463,305,325,342,0,,0,0.0,0.0,0.0,0.0,0.0
2024,8,5,1,2024-08-05,AS,4152,EWR,DTW,"Newark, NJ",New Jersey,"Detroit, MI",Michigan,2101,1929,13,15,2114,1944,23,3,2137,1941,389,40,60,66,0,,0,0.0,0.0,0.0,0.0,0.0
2024,3,17,7,2024-03-17,OO,1751,DFW,JFK,"Dallas/Fort Worth, TX",Texas,"New York, NY",New York,801,1450,17,10,818,1460,5,11,823,1449,1516,188,208,204,0,,0,0.0,0.0,0.0,0.0,0.0
2024,11,29,5,2024-11-29,YX,5322,DTW,SEA,"Detroit, MI",Michigan,"Seattle, WA",Washington,617,1596,-9,-15,608,1581,28,6,636,1575,2909,364,384,398,0,,0,0.0,0.0,0.0,0.0,0.0
2024,5,31,5,2024-05-31,YX,1878,LGA,DEN,"New York, NY",New York,"Denver, CO",Colorado,2260,1445,-4,-10,2256,1435,26,6,2282,1429,1576,192,212,224,0,,0,0.0,0.0,0.0,0.0,0.0
2024,11,18,1,2024-11-18,UA,783,LAX,JFK,"Los Angeles, CA",California,"New York, NY",New York,650,1109,-3,0,647,1109,7,13,654,1096,2309,279,299,299,0,,0,0.0,0.0,0.0,0.0,0.0
2024,8,26,1,2024-08-26,OH,9571,LAX,ATL,"Los Angeles, CA",California,"Atlanta, GA",Georgia,1690,1919,12,20,1702,1939,29,8,1731,1931,1841,239,259,276,0,,0,0.0,1.0,1.0,0.0,18.0
2024,4,24,3,2024-04-24,NK,2110,BOS,SAN,"Boston, MA",Massachusetts,"San Diego, CA",California,1106,621,0,0,1106,621,5,13,1111,608,405,57,77,75,0,,0,0.0,0.0,0.0,0.0,0.0
2024,11,14,4,2024-11-14,DL,9507,CLT,SLC,"Charlotte, NC",North Carolina,"Salt Lake City, UT",Utah,1271,2310,-14,-5,1257,2305,28,19,1285,2286,2774,344,364,391,0,,0,0.0,0.0,0.0,0.0,0.0
2024,4,3,3,2024-04-03,NK,2682,SEA,JFK,"Seattle, WA",Washington,"New York, NY",New York,1948,1607,1,10,1949,1617,29,16,1978,1601,2751,346,366,391,0,,0,0.0,0.0,0.0,0.0,0.0
2024,2,17,6,2024-02-17,DL,8605,IAD,MIA,"Washington, DC",District of Columbia,"Miami, FL",Florida,2294,841,-10,-15,2284,826,21,16,2305,810,996,125,145,162,0,,0,0.0,0.0,0.0,0.0,0.0
2024,7,9,2,2024-07-09,B6,7543,MIA,BWI,"Miami, FL",Florida,"Baltimore, MD",Maryland,1496,1442,16,10,1512,1452,13,15,1525,1437,737,97,117,125,0,,0,0.0,0.0,0.0,0.0,0.0
2024,1,12,5,2024-01-12,NK,5592,ATL,IAD,"Atlanta, GA",Georgia,"Washington, DC",District of Columbia,936,1177,18,20,954,1197,9,11,963,1186,1867,240,260,260,0,,0,2.0,3.0,3.0,0.0,12.0
2024,6,4,2,2024-06-04,OO,543,DCA,JFK,"Washington, DC",District of Columbia,"New York, NY",New York,1131,2017,10,20,1141,2037,9,13,1150,2024,2944,361,381,383,0,,0,5.0,4.0,3.0,0.0,8.0
2024,6,20,4,2024-06-20,OO,1771,PHL,BWI,"Philadelphia, PA",Pennsylvania,"Baltimore, MD",Maryland,1597,2050,-14,-15,1583,2035,15,19,1598,2016,2275,288,308,322,0,,0,0.0,0.0,0.0,0.0,0.0
2024,10,22,2,2024-10-22,OH,3366,DFW,ORD,"Dallas/Fort Worth, TX",Texas,"Chicago, IL",Illinois,861,1052,-5,0,856,1052,25,18,881,1034,2374,303,323,346,0,,0,0.0,0.0,0.0,0.0,0.0
2024,6,25,2,2024-06-25,UA,7525,DEN,CLT,"Denver, CO",Colorado,"Charlotte, NC",North Carolina,595,1106,0,0,595,1106,21,17,616,1089,1720,211,231,249,0,,0,0.0,0.0,0.0,0.0,0.0
2024,12,6,5,2024-12-06,OH,6009,LGA,STL,"New York, NY",New York,"St. Louis, MO",Missouri,791,2229,-15,-10,776,2219,20,16,796,2203,2794,349,369,385,0,,0,0.0,0.0,0.0,0.0,0.0
2024,2,26,1,2024-02-26,OO,7114,IAD,MCO,"Washington, DC",District of Columbia,"Orlando, FL",Florida,1700,812,9,0,1709,812,9,17,1718,795,615,80,100,106,0,,0,0.0,0.0,0.0,0.0,0.0
2024,12,8,7,2024-12-08,WN,5579,BWI,SEA,"Baltimore, MD",Maryland,"Seattle, WA",Washington,526,1864,-6,0,520,1864,16,14,536,1850,2421,305,325,335,0,,0,0.0,0.0,0.0,0.0,0.0
2024,12,5,4,2024-12-05,AA,7919,DFW,SFO,"Dallas/Fort Worth, TX",Texas,"San Francisco, CA",California,1320,1592,-3,-5,1317,1587,18,12,1335,1575,1317,165,185,195,0,,0,0.0,0.0,0.0,0.0,0.0
2024,7,21,7,2024-07-21,UA,5241,JFK,MSP,"New York, NY",New York,"Minneapolis, MN",Minnesota,804,1008,-15,-5,789,1003,14,10,803,993,528,75,95,99,0,,0,0.0,0.0,0.0,0.0,0.0
2024,7,3,3,2024-07-03,G4,815,DFW,HNL,"Dallas/Fort Worth, TX",Texas,"Honolulu, HI",Hawaii,1222,1221,-10,-15,1212,1206,17,16,1229,1190,1094,127,147,160,0,,0,0.0,0.0,0.0,0.0,0.0
2024,4,30,2,2024-04-30,9E,991,LAS,SFO,"Las Vegas, NV",Nevada,"San Francisco, CA",California,1369,1158,28,20,1397,1178,19,3,1416,1175,1911,238,258,260,0,,0,4.0,2.0,3.0,0.0,11.0
2024,8,13,2,2024-08-13,B6,3907,SLC,IAD,"Salt Lake City, UT",Utah,"Washington, DC",District of Columbia,1268,1471,10,10,1278,1481,10,18,1288,1463,2002,247,267,275,0,,0,0.0,0.0,0.0,0.0,0.0
2024,7,20,6,2024-07-20,HA,600,SAN,SFO,"San Diego, CA",California,"San Francisco, CA",California,1485,1267,-4,5,1481,1272,9,7,1490,1265,1373,161,181,177,0,,0,0.0,0.0,0.0,0.0,0.0
2024,11,25,1,2024-11-25,HA,2740,PDX,LAS,"Portland, OR",Oregon,"Las Vegas, NV",Nevada,1441,1191,-30,-20,1411,1171,20,10,1431,1161,1068,134,154,164,0,,0,0.0,0.0,0.0,0.0,0.0
2024,12,28,6,2024-12-28,F9,9645,STL,ORD,"St. Louis, MO",Missouri,"Chicago, IL",Illinois,704,1668,2,0,706,1668,10,4,716,1664,2462,300,320,314,0,,0,0.0,0.0,0.0,0.0,0.0
2024,12,21,6,2024-12-21,DL,8994,PHL,SEA,"Philadelphia, PA",Pennsylvania,"Seattle, WA",Washington,1366,1306,-4,-10,1362,1296,29,5,1391,1291,1700,220,240,254,0,,0,0.0,0.0,0.0,0.0,0.0
2024,8,3,6,2024-08-03,UA,2433,IAD,TPA,"Washington, DC",District of Columbia,"Tampa, FL",Florida,1514,1860,8,5,1522,1865,27,10,1549,1855,1344,166,186,203,0,,0,0.0,0.0,0.0,0.0,0.0
2024,2,12,1,2024-02-12,NK,2294,TPA,STL,"Tampa, FL",Florida,"St. Louis, MO",Missouri,1077,1322,6,0,1083,1322,15,5,1098,1317,1025,137,157,157,0,,0,0.0,0.0,0.0,0.0,0.0
2024,1,23,2,2024-01-23,OH,7037,ATL,MDW,"Atlanta, GA",Georgia,"Chicago, IL",Illinois,1161,1379,9,10,1170,1389,25,10,1195,1379,1906,232,252,267,0,,0,0.0,0.0,0.0,0.0,0.0
2024,6,3,1,2024-06-03,9E,8675,LGA,DTW,"New York, NY",New York,"Detroit, MI",Michigan,1178,2218,-4,-10,1174,2208,13,7,1187,2201,2615,318,338,338,0,,0,0.0,0.0,0.0,0.0,0.0
2024,7,4,4,2024-07-04,WN,9177,JFK,MDW,"New York, NY",New York,"Chicago, IL",Illinois,719,1736,-18,-20,701,1716,25,12,726,1704,1613,201,221,238,0,,0,0.0,0.0,0.0,0.0,0.0
2024,9,5,4,2024-09-05,G4,1691,ORD,PHX,"Chicago, IL",Illinois,"Phoenix, AZ",Arizona,799,1106,10,15,809,1121,9,13,818,1108,1948,234,254,256,0,,0,0.0,0.0,0.0,0.0,0.0
2024,8,24,6,2024-08-24,OH,5159,PDX,HNL,"Portland, OR",Oregon,"Honolulu, HI",Hawaii,757,2266,8,15,765,2281,15,6,780,2275,2122,262,282,283,0,,0,0.0,0.0,0.0,0.0,0.0
2024,10,19,6,2024-10-19,NK,4498,TPA,BWI,"Tampa, FL",Florida,"Baltimore, MD",Maryland,1214,1049,-7,0,1207,1049,10,12,1217,1037,796,103,123,125,0,,0,0.0,0.0,0.0,0.0,0.0
2024,5,13,1,2024-05-13,OH,4540,SEA,CLT,"Seattle, WA",Washington,"Charlotte, NC",North Carolina,739,2191,-12,-15,727,2176,28,7,755,2169,2617,335,355,370,0,,0,0.0,0.0,0.0,0.0,0.0
2024,11,16,6,2024-11-16,OO,1883,DTW,LGA,"Detroit, MI",Michigan,"New York, NY",New York,1752,1349,-7,0,1745,1349,21,14,1766,1335,2930,356,376,391,0,,0,0.0,0.0,0.0,0.0,0.0
2024,1,22,1,2024-01-22,YX,5485,PHL,DFW,"Philadelphia, PA",Pennsylvania,"Dallas/Fort Worth, TX",Texas,1997,1137,-6,0,1991,1137,13,12,2004,1125,1513,180,200,205,0,,0,0.0,0.0,0.0,0.0,0.0
2024,12,26,4,2024-12-26,AA,4217,PHL,EWR,"Philadelphia, PA",Pennsylvania,"Newark, NJ",New Jersey,1679,1832,13,10,1692,1842,12,14,1704,1828,458,58,78,84,0,,0,0.0,0.0,0.0,0.0,0.0
2024,3,28,4,2024-03-28,WN,7082,DFW,SFO,"Dallas/Fort Worth, TX",Texas,"San Francisco, CA",California,717,1913,9,5,726,1918,11,7,737,1911,1396,174,194,192,0,,0,0.0,0.0,0.0,0.0,0.0
2024,6,1,6,2024-06-01,9E,2683,SEA,CLT,"Seattle, WA",Washington,"Charlotte, NC",North Carolina,964,1097,-18,-15,946,1082,9,13,955,1069,2036,252,272,274,0,,0,0.0,0.0,0.0,0.0,0.0
2024,5,4,6,2024-05-04,OO,8554,PDX,HNL,"Portland, OR",Oregon,"Honolulu, HI",Hawaii,694,1806,5,5,699,1811,21,3,720,1808,582,63,83,87,0,,0,0.0,0.0,0.0,0.0,0.0
2024,3,19,2,2024-03-19,AS,2530,MDW,ORD,"Chicago, IL",Illinois,"Chicago, IL",Illinois,769,2342,-19,-15,750,2327,27,7,777,2320,876,104,124,138,0,,0,0.0,0.0,0.0,0.0,0.0
2024,12,11,3,2024-12-11,AS,5769,SEA,PDX,"Seattle, WA",Washington,"Portland, OR",Oregon,2051,1315,-13,-15,2038,1300,13,16,2051,1284,1020,130,150,159,0,,0,0.0,0.0,0.0,0.0,0.0
2024,2,20,2,2024-02-20,9E,7160,PHX,STL,"Phoenix, AZ",Arizona,"St. Louis, MO",Missouri,2276,999,-2,-5,2274,994,23,4,2297,990,2636,338,358,365,0,,0,0.0,0.0,0.0,0.0,0.0
2024,8,3,6,2024-08-03,AS,8683,HNL,MSP,"Honolulu, HI",Hawaii,"Minneapolis, MN",Minnesota,2287,1831,-17,-15,2270,1816,16,12,2286,1804,1017,130,150,158,0,,0,0.0,0.0,0.0,0.0,0.0
2024,6,24,1,2024-06-24,B6,3036,CLT,DEN,"Charlotte, NC",North Carolina,"Denver, CO",Colorado,1062,2046,14,10,1076,2056,12,3,1088,2053,2194,268,288,283,0,,0,0.0,0.0,0.0,0.0,0.0
2024,12,23,1,2024-12-23,UA,8831,HNL,LGA,"Honolulu, HI",Hawaii,"New York, NY",New York,855,2013,-3,0,852,2013,20,15,872,1998,1159,144,164,179,0,,0,0.0,0.0,0.0,0.0,0.0
2024,9,9,1,2024-09-09,DL,9407,SLC,LAX,"Salt Lake City, UT",Utah,"Los Angeles, CA",California,1039,1989,-9,0,1030,1989,18,6,1048,1983,311,35,55,59,0,,0,0.0,0.0,0.0,0.0,0.0
2024,9,2,1,2024-09-02,UA,6809,SAN,LAS,"San Diego, CA",California,"Las Vegas, NV",Nevada,975,1183,1,0,976,1183,18,5,994,1178,728,85,105,108,0,,0,0.0,0.0,0.0,0.0,0.0
2024,8,14,3,2024-08-14,G4,9175,PHX,CLT,"Phoenix, AZ",Arizona,"Charlotte, NC",North Carolina,1064,2059,25,20,1089,2079,23,14,1112,2065,207,25,45,62,0,,0,6.0,0.0,0.0,0.0,14.0
2024,4,15,1,2024-04-15,UA,4423,SFO,LAX,"San Francisco, CA",California,"Los Angeles, CA",California,807,1520,12,15,819,1535,7,14,826,1521,2758,353,373,374,0,,0,0.0,0.0,0.0,0.0,0.0
2024,7,11,4,2024-07-11,UA,6716,ORD,MCO,"Chicago, IL",Illinois,"Orlando, FL",Florida,1127,1935,0,10,1127,1945,11,18,1138,1927,1245,151,171,180,0,,0,0.0,0.0,0.0,0.0,0.0
2024,11,11,1,2024-11-11,AA,2519,MIA,ORD,"Miami, FL",Florida,"Chicago, IL",Illinois,908,938,1,-5,909,933,10,16,919,917,2855,364,384,390,0,,0,0.0,0.0,0.0,0.0,0.0
2024,10,28,1,2024-10-28,DL,1499,BOS,DCA,"Boston, MA",Massachusetts,"Washington, DC",District of Columbia,1964,1770,-7,-15,1957,1755,9,10,1966,1745,994,118,138,137,0,,0,0.0,0.0,0.0,0.0,0.0
2024,2,5,1,2024-02-05,OO,9868,SAN,IAD,"San Diego, CA",California,"Washington, DC",District of Columbia,1020,2339,9,0,1029,2339,20,15,1049,2324,257,36,56,71,0,,0,0.0,0.0,0.0,0.0,0.0
2024,7,22,1,2024-07-22,YX,2184,SAN,MDW,"San Diego, CA",California,"Chicago, IL",Illinois,2046,1056,-3,-5,2043,1051,15,18,2058,1033,2406,305,325,338,0,,0,0.0,0.0,0.0,0.0,0.0
2024,9,23,1,2024-09-23,UA,7904,IAH,PDX,"Houston, TX",Texas,"Portland, OR",Oregon,984,2034,-6,-10,978,2024,27,17,1005,2007,770,94,114,138,0,,0,0.0,0.0,0.0,0.0,0.0
2024,9,24,2,2024-09-24,DL,7087,SLC,BWI,"Salt Lake City, UT",Utah,"Baltimore, MD",Maryland,2142,1244,-13,-15,2129,1229,29,16,2158,1213,1995,255,275,300,0,,0,0.0,0.0,0.0,0.0,0.0
2024,6,18,2,2024-06-18,F9,5256,EWR,PHL,"Newark, NJ",New Jersey,"Philadelphia, PA",Pennsylvania,1781,881,-13,-5,1768,876,5,7,1773,869,2350,291,311,303,0,,0,0.0,0.0,0.0,0.0,0.0
2024,2,8,4,2024-02-08,AS,5409,HNL,LAS,"Honolulu, HI",Hawaii,"Las Vegas, NV",Nevada,1193,1013,10,5,1203,1018,14,8,1217,1010,1957,252,272,274,0,,0,0.0,0.0,0.0,0.0,0.0
2024,5,18,6,2024-05-18,NK,1635,LGA,HNL,"New York, NY",New York,"Honolulu, HI",Hawaii,1429,2213,-2,0,1427,2213,21,19,1448,2194,1394,167,187,207,0,,0,0.0,0.0,0.0,0.0,0.0
2024,10,18,5,2024-10-18,AA,4853,CLT,DEN,"Charlotte, NC",North Carolina,"Denver, CO",Colorado,1693,1720,13,5,1706,1725,25,11,1731,1714,1596,193,213,229,0,,0,0.0,0.0,0.0,0.0,0.0
2024,2,21,3,2024-02-21,AS,8381,MCO,SLC,"Orlando, FL",Florida,"Salt Lake City, UT",Utah,1984,762,-3,0,1981,762,28,14,2009,748,1062,131,151,173,0,,0,0.0,0.0,0.0,0.0,0.0
2024,10,13,7,2024-10-13,DL,7148,JFK,BOS,"New York, NY",New York,"Boston, MA",Massachusetts,1150,1442,-8,-5,1142,1437,27,15,1169,1422,1027,131,151,173,0,,0,0.0,0.0,0.0,0.0,0.0
2024,10,15,2,2024-10-15,MQ,4290,LAS,LGA,"Las Vegas, NV",Nevada,"New York, NY",New York,1296,2060,3,0,1299,2060,11,19,1310,2041,2720,334,354,364,0,,0,0.0,0.0,0.0,0.0,0.0
2024,5,20,1,2024-05-20,HA,1754,DFW,ORD,"Dallas/Fort Worth, TX",Texas,"Chicago, IL",Illinois,610,1819,28,20,638,1839,7,9,645,1830,2239,278,298,294,0,,0,4.0,5.0,3.0,0.0,8.0
2024,5,25,6,2024-05-25,AS,7653,SEA,PDX,"Seattle, WA",Washington,"Portland, OR",Oregon,1103,2251,-18,-20,1085,2231,29,10,1114,2221,2497,304,324,343,1,,0,0.0,0.0,0.0,0.0,0.0
2024,11,9,6,2024-11-09,UA,7552,BOS,SFO,"Boston, MA",Massachusetts,"San Francisco, CA",California,719,760,-8,0,711,760,9,3,720,757,774,89,109,101,0,,0,0.0,0.0,0.0,0.0,0.0
2024,7,2,2,2024-07-02,NK,8657,SLC,CLT,"Salt Lake City, UT",Utah,"Charlotte, NC",North Carolina,1528,854,-11,-5,1517,849,16,14,1533,835,1112,134,154,164,0,,0,0.0,0.0,0.0,0.0,0.0
2024,5,31,5,2024-05-31,UA,4060,PHL,LAX,"Philadelphia, PA",Pennsylvania,"Los Angeles, CA",California,2055,1693,-18,-15,2037,1678,14,10,2051,1668,2342,296,316,320,0,,0,0.0,0.0,0.0,0.0,0.0
2024,7,19,5,2024-07-19,G4,6934,EWR,SEA,"Newark, NJ",New Jersey,"Seattle, WA",Washington,2136,1011,-10,-5,2126,1006,7,14,2133,992,2859,357,377,378,0,,0,0.0,0.0,0.0,0.0,0.0
2024,5,7,2,2024-05-07,UA,5191,PHX,MIA,"Phoenix, AZ",Arizona,"Miami, FL",Florida,1818,1313,-6,0,1812,1313,20,8,1832,1305,1589,207,227,235,0,,0,0.0,0.0,0.0,0.0,0.0
2024,10,13,7,2024-10-13,NK,618,IAH,TPA,"Houston, TX",Texas,"Tampa, FL",Florida,1981,635,1,0,1982,635,10,8,1992,627,1970,253,273,271,0,,0,0.0,0.0,0.0,0.0,0.0
2024,11,6,3,2024-11-06,YX,3810,SFO,HNL,"San Francisco, CA",California,"Honolulu, HI",Hawaii,1168,1928,-25,-20,1143,1908,20,9,1163,1899,216,30,50,59,0,,0,0.0,0.0,0.0,0.0,0.0
2024,9,9,1,2024-09-09,WN,929,DFW,LGA,"Dallas/Fort Worth, TX",Texas,"New York, NY",New York,1394,1329,-3,0,1391,1329,28,11,1419,1318,2362,285,305,324,0,,0,0.0,0.0,0.0,0.0,0.0
2024,9,22,7,2024-09-22,F9,6727,MSP,STL,"Minneapolis, MN",Minnesota,"St. Louis, MO",Missouri,1012,1069,-14,-10,998,1059,12,14,1010,1045,503,60,80,86,0,,0,0.0,0.0,0.0,0.0,0.0
2024,7,6,6,2024-07-06,OH,8562,JFK,PHX,"New York, NY",New York,"Phoenix, AZ",Arizona,1735,908,-2,-5,1733,903,24,8,1757,895,605,70,90,102,0,,0,0.0,0.0,0.0,0.0,0.0
2024,8,17,6,2024-08-17,DL,8088,IAD,STL,"Washington, DC",District of Columbia,"St. Louis, MO",Missouri,618,1820,-7,-5,611,1815,24,8,635,1807,2567,323,343,355,0,,0,0.0,0.0,0.0,0.0,0.0
2024,9,27,5,2024-09-27,F9,3086,DTW,DCA,"Detroit, MI",Michigan,"Washington, DC",District of Columbia,884,1080,16,10,900,1090,13,11,913,1079,1958,240,260,264,0,,0,0.0,0.0,0.0,0.0,0.0
2024,9,15,7,2024-09-15,G4,6875,JFK,SEA,"New York, NY",New York,"Seattle, WA",Washington,759,1959,-12,-20,747,1939,17,9,764,1930,613,82,102,108,0,,0,0.0,0.0,0.0,0.0,0.0
2024,10,25,5,2024-10-25,MQ,6790,CLT,MDW,"Charlotte, NC",North Carolina,"Chicago, IL",Illinois,1922,1303,-10,-5,1912,1298,6,6,1918,1292,2234,274,294,286,0,,0,0.0,0.0,0.0,0.0,0.0
2024,7,16,2,2024-07-16,F9,4914,DTW,STL,"Detroit, MI",Michigan,"St. Louis, MO",Missouri,1698,1388,3,-5,1701,1383,13,15,1714,1368,1749,223,243,251,0,,0,0.0,0.0,0.0,0.0,0.0
2024,11,18,1,2024-11-18,AS,9299,MSP,ATL,"Minneapolis, MN",Minnesota,"Atlanta, GA",Georgia,1937,890,7,0,1944,890,17,12,1961,878,2518,311,331,340,0,,0,0.0,0.0,0.0,0.0,0.0
2024,2,25,7,2024-02-25,9E,8896,PHL,LAS,"Philadelphia, PA",Pennsylvania,"Las Vegas, NV",Nevada,633,1029,-5,5,628,1034,18,12,646,1022,1988,250,270,280,0,,0,0.0,0.0,0.0,0.0,0.0
2024,11,14,4,2024-11-14,AA,276,IAD,SEA,"Washington, DC",District of Columbia,"Seattle, WA",Washington,601,1197,-1,5,600,1202,28,6,628,1196,2546,325,345,359,0,,0,0.0,0.0,0.0,0.0,0.0
2024,7,21,7,2024-07-21,NK,8928,ORD,IAH,"Chicago, IL",Illinois,"Houston, TX",Texas,884,1031,7,5,891,1036,17,10,908,1026,512,54,74,81,0,,0,0.0,0.0,0.0,0.0,0.0
2024,9,27,5,2024-09-27,AA,6270,BWI,MCO,"Baltimore, MD",Maryland,"Orlando, FL",Florida,954,2157,-10,-10,944,2147,23,17,967,2130,602,75,95,115,0,,0,0.0,0.0,0.0,0.0,0.0
2024,4,18,4,2024-04-18,NK,2723,DEN,PHL,"Denver, CO",Colorado,"Philadelphia, PA",Pennsylvania,1585,1245,13,15,1598,1260,20,11,1618,1249,1660,203,223,234,0,,0,0.0,0.0,0.0,0.0,0.0
2024,4,25,4,2024-04-25,OH,2878,MIA,MSP,"Miami, FL",Florida,"Minneapolis, MN",Minnesota,1459,2133,-6,-5,1453,2128,22,6,1475,2122,2543,314,334,342,0,,0,0.0,0.0,0.0,0.0,0.0
2024,4,1,1,2024-04-01,DL,3852,TPA,DCA,"Tampa, FL",Florida,"Washington, DC",District of Columbia,1400,1104,-11,-20,1389,1084,20,9,1409,1075,1318,165,185,194,0,,0,0.0,0.0,0.0,0.0,0.0
2024,5,17,5,2024-05-17,F9,8952,LAS,EWR,"Las Vegas, NV",Nevada,"Newark, NJ",New Jersey,1065,1272,13,5,1078,1277,6,3,1084,1274,1452,184,204,193,0,,0,0.0,0.0,0.0,0.0,0.0
2024,10,29,2,2024-10-29,DL,4465,DTW,EWR,"Detroit, MI",Michigan,"Newark, NJ",New Jersey,506,1406,-9,0,497,1406,5,19,502,1387,1118,129,149,153,0,,0,0.0,0.0,0.0,0.0,0.0
2024,2,26,1,2024-02-26,UA,4440,MDW,SLC,"Chicago, IL",Illinois,"Salt Lake City, UT",Utah,1367,2178,-18,-15,1349,2163,14,5,1363,2158,563,66,86,85,0,,0,0.0,0.0,0.0,0.0,0.0
2024,2,19,1,2024-02-19,MQ,4855,LGA,DEN,"New York, NY",New York,"Denver, CO",Colorado,1014,2032,27,20,1041,2052,29,17,1070,2035,1217,158,178,204,0,,0,1.0,5.0,2.0,0.0,12.0
2024,3,11,1,2024-03-11,YX,8376,PHX,MIA,"Phoenix, AZ",Arizona,"Miami, FL",Florida,831,2025,7,0,838,2025,18,12,856,2013,2965,361,381,391,0,,0,0.0,0.0,0.0,0.0,0.0
2024,3,22,5,2024-03-22,UA,3770,CLT,STL,"Charlotte, NC",North Carolina,"St. Louis, MO",Missouri,1902,640,-9,0,1893,640,21,17,1914,623,2469,309,329,347,0,,0,0.0,0.0,0.0,0.0,0.0
2024,4,14,7,2024-04-14,AA,9198,HNL,IAD,"Honolulu, HI",Hawaii,"Washington, DC",District of Columbia,944,983,-1,-5,943,978,22,9,965,969,399,53,73,84,0,,0,0.0,0.0,0.0,0.0,0.0
2024,3,28,4,2024-03-28,B6,3621,PHL,DFW,"Philadelphia, PA",Pennsylvania,"Dallas/Fort Worth, TX",Texas,834,1485,-4,-10,830,1475,11,8,841,1467,2790,343,363,362,0,,0,0.0,0.0,0.0,0.0,0.0
2024,1,2,2,2024-01-02,B6,1975,DEN,MDW,"Denver, CO",Colorado,"Chicago, IL",Illinois,1991,1914,24,20,2015,1934,25,16,2040,1918,1495,195,215,236,0,,0,2.0,2.0,3.0,0.0,13.0
2024,12,25,3,2024-12-25,9E,4058,MDW,HNL,"Chicago, IL",Illinois,"Honolulu, HI",Hawaii,1160,782,14,5,1174,787,21,8,1195,779,2301,280,300,309,0,,0,0.0,0.0,0.0,0.0,0.0
2024,3,24,7,2024-03-24,B6,2236,TPA,LAX,"Tampa, FL",Florida,"Los Angeles, CA",California,787,1363,4,0,791,1363,8,15,799,1348,1070,126,146,149,0,,0,0.0,0.0,0.0,0.0,0.0
2024,2,12,1,2024-02-12,OH,9145,PDX,DEN,"Portland, OR",Oregon,"Denver, CO",Colorado,1535,1663,2,0,1537,1663,16,13,1553,1650,1631,204,224,233,0,,0,0.0,0.0,0.0,0.0,0.0
2024,6,2,7,2024-06-02,MQ,606,HNL,LGA,"Honolulu, HI",Hawaii,"New York, NY",New York,1496,2222,17,10,1513,2232,26,11,1539,2221,732,91,111,128,0,,0,0.0,0.0,0.0,0.0,0.0
2024,11,22,5,2024-11-22,G4,8699,MDW,BOS,"Chicago, IL",Illinois,"Boston, MA",Massachusetts,1627,1848,4,0,1631,1848,12,14,1643,1834,527,64,84,90,0,,0,0.0,0.0,0.0,0.0,0.0
2024,4,3,3,2024-04-03,AS,5490,ATL,STL,"Atlanta, GA",Georgia,"St. Louis, MO",Missouri,2146,1908,-8,-15,2138,1893,6,18,2144,1875,749,87,107,111,0,,0,0.0,0.0,0.0,0.0,0.0
2024,10,24,4,2024-10-24,AS,8815,LAS,TPA,"Las Vegas, NV",Nevada,"Tampa, FL",Florida,1786,737,13,5,1799,742,23,5,1822,737,525,72,92,100,0,,0,0.0,0.0,0.0,0.0,0.0
2024,5,12,7,2024-05-12,UA,5713,SAN,DCA,"San Diego, CA",California,"Washington, DC",District of Columbia,1958,934,7,0,1965,934,18,9,1983,925,830,96,116,123,0,,0,0.0,0.0,0.0,0.0,0.0
2024,3,5,2,2024-03-05,B6,6850,MDW,HNL,"Chicago, IL",Illinois,"Honolulu, HI",Hawaii,672,737,24,20,696,757,27,12,723,745,1893,228,248,267,0,,0,3.0,2.0,3.0,0.0,12.0
2024,10,16,3,2024-10-16,9E,3150,PHL,LAS,"Philadelphia, PA",Pennsylvania,"Las Vegas, NV",Nevada,2130,2097,4,5,2134,2102,21,8,2155,2094,661,88,108,117,0,,0,0.0,0.0,0.0,0.0,0.0
2024,9,13,5,2024-09-13,NK,7192,MSP,HNL,"Minneapolis, MN",Minnesota,"Honolulu, HI",Hawaii,820,1087,0,-5,820,1082,27,11,847,1071,462,48,68,86,0,,0,0.0,0.0,0.0,0.0,0.0
2024,7,31,3,2024-07-31,UA,2497,DTW,DCA,"Detroit, MI",Michigan,"Washington, DC",District of Columbia,2238,1175,-17,-15,2221,1160,21,14,2242,1146,2507,317,337,352,0,,0,0.0,0.0,0.0,0.0,0.0
2024,5,27,1,2024-05-27,DL,8012,IAD,DFW,"Washington, DC",District of Columbia,"Dallas/Fort Worth, TX",Texas,1568,1228,-9,0,1559,1228,12,7,1571,1221,1600,206,226,225,0,,0,0.0,0.0,0.0,0.0,0.0
2024,3,1,5,2024-03-01,B6,8619,LAX,SAN,"Los Angeles, CA",California,"San Diego, CA",California,2069,2233,7,5,2076,2238,10,7,2086,2231,2016,243,263,260,0,,0,0.0,0.0,0.0,0.0,0.0
2024,5,28,2,2024-05-28,UA,1409,SLC,PDX,"Salt Lake City, UT",Utah,"Portland, OR",Oregon,710,1769,-20,-10,690,1759,14,8,704,1751,2144,269,289,291,0,,0,0.0,0.0,0.0,0.0,0.0
2024,3,28,4,2024-03-28,B6,7302,DCA,MSP,"Washington, DC",District of Columbia,"Minneapolis, MN",Minnesota,1406,1497,-3,0,1403,1497,11,8,1414,1489,1626,209,229,228,0,,0,0.0,0.0,0.0,0.0,0.0
2024,11,19,2,2024-11-19,G4,7800,CLT,MSP,"Charlotte, NC",North Carolina,"Minneapolis, MN",Minnesota,1236,1008,5,10,1241,1018,6,3,1247,1015,2597,330,350,339,0,,0,0.0,0.0,0.0,0.0,0.0
2024,10,4,5,2024-10-04,OO,4818,LAS,LGA,"Las Vegas, NV",Nevada,"New York, NY",New York,916,2133,-2,-10,914,2123,19,13,933,2110,2020,246,266,278,0,,0,0.0,0.0,0.0,0.0,0.0
2024,3,22,5,2024-03-22,9E,6050,EWR,DFW,"Newark, NJ",New Jersey,"Dallas/Fort Worth, TX",Texas,763,1708,13,5,776,1713,26,18,802,1695,682,84,104,128,0,,0,0.0,0.0,0.0,0.0,0.0
2024,5,8,3,2024-05-08,AA,855,HNL,SFO,"Honolulu, HI",Hawaii,"San Francisco, CA",California,800,2186,-24,-15,776,2171,9,9,785,2162,872,109,129,127,1,,0,0.0,0.0,0.0,0.0,0.0
2024,10,12,6,2024-10-12,WN,245,PDX,ATL,"Portland, OR",Oregon,"Atlanta, GA",Georgia,1979,2230,-13,-20,1966,2210,7,19,1973,2191,2031,257,277,283,0,,0,0.0,0.0,0.0,0.0,0.0
2024,12,18,3,2024-12-18,9E,5216,LAS,IAH,"Las Vegas, NV",Nevada,"Houston, TX",Texas,1749,1632,-13,-20,1736,1612,13,6,1749,1606,1733,219,239,238,0,,0,0.0,0.0,0.0,0.0,0.0
2024,10,6,7,2024-10-06,HA,3674,BOS,ORD,"Boston, MA",Massachusetts,"Chicago, IL",Illinois,603,1458,4,0,607,1458,9,7,616,1451,670,85,105,101,0,,0,0.0,0.0,0.0,0.0,0.0
2024,9,26,4,2024-09-26,B6,9919,DTW,CLT,"Detroit, MI",Michigan,"Charlotte, NC",North Carolina,1486,1712,25,20,1511,1732,28,3,1539,1729,517,60,80,91,0,,0,2.0,3.0,0.0,0.0,15.0
2024,10,18,5,2024-10-18,DL,5023,DCA,MDW,"Washington, DC",District of Columbia,"Chicago, IL",Illinois,720,1712,7,5,727,1717,24,3,751,1714,1927,245,265,272,0,,0,0.0,0.0,0.0,0.0,0.0
2024,7,21,7,2024-07-21,YX,1958,TPA,MDW,"Tampa, FL",Florida,"Chicago, IL",Illinois,833,818,-16,-10,817,808,10,7,827,801,300,43,63,60,0,,0,0.0,0.0,0.0,0.0,0.0
2024,1,24,3,2024-01-24,DL,4822,DFW,DTW,"Dallas/Fort Worth, TX",Texas,"Detroit, MI",Michigan,917,1441,-8,-15,909,1426,8,15,917,1411,2878,364,384,387,0,,0,0.0,0.0,0.0,0.0,0.0
2024,12,16,1,2024-12-16,AA,3698,LAX,EWR,"Los Angeles, CA",California,"Newark, NJ",New Jersey,1824,949,-6,0,1818,949,8,7,1826,942,497,52,72,67,0,,0,0.0,0.0,0.0,0.0,0.0
2024,11,6,3,2024-11-06,OH,729,CLT,PDX,"Charlotte, NC",North Carolina,"Portland, OR",Oregon,1134,1004,-15,-20,1119,984,29,5,1148,979,2043,263,283,297,0,,0,0.0,0.0,0.0,0.0,0.0
2024,7,26,5,2024-07-26,F9,3618,LAX,LGA,"Los Angeles, CA",California,"New York, NY",New York,2008,1784,0,5,2008,1789,25,5,2033,1784,549,75,95,105,0,,0,0.0,0.0,0.0,0.0,0.0
2024,10,6,7,2024-10-06,DL,6658,IAD,PHX,"Washington, DC",District of Columbia,"Phoenix, AZ",Arizona,1460,642,-14,-10,1446,632,21,11,1467,621,2374,301,321,333,0,,0,0.0,0.0,0.0,0.0,0.0
2024,7,23,2,2024-07-23,UA,4452,LAS,PDX,"Las Vegas, NV",Nevada,"Portland, OR",Oregon,1980,2097,-20,-10,1960,2087,19,16,1979,2071,1000,116,136,151,0,,0,0.0,0.0,0.0,0.0,0.0
2024,5,31,5,2024-05-31,HA,7529,LAS,JFK,"Las Vegas, NV",Nevada,"New York, NY",New York,935,857,-8,-5,927,852,11,5,938,847,546,59,79,75,0,,0,0.0,0.0,0.0,0.0,0.0
2024,1,26,5,2024-01-26,YX,9196,SLC,IAH,"Salt Lake City, UT",Utah,"Houston, TX",Texas,893,1782,1,5,894,1787,23,16,917,1771,262,29,49,68,0,,0,0.0,0.0,0.0,0.0,0.0
2024,7,12,5,2024-07-12,DL,5655,DCA,PHL,"Washington, DC",District of Columbia,"Philadelphia, PA",Pennsylvania,1233,1755,-14,-10,1219,1745,15,19,1234,1726,1691,203,223,237,0,,0,0.0,0.0,0.0,0.0,0.0
2024,12,1,7,2024-12-01,WN,8097,SFO,MCO,"San Francisco, CA",California,"Orlando, FL",Florida,542,2182,-14,-10,528,2172,7,6,535,2166,342,51,71,64,0,,0,0.0,0.0,0.0,0.0,0.0
2024,8,25,7,2024-08-25,OH,207,DCA,LGA,"Washington, DC",District of Columbia,"New York, NY",New York,709,1451,-10,0,699,1451,19,18,718,1433,1965,250,270,287,0,,0,0.0,0.0,0.0,0.0,0.0
2024,11,16,6,2024-11-16,AA,9334,BOS,ORD,"Boston, MA",Massachusetts,"Chicago, IL",Illinois,1465,2224,1,0,1466,2224,26,4,1492,2220,1494,179,199,209,0,,0,0.0,0.0,0.0,0.0,0.0
2024,3,15,5,2024-03-15,UA,9680,LAX,IAH,"Los Angeles, CA",California,"Houston, TX",Texas,510,1668,20,20,530,1688,23,4,553,1684,1142,135,155,162,0,,0,5.0,3.0,2.0,0.0,10.0
2024,6,11,2,2024-06-11,B6,9968,LAX,SEA,"Los Angeles, CA",California,"Seattle, WA",Washington,715,1944,-5,-10,710,1934,21,14,731,1920,600,65,85,100,0,,0,0.0,0.0,0.0,0.0,0.0
2024,10,25,5,2024-10-25,9E,5598,DEN,IAD,"Denver, CO",Colorado,"Washington, DC",District of Columbia,1687,1613,-25,-15,1662,1598,10,18,1672,1580,1477,174,194,202,0,,0,0.0,0.0,0.0,0.0,0.0
2024,1,29,1,2024-01-29,AA,4355,HNL,EWR,"Honolulu, HI",Hawaii,"Newark, NJ",New Jersey,724,1817,-5,0,719,1817,27,12,746,1805,2748,333,353,372,0,,0,0.0,0.0,0.0,0.0,0.0
2024,6,13,4,2024-06-13,WN,4295,BWI,CLT,"Baltimore, MD",Maryland,"Charlotte, NC",North Carolina,2260,2141,-16,-10,2244,2131,9,4,2253,2127,2003,241,261,254,0,,0,0.0,0.0,0.0,0.0,0.0
2024,12,2,1,2024-12-02,AS,8556,PHL,BOS,"Philadelphia, PA",Pennsylvania,"Boston, MA",Massachusetts,1769,1886,-4,-5,1765,1881,17,18,1782,1863,320,41,61,76,0,,0,0.0,0.0,0.0,0.0,0.0
2024,7,4,4,2024-07-04,HA,3921,SAN,PHL,"San Diego, CA",California,"Philadelphia, PA",Pennsylvania,1157,1034,-4,-10,1153,1024,21,6,1174,1018,2103,266,286,293,0,,0,0.0,0.0,0.0,0.0,0.0
2024,2,23,5,2024-02-23,WN,776,MCO,LAS,"Orlando, FL",Florida,"Las Vegas, NV",Nevada,2226,2331,12,10,2238,2341,6,12,2244,2329,2592,320,340,338,0,,0,0.0,0.0,0.0,0.0,0.0
2024,10,21,1,2024-10-21,NK,5278,HNL,PDX,"Honolulu, HI",Hawaii,"Portland, OR",Oregon,1272,1129,-11,-5,1261,1124,22,19,1283,1105,1652,198,218,239,0,,0,0.0,0.0,0.0,0.0,0.0
2024,2,11,7,2024-02-11,OH,5666,TPA,PHX,"Tampa, FL",Florida,"Phoenix, AZ",Arizona,515,1920,9,5,524,1925,14,6,538,1919,1176,143,163,163,0,,0,0.0,0.0,0.0,0.0,0.0
2024,10,11,5,2024-10-11,NK,4069,SEA,SAN,"Seattle, WA",Washington,"San Diego, CA",California,1717,2124,6,15,1723,2139,28,8,1751,2131,637,81,101,117,0,,0,0.0,0.0,0.0,0.0,0.0
2024,5,17,5,2024-05-17,AS,5520,MSP,SEA,"Minneapolis, MN",Minnesota,"Seattle, WA",Washington,1532,2242,6,15,1538,2257,12,5,1550,2252,1800,221,241,238,0,,0,0.0,0.0,0.0,0.0,0.0
2024,7,5,5,2024-07-05,G4,707,SLC,DFW,"Salt Lake City, UT",Utah,"Dallas/Fort Worth, TX",Texas,1013,668,9,0,1022,668,12,11,1034,657,1209,157,177,180,0,,0,0.0,0.0,0.0,0.0,0.0
2024,7,22,1,2024-07-22,DL,5774,IAH,DTW,"Houston, TX",Texas,"Detroit, MI",Michigan,792,1648,35,30,827,1678,22,7,849,1671,2785,353,373,382,0,,0,5.0,1.0,2.0,0.0,22.0
2024,2,11,7,2024-02-11,MQ,5988,MCO,PHL,"Orlando, FL",Florida,"Philadelphia, PA",Pennsylvania,1607,1167,6,5,1613,1172,16,11,1629,1161,1468,187,207,214,0,,0,0.0,0.0,0.0,0.0,0.0
2024,12,15,7,2024-12-15,9E,5432,SEA,MCO,"Seattle, WA",Washington,"Orlando, FL",Florida,1732,1112,-22,-15,1710,1097,25,15,1735,1082,258,24,44,64,0,,0,0.0,0.0,0.0,0.0,0.0
2024,10,14,1,2024-10-14,F9,7456,HNL,CLT,"Honolulu, HI",Hawaii,"Charlotte, NC",North Carolina,557,782,8,10,565,792,9,4,574,788,1857,225,245,238,0,,0,0.0,0.0,0.0,0.0,0.0
2024,1,26,5,2024-01-26,F9,6886,BWI,EWR,"Baltimore, MD",Maryland,"Newark, NJ",New Jersey,1484,653,1,0,1485,653,8,5,1493,648,498,67,87,80,0,,0,0.0,0.0,0.0,0.0,0.0
2024,2,25,7,2024-02-25,OO,2494,PDX,IAH,"Portland, OR",Oregon,"Houston, TX",Texas,1350,1704,-19,-10,1331,1694,28,9,1359,1685,1343,173,193,210,0,,0,0.0,0.0,0.0,0.0,0.0
2024,9,9,1,2024-09-09,9E,8170,STL,SAN,"St. Louis, MO",Missouri,"San Diego, CA",California,2035,759,2,5,2037,764,28,14,2065,750,2386,295,315,337,0,,0,0.0,0.0,0.0,0.0,0.0
2024,5,1,3,2024-05-01,OH,9452,LAS,PHX,"Las Vegas, NV",Nevada,"Phoenix, AZ",Arizona,2141,2009,3,0,2144,2009,17,11,2161,1998,2678,339,359,367,0,,0,0.0,0.0,0.0,0.0,0.0
2024,4,15,1,2024-04-15,OH,5249,PHL,STL,"Philadelphia, PA",Pennsylvania,"St. Louis, MO",Missouri,1147,2072,10,10,1157,2082,29,15,1186,2067,1123,135,155,179,0,,0,0.0,0.0,0.0,0.0,0.0
2024,5,9,4,2024-05-09,OO,6389,DEN,DFW,"Denver, CO",Colorado,"Dallas/Fort Worth, TX",Texas,1854,1337,7,10,1861,1347,8,13,1869,1334,421,50,70,71,0,,0,0.0,0.0,0.0,0.0,0.0
2024,12,2,1,2024-12-02,WN,9783,PDX,SEA,"Portland, OR",Oregon,"Seattle, WA",Washington,960,863,-7,-5,953,858,5,15,958,843,618,70,90,90,0,,0,0.0,0.0,0.0,0.0,0.0
2024,6,6,4,2024-06-06,AS,2121,DCA,MCO,"Washington, DC",District of Columbia,"Orlando, FL",Florida,2112,1220,-14,-10,2098,1210,15,10,2113,1200,2638,327,347,352,0,,0,0.0,0.0,0.0,0.0,0.0
2024,8,18,7,2024-08-18,OO,7884,DFW,CLT,"Dallas/Fort Worth, TX",Texas,"Charlotte, NC",North Carolina,1468,1605,8,5,1476,1610,13,17,1489,1593,1320,166,186,196,0,,0,0.0,0.0,0.0,0.0,0.0
2024,11,3,7,2024-11-03,AS,4698,ATL,SEA,"Atlanta, GA",Georgia,"Seattle, WA",Washington,1848,1932,-4,0,1844,1932,21,16,1865,1916,292,40,60,77,0,,0,0.0,0.0,0.0,0.0,0.0
2024,3,31,7,2024-03-31,B6,3115,LAS,PHX,"Las Vegas, NV",Nevada,"Phoenix, AZ",Arizona,1733,1667,-16,-15,1717,1652,24,19,1741,1633,2097,257,277,300,0,,0,0.0,0.0,0.0,0.0,0.0
2024,1,22,1,2024-01-22,OH,5410,MCO,ORD,"Orlando, FL",Florida,"Chicago, IL",Illinois,2267,800,-14,-10,2253,790,15,15,2268,775,1318,167,187,197,0,,0,0.0,0.0,0.0,0.0,0.0
2024,10,16,3,2024-10-16,AA,2148,ORD,IAH,"Chicago, IL",Illinois,"Houston, TX",Texas,1648,1907,-6,-10,1642,1897,14,13,1656,1884,2422,306,326,333,0,,0,0.0,0.0,0.0,0.0,0.0
2024,4,19,5,2024-04-19,UA,6069,LAS,CLT,"Las Vegas, NV",Nevada,"Charlotte, NC",North Carolina,1191,746,7,0,1198,746,21,12,1219,734,844,106,126,139,0,,0,0.0,0.0,0.0,0.0,0.0
2024,2,18,7,2024-02-18,NK,993,CLT,SAN,"Charlotte, NC",North Carolina,"San Diego, CA",California,1985,2063,-13,-15,1972,2048,7,19,1979,2029,2796,352,372,378,0,,0,0.0,0.0,0.0,0.0,0.0
2024,5,8,3,2024-05-08,F9,9379,ORD,BWI,"Chicago, IL",Illinois,"Baltimore, MD",Maryland,789,2027,-17,-10,772,2017,23,14,795,2003,1569,187,207,224,0,,0,0.0,0.0,0.0,0.0,0.0
2024,3,13,3,2024-03-13,DL,6187,EWR,LGA,"Newark, NJ",New Jersey,"New York, NY",New York,1737,1310,1,0,1738,1310,27,4,1765,1306,2877,366,386,397,0,,0,0.0,0.0,0.0,0.0,0.0
2024,12,5,4,2024-12-05,UA,3033,STL,SEA,"St. Louis, MO",Missouri,"Seattle, WA",Washington,1955,1807,-6,-15,1949,1792,7,3,1956,1789,1458,183,203,193,0,,0,0.0,0.0,0.0,0.0,0.0
2024,2,22,4,2024-02-22,WN,2381,DFW,SLC,"Dallas/Fort Worth, TX",Texas,"Salt Lake City, UT",Utah,1620,1146,-3,-10,1617,1136,10,17,1627,1119,1292,167,187,194,0,,0,0.0,0.0,0.0,0.0,0.0
2024,12,21,6,2024-12-21,OH,8364,EWR,MIA,"Newark, NJ",New Jersey,"Miami, FL",Florida,1419,1832,11,15,1430,1847,24,5,1454,1842,2344,294,314,323,0,,0,0.0,0.0,0.0,0.0,0.0
2024,6,16,7,2024-06-16,OO,1480,CLT,MIA,"Charlotte, NC",North Carolina,"Miami, FL",Florida,748,1471,-2,5,746,1476,10,11,756,1465,1542,192,212,213,0,,0,0.0,0.0,0.0,0.0,0.0
2024,2,14,3,2024-02-14,B6,583,HNL,STL,"Honolulu, HI",Hawaii,"St. Louis, MO",Missouri,2026,1174,-8,-5,2018,1169,29,15,2047,1154,542,62,82,106,0,,0,0.0,0.0,0.0,0.0,0.0
2024,4,14,7,2024-04-14,UA,9321,SEA,IAD,"Seattle, WA",Washington,"Washington, DC",District of Columbia,1232,681,19,10,1251,691,11,13,1262,678,2375,289,309,313,0,,0,0.0,0.0,0.0,0.0,0.0
2024,5,29,3,2024-05-29,B6,3879,SAN,DFW,"San Diego, CA",California,"Dallas/Fort Worth, TX",Texas,1024,862,-3,-10,1021,852,5,18,1026,834,1402,175,195,198,0,,0,0.0,0.0,0.0,0.0,0.0
2024,5,25,6,2024-05-25,F9,6201,DFW,EWR,"Dallas/Fort Worth, TX",Texas,"Newark, NJ",New Jersey,2028,1522,-5,0,2023,1522,12,10,2035,1512,2666,327,347,349,0,,0,0.0,0.0,0.0,0.0,0.0
2024,7,22,1,2024-07-22,F9,5054,PDX,DEN,"Portland, OR",Oregon,"Denver, CO",Colorado,1614,1662,-7,-5,1607,1657,20,14,1627,1643,593,80,100,114,0,,0,0.0,0.0,0.0,0.0,0.0
2024,12,27,5,2024-12-27,OH,6053,STL,CLT,"St. Louis, MO",Missouri,"Charlotte, NC",North Carolina,1204,885,6,5,1210,890,24,4,1234,886,1832,230,250,258,0,,0,0.0,0.0,0.0,0.0,0.0
2024,10,25,5,2024-10-25,DL,6380,BWI,ORD,"Baltimore, MD",Maryland,"Chicago, IL",Illinois,2234,622,-7,-5,2227,617,28,7,2255,610,2481,315,335,350,0,,0,0.0,0.0,0.0,0.0,0.0
2024,6,15,6,2024-06-15,AS,878,PHX,EWR,"Phoenix, AZ",Arizona,"Newark, NJ",New Jersey,1271,2219,-6,-10,1265,2209,19,16,1284,2193,236,26,46,61,0,,0,0.0,0.0,0.0,0.0,0.0
2024,7,19,5,2024-07-19,WN,3575,DFW,STL,"Dallas/Fort Worth, TX",Texas,"St. Louis, MO",Missouri,1075,2097,2,0,1077,2097,23,18,1100,2079,2718,339,359,380,0,,0,0.0,0.0,0.0,0.0,0.0
2024,5,13,1,2024-05-13,G4,4823,STL,MIA,"St. Louis, MO",Missouri,"Miami, FL",Florida,1341,902,-3,5,1338,907,14,4,1352,903,2184,269,289,287,0,,0,0.0,0.0,0.0,0.0,0.0
2024,7,29,1,2024-07-29,9E,6986,MDW,SFO,"Chicago, IL",Illinois,"San Francisco, CA",California,1243,805,-8,0,1235,805,16,12,1251,793,2776,339,359,367,0,,0,0.0,0.0,0.0,0.0,0.0
2024,2,17,6,2024-02-17,DL,6813,ORD,MSP,"Chicago, IL",Illinois,"Minneapolis, MN",Minnesota,2262,2055,13,5,2275,2060,9,12,2284,2048,565,72,92,93,0,,0,0.0,0.0,0.0,0.0,0.0
2024,5,5,7,2024-05-05,F9,8701,DCA,SFO,"Washington, DC",District of Columbia,"San Francisco, CA",California,666,694,-3,-5,663,689,7,10,670,679,2795,343,363,360,0,,0,0.0,0.0,0.0,0.0,0.0
2024,8,26,1,2024-08-26,AA,1159,SLC,TPA,"Salt Lake City, UT",Utah,"Tampa, FL",Florida,1774,1074,6,5,1780,1079,17,14,1797,1065,354,42,62,73,0,,0,0.0,0.0,0.0,0.0,0.0
2024,1,7,7,2024-01-07,OO,6473,SFO,HNL,"San Francisco, CA",California,"Honolulu, HI",Hawaii,1970,2198,-5,0,1965,2198,23,12,1988,2186,247,22,42,57,0,,0,0.0,0.0,0.0,0.0,0.0
2024,9,28,6,2024-09-28,AS,7494,BOS,SEA,"Boston, MA",Massachusetts,"Seattle, WA",Washington,1709,1999,-3,-10,1706,1989,7,6,1713,1983,2414,294,314,307,0,,0,0.0,0.0,0.0,0.0,0.0
2024,2,6,2,2024-02-06,OO,2409,JFK,HNL,"New York, NY",New York,"Honolulu, HI",Hawaii,748,736,8,10,756,746,24,9,780,737,2184,271,291,304,0,,0,0.0,0.0,0.0,0.0,0.0
2024,7,29,1,2024-07-29,OO,1700,TPA,ORD,"Tampa, FL",Florida,"Chicago, IL",Illinois,839,750,16,10,855,760,7,9,862,751,2669,337,357,353,0,,0,0.0,0.0,0.0,0.0,0.0
2024,6,13,4,2024-06-13,OH,2333,LGA,IAD,"New York, NY",New York,"Washington, DC",District of Columbia,1969,2252,21,20,1990,2272,20,17,2010,2255,1109,136,156,173,0,,0,7.0,4.0,0.0,0.0,9.0
2024,5,4,6,2024-05-04,YX,9944,SLC,ORD,"Salt Lake City, UT",Utah,"Chicago, IL",Illinois,1661,1302,6,0,1667,1302,16,15,1683,1287,1675,218,238,249,0,,0,0.0,0.0,0.0,0.0,0.0
2024,12,2,1,2024-12-02,9E,7453,CLT,ATL,"Charlotte, NC",North Carolina,"Atlanta, GA",Georgia,608,801,9,5,617,806,22,3,639,803,2215,266,286,291,0,,0,0.0,0.0,0.0,0.0,0.0
2024,7,10,3,2024-07-10,MQ,9589,BWI,PHL,"Baltimore, MD",Maryland,"Philadelphia, PA",Pennsylvania,1329,1542,1,10,1330,1552,26,5,1356,1547,1692,205,225,236,0,,0,0.0,0.0,0.0,0.0,0.0
2024,8,5,1,2024-08-05,AA,451,DTW,BOS,"Detroit, MI",Michigan,"Boston, MA",Massachusetts,916,1873,-22,-15,894,1858,21,4,915,1854,2034,250,270,275,0,,0,0.0,0.0,0.0,0.0,0.0
2024,8,1,4,2024-08-01,DL,6569,DTW,DCA,"Detroit, MI",Michigan,"Washington, DC",District of Columbia,925,2222,13,15,938,2237,25,10,963,2227,1849,226,246,261,0,,0,0.0,0.0,0.0,0.0,0.0
2024,3,2,6,2024-03-02,UA,8756,LGA,CLT,"New York, NY",New York,"Charlotte, NC",North Carolina,1567,673,-9,-10,1558,663,26,13,1584,650,1609,198,218,237,0,,0,0.0,0.0,0.0,0.0,0.0
2024,11,23,6,2024-11-23,G4,3266,IAD,TPA,"Washington, DC",District of Columbia,"Tampa, FL",Florida,841,1945,-24,-15,817,1930,21,16,838,1914,621,78,98,115,0,,0,0.0,0.0,0.0,0.0,0.0
2024,6,9,7,2024-06-09,B6,5353,TPA,BWI,"Tampa, FL",Florida,"Baltimore, MD",Maryland,1502,1148,-17,-10,1485,1138,21,14,1506,1124,898,104,124,139,0,,0,0.0,0.0,0.0,0.0,0.0
2024,3,6,3,2024-03-06,9E,2309,DEN,ATL,"Denver, CO",Colorado,"Atlanta, GA",Georgia,700,1236,1,0,701,1236,11,3,712,1233,2935,374,394,388,0,,0,0.0,0.0,0.0,0.0,0.0
2024,10,12,6,2024-10-12,9E,8847,MIA,ATL,"Miami, FL",Florida,"Atlanta, GA",Georgia,877,1599,-29,-20,848,1579,18,8,866,1571,2581,314,334,340,0,,0,0.0,0.0,0.0,0.0,0.0
2024,8,26,1,2024-08-26,YX,399,DTW,SAN,"Detroit, MI",Michigan,"San Diego, CA",California,1627,1597,-25,-20,1602,1577,15,6,1617,1571,2419,299,319,320,0,,0,0.0,0.0,0.0,0.0,0.0
2024,1,20,6,2024-01-20,DL,3966,IAD,ATL,"Washington, DC",District of Columbia,"Atlanta, GA",Georgia,957,1789,-4,0,953,1789,20,19,973,1770,1754,223,243,262,0,,0,0.0,0.0,0.0,0.0,0.0
2024,7,6,6,2024-07-06,9E,8647,CLT,IAD,"Charlotte, NC",North Carolina,"Washington, DC",District of Columbia,1490,1624,7,0,1497,1624,26,19,1523,1605,1107,141,161,186,0,,0,0.0,0.0,0.0,0.0,0.0
2024,3,22,5,2024-03-22,B6,663,SLC,MIA,"Salt Lake City, UT",Utah,"Miami, FL",Florida,1938,1961,4,10,1942,1971,29,12,1971,1959,2307,285,305,326,0,,0,0.0,0.0,0.0,0.0,0.0
2024,12,28,6,2024-12-28,B6,4988,DTW,STL,"Detroit, MI",Michigan,"St. Louis, MO",Missouri,1400,890,-11,-10,1389,880,8,7,1397,873,1894,237,257,252,0,,0,0.0,0.0,0.0,0.0,0.0
2024,7,20,6,2024-07-20,AA,9314,SEA,STL,"Seattle, WA",Washington,"St. Louis, MO",Missouri,1131,670,-3,-10,1128,660,23,7,1151,653,2793,346,366,376,0,,0,0.0,0.0,0.0,0.0,0.0
2024,5,11,6,2024-05-11,UA,1290,CLT,EWR,"Charlotte, NC",North Carolina,"Newark, NJ",New Jersey,1925,707,-15,-15,1910,692,26,3,1936,689,2928,362,382,391,0,,0,0.0,0.0,0.0,0.0,0.0
2024,2,6,2,2024-02-06,B6,3310,CLT,MSP,"Charlotte, NC",North Carolina,"Minneapolis, MN",Minnesota,1913,2113,6,0,1919,2113,12,3,1931,2110,1118,134,154,149,0,,0,0.0,0.0,0.0,0.0,0.0
2024,5,11,6,2024-05-11,G4,6478,PHX,BOS,"Phoenix, AZ",Arizona,"Boston, MA",Massachusetts,1885,1197,-5,-5,1880,1192,9,18,1889,1174,2704,329,349,356,0,,0,0.0,0.0,0.0,0.0,0.0
2024,3,17,7,2024-03-17,9E,9318,DTW,IAD,"Detroit, MI",Michigan,"Washington, DC",District of Columbia,1957,1804,-11,-5,1946,1799,7,16,1953,1783,2007,254,274,277,0,,0,0.0,0.0,0.0,0.0,0.0
2024,3,29,5,2024-03-29,AA,8547,SAN,ATL,"San Diego, CA",California,"Atlanta, GA",Georgia,1906,1648,-5,0,1901,1648,7,12,1908,1636,927,120,140,139,0,,0,0.0,0.0,0.0,0.0,0.0
2024,9,9,1,2024-09-09,F9,2518,SAN,ATL,"San Diego, CA",California,"Atlanta, GA",Georgia,1551,1774,13,10,1564,1784,21,9,1585,1775,1452,177,197,207,0,,0,0.0,0.0,0.0,0.0,0.0
2024,12,9,1,2024-12-09,AA,2663,LGA,PHX,"New York, NY",New York,"Phoenix, AZ",Arizona,1630,1888,-10,-15,1620,1873,10,11,1630,1862,486,50,70,71,0,,0,0.0,0.0,0.0,0.0,0.0
2024,7,12,5,2024-07-12,G4,3051,ORD,MDW,"Chicago, IL",Illinois,"Chicago, IL",Illinois,1039,802,3,0,1042,802,14,13,1056,789,2174,274,294,301,0,,0,0.0,0.0,0.0,0.0,0.0
2024,6,24,1,2024-06-24,AS,7483,DEN,IAD,"Denver, CO",Colorado,"Washington, DC",District of Columbia,1709,2186,-20,-10,1689,2176,27,8,1716,2168,2108,265,285,300,0,,0,0.0,0.0,0.0,0.0,0.0
2024,2,2,5,2024-02-02,AA,369,JFK,DCA,"New York, NY",New York,"Washington, DC",District of Columbia,694,2098,-16,-10,678,2088,13,13,691,2075,1393,180,200,206,0,,0,0.0,0.0,0.0,0.0,0.0
2024,2,27,2,2024-02-27,F9,6719,TPA,SAN,"Tampa, FL",Florida,"San Diego, CA",California,1669,1843,-16,-10,1653,1833,10,16,1663,1817,1901,242,262,268,0,,0,0.0,0.0,0.0,0.0,0.0
2024,7,19,5,2024-07-19,B6,5747,STL,DFW,"St. Louis, MO",Missouri,"Dallas/Fort Worth, TX",Texas,1271,1168,-3,0,1268,1168,28,3,1296,1165,1575,197,217,228,0,,0,0.0,0.0,0.0,0.0,0.0
2024,1,28,7,2024-01-28,NK,9219,PHL,SFO,"Philadelphia, PA",Pennsylvania,"San Francisco, CA",California,1371,1705,3,0,1374,1705,26,14,1400,1691,1118,134,154,174,0,,0,0.0,0.0,0.0,0.0,0.0
2024,2,4,7,2024-02-04,NK,8355,DEN,STL,"Denver, CO",Colorado,"St. Louis, MO",Missouri,1188,763,7,10,1195,773,6,3,1201,770,542,58,78,67,0,,0,0.0,0.0,0.0,0.0,0.0
2024,5,4,6,2024-05-04,HA,4655,PHX,PDX,"Phoenix, AZ",Arizona,"Portland, OR",Oregon,627,1529,8,10,635,1539,7,5,642,1534,1473,180,200,192,0,,0,0.0,0.0,0.0,0.0,0.0
2024,11,16,6,2024-11-16,NK,1142,SFO,IAD,"San Francisco, CA",California,"Washington, DC",District of Columbia,605,1892,9,0,614,1892,15,8,629,1884,1606,197,217,220,0,,0,0.0,0.0,0.0,0.0,0.0
2024,2,11,7,2024-02-11,AS,5544,LAS,PHX,"Las Vegas, NV",Nevada,"Phoenix, AZ",Arizona,1939,1806,-18,-10,1921,1796,19,15,1940,1781,709,85,105,119,0,,0,0.0,0.0,0.0,0.0,0.0
2024,3,25,1,2024-03-25,OO,5103,SEA,IAH,"Seattle, WA",Washington,"Houston, TX",Texas,851,779,9,10,860,789,18,7,878,782,2736,350,370,375,0,,0,0.0,0.0,0.0,0.0,0.0
2024,7,6,6,2024-07-06,F9,4288,ORD,PHL,"Chicago, IL",Illinois,"Philadelphia, PA",Pennsylvania,1906,1197,10,5,1916,1202,17,11,1933,1191,1121,134,154,162,0,,0,0.0,0.0,0.0,0.0,0.0
2024,4,20,6,2024-04-20,G4,9101,JFK,SAN,"New York, NY",New York,"San Diego, CA",California,2246,1071,5,5,2251,1076,21,18,2272,1058,1482,183,203,222,0,,0,0.0,0.0,0.0,0.0,0.0
2024,9,27,5,2024-09-27,YX,3188,IAD,BOS,"Washington, DC",District of Columbia,"Boston, MA",Massachusetts,1872,1734,-29,-20,1843,1714,25,8,1868,1706,2196,278,298,311,0,,0,0.0,0.0,0.0,0.0,0.0
2024,11,20,3,2024-11-20,HA,1746,EWR,JFK,"Newark, NJ",New Jersey,"New York, NY",New York,2004,2293,-5,5,1999,2298,15,5,2014,2293,2466,309,329,329,1,,0,0.0,0.0,0.0,0.0,0.0
2024,4,14,7,2024-04-14,DL,587,EWR,STL,"Newark, NJ",New Jersey,"St. Louis, MO",Missouri,1333,1668,9,10,1342,1678,10,6,1352,1672,1657,199,219,215,0,,0,0.0,0.0,0.0,0.0,0.0
2024,11,15,5,2024-11-15,NK,3181,MDW,HNL,"Chicago, IL",Illinois,"Honolulu, HI",Hawaii,813,2173,-5,0,808,2173,26,6,834,2167,2786,348,368,380,0,,0,0.0,0.0,0.0,0.0,0.0
2024,2,10,6,2024-02-10,HA,1847,LAX,IAD,"Los Angeles, CA",California,"Washington, DC",District of Columbia,2046,1131,2,5,2048,1136,6,11,2054,1125,499,60,80,77,0,,0,0.0,0.0,0.0,0.0,0.0
2024,8,2,5,2024-08-02,DL,9040,LAS,CLT,"Las Vegas, NV",Nevada,"Charlotte, NC",North Carolina,1500,1208,0,5,1500,1213,5,17,1505,1196,2589,318,338,340,0,,0,0.0,0.0,0.0,0.0,0.0
2024,3,11,1,2024-03-11,AS,627,STL,MSP,"St. Louis, MO",Missouri,"Minneapolis, MN",Minnesota,1883,1030,-9,0,1874,1030,27,11,1901,1019,914,123,143,161,0,,0,0.0,0.0,0.0,0.0,0.0
2024,2,25,7,2024-02-25,DL,1267,SEA,TPA,"Seattle, WA",Washington,"Tampa, FL",Florida,1844,1981,7,10,1851,1991,8,14,1859,1977,1317,159,179,181,0,,0,0.0,0.0,0.0,0.0,0.0
2024,8,23,5,2024-08-23,9E,4710,MDW,ATL,"Chicago, IL",Illinois,"Atlanta, GA",Georgia,883,1682,-3,5,880,1687,13,7,893,1680,1433,180,200,200,0,,0,0.0,0.0,0.0,0.0,0.0
2024,10,7,1,2024-10-07,AS,4572,SFO,TPA,"San Francisco, CA",California,"Tampa, FL",Florida,1501,1574,16,15,1517,1589,15,19,1532,1570,243,35,55,69,0,,0,0.0,0.0,0.0,0.0,0.0
2024,4,14,7,2024-04-14,DL,7761,ATL,DTW,"Atlanta, GA",Georgia,"Detroit, MI",Michigan,516,1574,10,15,526,1589,28,19,554,1570,671,91,111,138,0,,0,0.0,0.0,0.0,0.0,0.0
2024,6,10,1,2024-06-10,AA,5904,IAD,LGA,"Washington, DC",District of Columbia,"New York, NY",New York,1893,823,8,0,1901,823,10,16,1911,807,1575,196,216,222,0,,0,0.0,0.0,0.0,0.0,0.0
2024,7,9,2,2024-07-09,NK,583,CLT,IAD,"Charlotte, NC",North Carolina,"Washington, DC",District of Columbia,1589,1409,-24,-20,1565,1389,20,9,1585,1380,2461,297,317,326,0,,0,0.0,0.0,0.0,0.0,0.0
2024,1,9,2,2024-01-09,UA,551,SAN,MCO,"San Diego, CA",California,"Orlando, FL",Florida,1385,788,-18,-20,1367,768,14,10,1381,758,524,61,81,85,0,,0,0.0,0.0,0.0,0.0,0.0
2024,2,29,4,2024-02-29,OH,4169,MDW,DTW,"Chicago, IL",Illinois,"Detroit, MI",Michigan,1636,658,8,15,1644,673,7,8,1651,665,1885,236,256,251,0,,0,0.0,0.0,0.0,0.0,0.0
2024,10,31,4,2024-10-31,YX,5755,MCO,PHX,"Orlando, FL",Florida,"Phoenix, AZ",Arizona,2167,1631,-2,-5,2165,1626,28,8,2193,1618,1080,143,163,179,0,,0,0.0,0.0,0.0,0.0,0.0
2024,8,12,1,2024-08-12,OH,7307,CLT,PDX,"Charlotte, NC",North Carolina,"Portland, OR",Oregon,1939,2107,-12,-5,1927,2102,14,8,1941,2094,2414,305,325,327,0,,0,0.0,0.0,0.0,0.0,0.0
2024,11,2,6,2024-11-02,MQ,4497,LAS,BOS,"Las Vegas, NV",Nevada,"Boston, MA",Massachusetts,570,1424,7,0,577,1424,16,19,593,1405,1629,210,230,245,0,,0,0.0,0.0,0.0,0.0,0.0
2024,7,6,6,2024-07-06,WN,5771,MSP,LGA,"Minneapolis, MN",Minnesota,"New York, NY",New York,1584,1005,-14,-10,1570,995,5,4,1575,991,1614,204,224,213,0,,0,0.0,0.0,0.0,0.0,0.0
2024,3,10,7,2024-03-10,MQ,3233,PDX,PHL,"Portland, OR",Oregon,"Philadelphia, PA",Pennsylvania,943,1213,2,0,945,1213,29,4,974,1209,761,91,111,124,0,,0,0.0,0.0,0.0,0.0,0.0
2024,10,19,6,2024-10-19,AS,1873,PDX,SFO,"Portland, OR",Oregon,"San Francisco, CA",California,1468,2095,-3,5,1465,2100,14,14,1479,2086,1476,193,213,221,0,,0,0.0,0.0,0.0,0.0,0.0
2024,10,13,7,2024-10-13,B6,5722,SEA,IAD,"Seattle, WA",Washington,"Washington, DC",District of Columbia,1837,1644,-4,-10,1833,1634,29,11,1862,1623,2173,265,285,305,0,,0,0.0,0.0,0.0,0.0,0.0
2024,6,17,1,2024-06-17,WN,9290,SEA,LAS,"Seattle, WA",Washington,"Las Vegas, NV",Nevada,982,983,-5,5,977,988,14,7,991,981,2972,370,390,391,0,,0,0.0,0.0,0.0,0.0,0.0
2024,3,2,6,2024-03-02,G4,7512,SAN,CLT,"San Diego, CA",California,"Charlotte, NC",North Carolina,1767,1011,5,5,1772,1016,28,19,1800,997,2218,272,292,319,0,,0,0.0,0.0,0.0,0.0,0.0
2024,12,14,6,2024-12-14,AS,2165,LGA,MSP,"New York, NY",New York,"Minneapolis, MN",Minnesota,1016,1928,8,0,1024,1928,8,8,1032,1920,2873,352,372,368,0,,0,0.0,0.0,0.0,0.0,0.0
2024,1,14,7,2024-01-14,AS,8689,STL,LAS,"St. Louis, MO",Missouri,"Las Vegas, NV",Nevada,1893,1327,-9,-5,1884,1322,13,18,1897,1304,2899,357,377,388,0,,0,0.0,0.0,0.0,0.0,0.0
2024,6,12,3,2024-06-12,DL,6432,EWR,STL,"Newark, NJ",New Jersey,"St. Louis, MO",Missouri,816,1933,13,10,829,1943,13,15,842,1928,926,108,128,136,0,,0,0.0,0.0,0.0,0.0,0.0
2024,9,1,7,2024-09-01,AS,8013,PHL,BWI,"Philadelphia, PA",Pennsylvania,"Baltimore, MD",Maryland,1544,830,-9,-5,1535,825,16,19,1551,806,916,123,143,158,0,,0,0.0,0.0,0.0,0.0,0.0
2024,11,30,6,2024-11-30,NK,2046,STL,PDX,"St. Louis, MO",Missouri,"Portland, OR",Oregon,1197,835,-5,-5,1192,830,15,12,1207,818,1802,223,243,250,0,,0,0.0,0.0,0.0,0.0,0.0
2024,1,8,1,2024-01-08,F9,3515,JFK,PHX,"New York, NY",New York,"Phoenix, AZ",Arizona,1220,1262,8,0,1228,1262,25,17,1253,1245,2189,277,297,319,1,,0,0.0,0.0,0.0,0.0,0.0
2024,6,2,7,2024-06-02,HA,1494,TPA,PDX,"Tampa, FL",Florida,"Portland, OR",Oregon,730,2203,20,15,750,2218,10,9,760,2209,1829,234,254,253,0,,0,0.0,0.0,0.0,0.0,0.0
2024,2,5,1,2024-02-05,OH,2521,SAN,TPA,"San Diego, CA",California,"Tampa, FL",Florida,2049,645,6,0,2055,645,11,8,2066,637,2954,363,383,382,0,,0,0.0,0.0,0.0,0.0,0.0
2024,2,17,6,2024-02-17,F9,4019,DFW,LAS,"Dallas/Fort Worth, TX",Texas,"Las Vegas, NV",Nevada,1363,821,8,5,1371,826,13,18,1384,808,585,67,87,98,0,,0,0.0,0.0,0.0,0.0,0.0
2024,3,25,1,2024-03-25,G4,7445,SAN,LAS,"San Diego, CA",California,"Las Vegas, NV",Nevada,2114,1351,4,0,2118,1351,15,10,2133,1341,2048,246,266,271,0,,0,0.0,0.0,0.0,0.0,0.0
2024,1,28,7,2024-01-28,9E,3183,LAS,SAN,"Las Vegas, NV",Nevada,"San Diego, CA",California,1992,755,-3,-10,1989,745,27,5,2016,740,1538,201,221,233,0,,0,0.0,0.0,0.0,0.0,0.0
2024,7,14,7,2024-07-14,OO,8130,ATL,DCA,"Atlanta, GA",Georgia,"Washington, DC",District of Columbia,2217,1718,-14,-15,2203,1703,21,17,2224,1686,2149,275,295,313,0,,0,0.0,0.0,0.0,0.0,0.0
2024,7,26,5,2024-07-26,MQ,8220,DFW,STL,"Dallas/Fort Worth, TX",Texas,"St. Louis, MO",Missouri,1601,2232,-13,-15,1588,2217,15,18,1603,2199,388,55,75,88,0,,0,0.0,0.0,0.0,0.0,0.0
2024,7,22,1,2024-07-22,YX,1944,PHL,TPA,"Philadelphia, PA",Pennsylvania,"Tampa, FL",Florida,1062,1417,-27,-20,1035,1397,29,15,1064,1382,1059,123,143,167,0,,0,0.0,0.0,0.0,0.0,0.0
2024,11,2,6,2024-11-02,UA,1904,TPA,DTW,"Tampa, FL",Florida,"Detroit, MI",Michigan,1268,1706,-1,0,1267,1706,26,10,1293,1696,1468,184,204,220,0,,0,0.0,0.0,0.0,0.0,0.0
2024,4,13,6,2024-04-13,9E,9181,SFO,IAH,"San Francisco, CA",California,"Houston, TX",Texas,1307,1868,-17,-15,1290,1853,22,7,1312,1846,888,110,130,139,0,,0,0.0,0.0,0.0,0.0,0.0
2024,8,17,6,2024-08-17,HA,2603,DEN,ORD,"Denver, CO",Colorado,"Chicago, IL",Illinois,1029,1174,11,10,1040,1184,13,13,1053,1171,2991,379,399,405,0,,0,0.0,0.0,0.0,0.0,0.0
2024,4,10,3,2024-04-10,NK,1993,LGA,BWI,"New York, NY",New York,"Baltimore, MD",Maryland,789,609,23,30,812,639,21,11,833,628,2217,275,295,307,0,,0,3.0,4.0,0.0,0.0,23.0
2024,1,29,1,2024-01-29,NK,1766,SLC,STL,"Salt Lake City, UT",Utah,"St. Louis, MO",Missouri,1741,688,-5,0,1736,688,25,11,1761,677,344,52,72,88,0,,0,0.0,0.0,0.0,0.0,0.0
2024,5,6,1,2024-05-06,AA,4444,PDX,PHL,"Portland, OR",Oregon,"Philadelphia, PA",Pennsylvania,599,2300,-2,-5,597,2295,29,14,626,2281,2960,369,389,412,0,,0,0.0,0.0,0.0,0.0,0.0
2024,12,3,2,2024-12-03,F9,6691,PHX,DCA,"Phoenix, AZ",Arizona,"Washington, DC",District of Columbia,648,1508,-12,-5,636,1503,20,9,656,1494,731,98,118,127,0,,0,0.0,0.0,0.0,0.0,0.0
2024,1,10,3,2024-01-10,HA,3165,BWI,LAS,"Baltimore, MD",Maryland,"Las Vegas, NV",Nevada,1908,925,-1,0,1907,925,18,5,1925,920,1556,188,208,211,0,,0,0.0,0.0,0.0,0.0,0.0
2024,4,15,1,2024-04-15,WN,5175,MCO,EWR,"Orlando, FL",Florida,"Newark, NJ",New Jersey,1678,885,-6,0,1672,885,5,6,1677,879,2210,284,304,295,0,,0,0.0,0.0,0.0,0.0,0.0
2024,6,15,6,2024-06-15,B6,3175,MIA,PHL,"Miami, FL",Florida,"Philadelphia, PA",Pennsylvania,894,814,-9,-5,885,809,6,17,891,792,1195,153,173,176,0,,0,0.0,0.0,0.0,0.0,0.0
2024,9,13,5,2024-09-13,OH,1359,SLC,DFW,"Salt Lake City, UT",Utah,"Dallas/Fort Worth, TX",Texas,875,1595,-9,-5,866,1590,15,8,881,1582,2371,302,322,325,0,,0,0.0,0.0,0.0,0.0,0.0
2024,10,21,1,2024-10-21,AS,2320,BOS,SAN,"Boston, MA",Massachusetts,"San Diego, CA",California,601,1695,-1,0,600,1695,11,3,611,1692,1995,240,260,254,0,,0,0.0,0.0,0.0,0.0,0.0
2024,10,3,4,2024-10-03,UA,5541,MCO,DEN,"Orlando, FL",Florida,"Denver, CO",Colorado,2150,1831,9,0,2159,1831,14,4,2173,1827,1826,229,249,247,0,,0,0.0,0.0,0.0,0.0,0.0
2024,3,5,2,2024-03-05,B6,9078,STL,MDW,"St. Louis, MO",Missouri,"Chicago, IL",Illinois,1281,1762,7,5,1288,1767,16,10,1304,1757,2319,286,306,312,0,,0,0.0,0.0,0.0,0.0,0.0
2024,9,27,5,2024-09-27,9E,5035,MIA,SAN,"Miami, FL",Florida,"San Diego, CA",California,591,2002,19,15,610,2017,15,15,625,2002,647,76,96,106,0,,0,0.0,0.0,0.0,0.0,0.0
2024,7,6,6,2024-07-06,B6,2547,SAN,MIA,"San Diego, CA",California,"Miami, FL",Florida,910,2264,-1,5,909,2269,6,9,915,2260,2896,364,384,379,0,,0,0.0,0.0,0.0,0.0,0.0
2024,11,12,2,2024-11-12,AA,3229,CLT,EWR,"Charlotte, NC",North Carolina,"Newark, NJ",New Jersey,905,1581,0,-5,905,1576,29,4,934,1572,924,114,134,147,0,,0,0.0,0.0,0.0,0.0,0.0
2024,5,17,5,2024-05-17,UA,1998,ORD,BWI,"Chicago, IL",Illinois,"Baltimore, MD",Maryland,520,1001,0,5,520,1006,18,14,538,992,1002,127,147,159,0,,0,0.0,0.0,0.0,0.0,0.0
2024,12,8,7,2024-12-08,UA,7797,SLC,LGA,"Salt Lake City, UT",Utah,"New York, NY",New York,1131,1211,-7,0,1124,1211,13,6,1137,1205,2628,335,355,354,0,,0,0.0,0.0,0.0,0.0,0.0
2024,4,14,7,2024-04-14,AA,6791,SFO,HNL,"San Francisco, CA",California,"Honolulu, HI",Hawaii,1931,1122,0,5,1931,1127,16,12,1947,1115,355,51,71,79,0,,0,0.0,0.0,0.0,0.0,0.0
2024,2,3,6,2024-02-03,MQ,4603,DEN,SEA,"Denver, CO",Colorado,"Seattle, WA",Washington,518,939,15,10,533,949,14,8,547,941,2914,369,389,391,0,,0,0.0,0.0,0.0,0.0,0.0
2024,4,19,5,2024-04-19,NK,4049,ORD,SFO,"Chicago, IL",Illinois,"San Francisco, CA",California,2059,1799,-2,-10,2057,1789,28,4,2085,1785,2425,306,326,338,0,,0,0.0,0.0,0.0,0.0,0.0
2024,2,2,5,2024-02-02,AA,8110,LAX,MDW,"Los Angeles, CA",California,"Chicago, IL",Illinois,2061,1428,-15,-10,2046,1418,6,8,2052,1410,1908,233,253,247,0,,0,0.0,0.0,0.0,0.0,0.0
2024,12,19,4,2024-12-19,NK,7539,SFO,ATL,"San Francisco, CA",California,"Atlanta, GA",Georgia,652,1505,-5,-5,647,1500,16,13,663,1487,1705,213,233,242,0,,0,0.0,0.0,0.0,0.0,0.0
2024,8,18,7,2024-08-18,WN,116,BOS,PHX,"Boston, MA",Massachusetts,"Phoenix, AZ",Arizona,800,956,-12,-15,788,941,7,13,795,928,469,65,85,85,0,,0,0.0,0.0,0.0,0.0,0.0
2024,11,12,2,2024-11-12,G4,8059,LGA,DCA,"New York, NY",New York,"Washington, DC",District of Columbia,912,977,9,5,921,982,17,11,938,971,2357,292,312,320,0,,0,0.0,0.0,0.0,0.0,0.0
2024,9,22,7,2024-09-22,NK,6341,PHX,SAN,"Phoenix, AZ",Arizona,"San Diego, CA",California,701,1939,-5,5,696,1944,23,4,719,1940,515,59,79,86,0,,0,0.0,0.0,0.0,0.0,0.0
2024,6,30,7,2024-06-30,B6,8006,TPA,MSP,"Tampa, FL",Florida,"Minneapolis, MN",Minnesota,638,2285,-12,-5,626,2280,28,11,654,2269,1380,167,187,206,0,,0,0.0,0.0,0.0,0.0,0.0
2024,12,5,4,2024-12-05,NK,3122,BOS,ORD,"Boston, MA",Massachusetts,"Chicago, IL",Illinois,523,674,-4,0,519,674,17,18,536,656,256,26,46,61,0,,0,0.0,0.0,0.0,0.0,0.0
2024,3,5,2,2024-03-05,G4,1366,SFO,BOS,"San Francisco, CA",California,"Boston, MA",Massachusetts,511,1722,-1,0,510,1722,28,17,538,1705,445,54,74,99,0,,0,0.0,0.0,0.0,0.0,0.0
2024,11,28,4,2024-11-28,9E,578,IAH,MDW,"Houston, TX",Texas,"Chicago, IL",Illinois,634,864,-25,-15,609,849,26,8,635,841,2112,259,279,293,0,,0,0.0,0.0,0.0,0.0,0.0
2024,1,1,1,2024-01-01,AS,4396,BWI,IAD,"Baltimore, MD",Maryland,"Washington, DC",District of Columbia,1435,1510,8,5,1443,1515,20,18,1463,1497,1028,130,150,168,0,,0,0.0,0.0,0.0,0.0,0.0
2024,5,12,7,2024-05-12,AA,4077,SEA,LGA,"Seattle, WA",Washington,"New York, NY",New York,580,1613,-5,0,575,1613,27,13,602,1600,412,49,69,89,0,,0,0.0,0.0,0.0,0.0,0.0
2024,3,20,3,2024-03-20,AS,6168,DEN,JFK,"Denver, CO",Colorado,"New York, NY",New York,1878,1706,3,0,1881,1706,5,15,1886,1691,312,34,54,54,0,,0,0.0,0.0,0.0,0.0,0.0
2024,9,27,5,2024-09-27,AA,4374,PHL,BWI,"Philadelphia, PA",Pennsylvania,"Baltimore, MD",Maryland,1593,2205,13,5,1606,2210,12,16,1618,2194,521,70,90,98,0,,0,0.0,0.0,0.0,0.0,0.0
2024,8,28,3,2024-08-28,MQ,6513,PHX,LGA,"Phoenix, AZ",Arizona,"New York, NY",New York,1727,827,0,5,1727,832,17,11,1744,821,1274,165,185,193,0,,0,0.0,0.0,0.0,0.0,0.0
2024,1,28,7,2024-01-28,YX,7891,MIA,BWI,"Miami, FL",Florida,"Baltimore, MD",Maryland,1090,2307,-6,-15,1084,2292,11,5,1095,2287,721,83,103,99,0,,0,0.0,0.0,0.0,0.0,0.0
2024,8,10,6,2024-08-10,WN,585,DCA,BOS,"Washington, DC",District of Columbia,"Boston, MA",Massachusetts,1491,730,14,5,1505,735,25,9,1530,726,250,32,52,66,0,,0,0.0,0.0,0.0,0.0,0.0
2024,1,23,2,2024-01-23,OH,4773,SLC,ORD,"Salt Lake City, UT",Utah,"Chicago, IL",Illinois,1802,1633,-5,0,1797,1633,25,6,1822,1627,2490,319,339,350,0,,0,0.0,0.0,0.0,0.0,0.0
2024,4,18,4,2024-04-18,F9,437,LAS,SAN,"Las Vegas, NV",Nevada,"San Diego, CA",California,1210,2191,5,5,1215,2196,6,7,1221,2189,551,63,83,76,0,,0,0.0,0.0,0.0,0.0,0.0
2024,4,16,2,2024-04-16,B6,9152,MDW,DEN,"Chicago, IL",Illinois,"Denver, CO",Colorado,1902,1144,-10,-10,1892,1134,17,6,1909,1128,692,79,99,102,0,,0,0.0,0.0,0.0,0.0,0.0
2024,5,24,5,2024-05-24,HA,7000,DEN,ATL,"Denver, CO",Colorado,"Atlanta, GA",Georgia,1817,843,-4,-10,1813,833,16,10,1829,823,2935,370,390,396,0,,0,0.0,0.0,0.0,0.0,0.0
2024,12,19,4,2024-12-19,B6,2103,SAN,IAH,"San Diego, CA",California,"Houston, TX",Texas,1938,1849,19,10,1957,1859,21,6,1978,1853,256,29,49,56,0,,0,0.0,0.0,0.0,0.0,0.0
2024,5,18,6,2024-05-18,MQ,1571,BOS,PHL,"Boston, MA",Massachusetts,"Philadelphia, PA",Pennsylvania,1296,827,-7,-5,1289,822,13,13,1302,809,2683,342,362,368,0,,0,0.0,0.0,0.0,0.0,0.0
2024,10,10,4,2024-10-10,9E,6827,ATL,BOS,"Atlanta, GA",Georgia,"Boston, MA",Massachusetts,1951,844,3,0,1954,844,14,15,1968,829,2483,313,333,342,0,,0,0.0,0.0,0.0,0.0,0.0
2024,10,24,4,2024-10-24,OO,2142,MCO,TPA,"Orlando, FL",Florida,"Tampa, FL",Florida,1679,1043,-5,0,1674,1043,7,17,1681,1026,2560,324,344,348,0,,0,0.0,0.0,0.0,0.0,0.0
2024,4,8,1,2024-04-08,F9,1619,DCA,MIA,"Washington, DC",District of Columbia,"Miami, FL",Florida,2111,1214,-7,0,2104,1214,25,18,2129,1196,1053,135,155,178,0,,0,0.0,0.0,0.0,0.0,0.0
2024,11,12,2,2024-11-12,F9,6589,BWI,PDX,"Baltimore, MD",Maryland,"Portland, OR",Oregon,1230,2332,-19,-15,1211,2317,15,12,1226,2305,926,107,127,134,0,,0,0.0,0.0,0.0,0.0,0.0
2024,5,2,4,2024-05-02,AA,8993,SAN,IAD,"San Diego, CA",California,"Washington, DC",District of Columbia,776,1486,-6,-5,770,1481,28,12,798,1469,660,88,108,128,0,,0,0.0,0.0,0.0,0.0,0.0
2024,11,15,5,2024-11-15,MQ,4488,IAH,MDW,"Houston, TX",Texas,"Chicago, IL",Illinois,1788,1424,-19,-15,1769,1409,16,3,1785,1406,1696,210,230,229,0,,0,0.0,0.0,0.0,0.0,0.0
2024,10,13,7,2024-10-13,MQ,7956,SEA,SAN,"Seattle, WA",Washington,"San Diego, CA",California,548,2084,-6,0,542,2084,11,8,553,2076,2697,338,358,357,0,,0,0.0,0.0,0.0,0.0,0.0
2024,3,21,4,2024-03-21,B6,9465,LAS,BOS,"Las Vegas, NV",Nevada,"Boston, MA",Massachusetts,1109,1535,8,15,1117,1550,27,14,1144,1536,624,78,98,119,0,,0,0.0,0.0,0.0,0.0,0.0
2024,1,10,3,2024-01-10,YX,1705,PDX,STL,"Portland, OR",Oregon,"St. Louis, MO",Missouri,792,2344,-1,-5,791,2339,14,3,805,2336,2756,345,365,362,0,,0,0.0,0.0,0.0,0.0,0.0
2024,1,8,1,2024-01-08,B6,5764,JFK,MSP,"New York, NY",New York,"Minneapolis, MN",Minnesota,1544,981,-2,5,1542,986,14,7,1556,979,893,106,126,127,0,,0,0.0,0.0,0.0,0.0,0.0
2024,7,23,2,2024-07-23,F9,7039,ATL,MIA,"Atlanta, GA",Georgia,"Miami, FL",Florida,1967,1815,-6,-10,1961,1805,24,17,1985,1788,2598,328,348,369,0,,1,0.0,0.0,0.0,0.0,0.0
2024,11,10,7,2024-11-10,AA,5217,MCO,LAS,"Orlando, FL",Florida,"Las Vegas, NV",Nevada,2058,1238,6,10,2064,1248,14,6,2078,1242,601,83,103,103,0,,0,0.0,0.0,0.0,0.0,0.0
2024,7,15,1,2024-07-15,NK,5479,LAS,DTW,"Las Vegas, NV",Nevada,"Detroit, MI",Michigan,971,1121,-10,-5,961,1116,8,5,969,1111,1175,151,171,164,0,,0,0.0,0.0,0.0,0.0,0.0
2024,7,16,2,2024-07-16,NK,2224,SFO,DEN,"San Francisco, CA",California,"Denver, CO",Colorado,1661,1441,-12,-5,1649,1436,14,6,1663,1430,2709,332,352,352,0,,0,0.0,0.0,0.0,0.0,0.0
2024,1,30,2,2024-01-30,MQ,5091,SAN,SEA,"San Diego, CA",California,"Seattle, WA",Washington,729,2201,13,5,742,2206,26,12,768,2194,2088,255,275,293,0,,0,0.0,0.0,0.0,0.0,0.0
2024,1,20,6,2024-01-20,G4,6894,ATL,EWR,"Atlanta, GA",Georgia,"Newark, NJ",New Jersey,1337,757,-9,0,1328,757,14,14,1342,743,1998,247,267,275,0,,0,0.0,0.0,0.0,0.0,0.0
2024,2,17,6,2024-02-17,DL,1546,EWR,ORD,"Newark, NJ",New Jersey,"Chicago, IL",Illinois,1928,1879,-1,-5,1927,1874,8,11,1935,1863,2157,260,280,279,0,,0,0.0,0.0,0.0,0.0,0.0
2024,5,9,4,2024-05-09,HA,3406,BWI,PHX,"Baltimore, MD",Maryland,"Phoenix, AZ",Arizona,856,1146,-6,-15,850,1131,11,6,861,1125,1099,142,162,159,0,,0,0.0,0.0,0.0,0.0,0.0
2024,10,19,6,2024-10-19,UA,2472,BOS,PHL,"Boston, MA",Massachusetts,"Philadelphia, PA",Pennsylvania,1040,1105,-19,-10,1021,1095,22,4,1043,1091,210,25,45,51,0,,0,0.0,0.0,0.0,0.0,0.0
2024,5,11,6,2024-05-11,WN,250,LAX,MSP,"Los Angeles, CA",California,"Minneapolis, MN",Minnesota,1326,1420,7,5,1333,1425,27,9,1360,1416,973,120,140,156,0,,0,0.0,0.0,0.0,0.0,0.0
2024,12,21,6,2024-12-21,AA,1759,LAX,MSP,"Los Angeles, CA",California,"Minneapolis, MN",Minnesota,1435,766,18,15,1453,781,7,14,1460,767,441,60,80,81,0,,0,0.0,0.0,0.0,0.0,0.0
2024,2,23,5,2024-02-23,HA,6239,SFO,DCA,"San Francisco, CA",California,"Washington, DC",District of Columbia,1544,621,-12,-10,1532,611,28,14,1560,597,2894,370,390,412,0,,0,0.0,0.0,0.0,0.0,0.0
2024,10,7,1,2024-10-07,NK,9170,SFO,DTW,"San Francisco, CA",California,"Detroit, MI",Michigan,2134,666,5,0,2139,666,19,3,2158,663,2277,286,306,308,0,,0,0.0,0.0,0.0,0.0,0.0
2024,9,21,6,2024-09-21,OH,7299,SFO,MDW,"San Francisco, CA",California,"Chicago, IL",Illinois,2098,1309,-22,-20,2076,1289,9,9,2085,1280,739,95,115,113,0,,0,0.0,0.0,0.0,0.0,0.0
2024,8,2,5,2024-08-02,9E,2419,LAX,DFW,"Los Angeles, CA",California,"Dallas/Fort Worth, TX",Texas,1313,1211,-4,-10,1309,1201,13,15,1322,1186,2605,331,351,359,0,,0,0.0,0.0,0.0,0.0,0.0
2024,10,16,3,2024-10-16,UA,2983,MIA,ATL,"Miami, FL",Florida,"Atlanta, GA",Georgia,1144,1447,-13,-5,1131,1442,24,7,1155,1435,1962,254,274,285,0,,0,0.0,0.0,0.0,0.0,0.0
2024,2,12,1,2024-02-12,UA,7903,LGA,SLC,"New York, NY",New York,"Salt Lake City, UT",Utah,1026,2330,-1,5,1025,2335,16,9,1041,2326,1352,176,196,201,0,,0,0.0,0.0,0.0,0.0,0.0
2024,3,14,4,2024-03-14,UA,1615,LAX,EWR,"Los Angeles, CA",California,"Newark, NJ",New Jersey,1521,2235,-19,-20,1502,2215,25,17,1527,2198,2591,328,348,370,0,,0,0.0,0.0,0.0,0.0,0.0
2024,12,15,7,2024-12-15,F9,689,DEN,MSP,"Denver, CO",Colorado,"Minneapolis, MN",Minnesota,1628,1186,-1,5,1627,1191,20,19,1647,1172,631,78,98,117,0,,0,0.0,0.0,0.0,0.0,0.0
2024,10,4,5,2024-10-04,G4,687,BOS,BWI,"Boston, MA",Massachusetts,"Baltimore, MD",Maryland,1122,1487,-7,-10,1115,1477,15,4,1130,1473,227,20,40,39,0,,0,0.0,0.0,0.0,0.0,0.0
2024,11,21,4,2024-11-21,9E,2719,PHL,PHX,"Philadelphia, PA",Pennsylvania,"Phoenix, AZ",Arizona,1350,616,11,5,1361,621,21,9,1382,612,382,51,71,81,0,,0,0.0,0.0,0.0,0.0,0.0
2024,8,29,4,2024-08-29,MQ,5587,LAS,BWI,"Las Vegas, NV",Nevada,"Baltimore, MD",Maryland,1859,1258,-6,0,1853,1258,7,13,1860,1245,2584,330,350,350,0,,0,0.0,0.0,0.0,0.0,0.0
2024,5,9,4,2024-05-09,OH,6323,LAX,JFK,"Los Angeles, CA",California,"New York, NY",New York,923,1361,-3,-5,920,1356,19,4,939,1352,2335,293,313,316,0,,0,0.0,0.0,0.0,0.0,0.0
2024,12,15,7,2024-12-15,DL,9487,HNL,MCO,"Honolulu, HI",Hawaii,"Orlando, FL",Florida,1122,854,9,5,1131,859,8,9,1139,850,998,130,150,147,0,,0,0.0,0.0,0.0,0.0,0.0
2024,7,12,5,2024-07-12,9E,4453,BOS,SLC,"Boston, MA",Massachusetts,"Salt Lake City, UT",Utah,503,1811,-4,-10,499,1801,13,17,512,1784,1666,209,229,239,0,,0,0.0,0.0,0.0,0.0,0.0
2024,2,1,4,2024-02-01,HA,2705,HNL,EWR,"Honolulu, HI",Hawaii,"Newark, NJ",New Jersey,968,927,-11,-10,957,917,12,4,969,913,1764,210,230,226,0,,0,0.0,0.0,0.0,0.0,0.0
2024,4,15,1,2024-04-15,9E,2638,SFO,MSP,"San Francisco, CA",California,"Minneapolis, MN",Minnesota,1163,2003,-10,-15,1153,1988,22,4,1175,1984,2069,252,272,278,0,,0,0.0,0.0,0.0,0.0,0.0
2024,7,22,1,2024-07-22,AA,8857,IAD,MSP,"Washington, DC",District of Columbia,"Minneapolis, MN",Minnesota,2077,945,0,-5,2077,940,26,4,2103,936,2673,342,362,372,0,,0,0.0,0.0,0.0,0.0,0.0
2024,1,1,1,2024-01-01,OH,1856,IAD,EWR,"Washington, DC",District of Columbia,"Newark, NJ",New Jersey,1386,839,-9,-15,1377,824,8,13,1385,811,903,110,130,131,0,,0,0.0,0.0,0.0,0.0,0.0
2024,9,1,7,2024-09-01,G4,1460,DFW,ORD,"Dallas/Fort Worth, TX",Texas,"Chicago, IL",Illinois,1037,2096,-9,-5,1028,2091,9,8,1037,2083,865,105,125,122,0,,0,0.0,0.0,0.0,0.0,0.0
2024,3,12,2,2024-03-12,AS,2473,LAX,ORD,"Los Angeles, CA",California,"Chicago, IL",Illinois,1717,906,-20,-20,1697,886,13,16,1710,870,1712,223,243,252,0,,0,0.0,0.0,0.0,0.0,0.0
2024,11,1,5,2024-11-01,OH,1295,SEA,MIA,"Seattle, WA",Washington,"Miami, FL",Florida,859,775,-7,-10,852,765,20,12,872,753,435,56,76,88,0,,0,0.0,0.0,0.0,0.0,0.0
2024,1,15,1,2024-01-15,HA,2231,BWI,SAN,"Baltimore, MD",Maryland,"San Diego, CA",California,1019,912,16,15,1035,927,8,3,1043,924,1879,233,253,244,0,,0,0.0,0.0,0.0,0.0,0.0
2024,2,22,4,2024-02-22,G4,8109,SFO,STL,"San Francisco, CA",California,"St. Louis, MO",Missouri,1596,1505,3,5,1599,1510,20,13,1619,1497,1643,206,226,239,0,,0,0.0,0.0,0.0,0.0,0.0
2024,1,8,1,2024-01-08,AS,5743,HNL,MSP,"Honolulu, HI",Hawaii,"Minneapolis, MN",Minnesota,1601,1143,-14,-10,1587,1133,9,15,1596,1118,1508,195,215,219,0,,0,0.0,0.0,0.0,0.0,0.0
2024,11,25,1,2024-11-25,DL,9859,LAX,JFK,"Los Angeles, CA",California,"New York, NY",New York,2183,934,8,5,2191,939,11,14,2202,925,1123,137,157,162,0,,0,0.0,0.0,0.0,0.0,0.0
2024,2,15,4,2024-02-15,AA,3510,IAD,TPA,"Washington, DC",District of Columbia,"Tampa, FL",Florida,567,2002,10,5,577,2007,15,7,592,2000,610,71,91,93,0,,0,0.0,0.0,0.0,0.0,0.0
2024,11,20,3,2024-11-20,OH,2467,DEN,DFW,"Denver, CO",Colorado,"Dallas/Fort Worth, TX",Texas,1194,2257,-11,-10,1183,2247,11,10,1194,2237,466,55,75,76,0,,0,0.0,0.0,0.0,0.0,0.0
2024,4,23,2,2024-04-23,F9,3443,PHL,STL,"Philadelphia, PA",Pennsylvania,"St. Louis, MO",Missouri,1857,1435,-11,-5,1846,1430,10,14,1856,1416,2932,366,386,390,0,,0,0.0,0.0,0.0,0.0,0.0
2024,5,26,7,2024-05-26,UA,7381,MSP,HNL,"Minneapolis, MN",Minnesota,"Honolulu, HI",Hawaii,584,2163,23,15,607,2178,23,7,630,2171,2936,369,389,399,0,,0,0.0,0.0,0.0,0.0,0.0
2024,6,14,5,2024-06-14,AA,3197,LAS,HNL,"Las Vegas, NV",Nevada,"Honolulu, HI",Hawaii,2019,1499,1,5,2020,1504,21,14,2041,1490,2610,322,342,357,0,,0,0.0,0.0,0.0,0.0,0.0
2024,5,18,6,2024-05-18,HA,9552,DFW,TPA,"Dallas/Fort Worth, TX",Texas,"Tampa, FL",Florida,578,1300,2,5,580,1305,29,13,609,1292,2571,326,346,368,0,,0,0.0,0.0,0.0,0.0,0.0
2024,4,26,5,2024-04-26,F9,1433,STL,TPA,"St. Louis, MO",Missouri,"Tampa, FL",Florida,2074,1956,-1,0,2073,1956,10,7,2083,1949,1659,209,229,226,0,,0,0.0,0.0,0.0,0.0,0.0
2024,10,25,5,2024-10-25,YX,7265,SLC,IAD,"Salt Lake City, UT",Utah,"Washington, DC",District of Columbia,1829,1763,-3,5,1826,1768,23,10,1849,1758,1344,177,197,210,0,,0,0.0,0.0,0.0,0.0,0.0
2024,10,2,3,2024-10-02,AA,3436,MDW,ATL,"Chicago, IL",Illinois,"Atlanta, GA",Georgia,519,1908,3,0,522,1908,21,18,543,1890,871,100,120,139,0,,0,0.0,0.0,0.0,0.0,0.0
2024,10,3,4,2024-10-03,F9,8257,TPA,JFK,"Tampa, FL",Florida,"New York, NY",New York,2105,1966,14,5,2119,1971,16,5,2135,1966,2434,311,331,332,0,,0,0.0,0.0,0.0,0.0,0.0
2024,12,3,2,2024-12-03,AA,3184,DEN,BOS,"Denver, CO",Colorado,"Boston, MA",Massachusetts,655,868,-3,5,652,873,16,8,668,865,2963,377,397,401,0,,0,0.0,0.0,0.0,0.0,0.0
2024,11,8,5,2024-11-08,G4,3487,BWI,DCA,"Baltimore, MD",Maryland,"Washington, DC",District of Columbia,1640,1405,-16,-20,1624,1385,17,7,1641,1378,954,126,146,150,0,,0,0.0,0.0,0.0,0.0,0.0
2024,6,26,3,2024-06-26,OH,4813,SLC,MCO,"Salt Lake City, UT",Utah,"Orlando, FL",Florida,1379,785,-1,0,1378,785,10,12,1388,773,1927,248,268,270,1,,0,0.0,0.0,0.0,0.0,0.0
2024,11,25,1,2024-11-25,G4,7905,PHX,STL,"Phoenix, AZ",Arizona,"St. Louis, MO",Missouri,1438,709,-4,0,1434,709,23,14,1457,695,2179,265,285,302,0,,0,0.0,0.0,0.0,0.0,0.0
2024,12,19,4,2024-12-19,YX,5201,DFW,CLT,"Dallas/Fort Worth, TX",Texas,"Charlotte, NC",North Carolina,1973,1366,-7,-15,1966,1351,5,17,1971,1334,1120,134,154,156,0,,0,0.0,0.0,0.0,0.0,0.0
2024,6,2,7,2024-06-02,MQ,2531,HNL,SEA,"Honolulu, HI",Hawaii,"Seattle, WA",Washington,527,634,-6,-5,521,629,17,5,538,624,1951,236,256,258,0,,0,0.0,0.0,0.0,0.0,0.0
2024,7,19,5,2024-07-19,G4,1116,ATL,MDW,"Atlanta, GA",Georgia,"Chicago, IL",Illinois,1109,1845,13,10,1122,1855,9,6,1131,1849,283,44,64,59,0,,0,0.0,0.0,0.0,0.0,0.0
2024,4,24,3,2024-04-24,UA,741,DFW,DEN,"Dallas/Fort Worth, TX",Texas,"Denver, CO",Colorado,1473,2245,17,20,1490,2265,5,9,1495,2256,505,66,86,80,0,,0,7.0,3.0,3.0,0.0,7.0
2024,6,7,5,2024-06-07,WN,4162,IAD,ORD,"Washington, DC",District of Columbia,"Chicago, IL",Illinois,1852,2137,14,5,1866,2142,7,3,1873,2139,433,62,82,72,0,,0,0.0,0.0,0.0,0.0,0.0
2024,2,11,7,2024-02-11,B6,8607,IAH,ATL,"Houston, TX",Texas,"Atlanta, GA",Georgia,2186,1397,-20,-10,2166,1387,7,10,2173,1377,1230,149,169,166,0,,0,0.0,0.0,0.0,0.0,0.0
2024,9,3,2,2024-09-03,AS,540,MSP,PDX,"Minneapolis, MN",Minnesota,"Portland, OR",Oregon,1887,1722,-10,-5,1877,1717,19,19,1896,1698,2087,256,276,294,0,,0,0.0,0.0,0.0,0.0,0.0
2024,3,8,5,2024-03-08,G4,1238,SLC,PDX,"Salt Lake City, UT",Utah,"Portland, OR",Oregon,918,1230,-6,-10,912,1220,19,13,931,1207,826,112,132,144,0,,0,0.0,0.0,0.0,0.0,0.0
2024,11,21,4,2024-11-21,MQ,9206,LAS,CLT,"Las Vegas, NV",Nevada,"Charlotte, NC",North Carolina,521,609,-1,5,520,614,26,9,546,605,717,91,111,126,0,,0,0.0,0.0,0.0,0.0,0.0
2024,11,29,5,2024-11-29,OO,5343,JFK,EWR,"New York, NY",New York,"Newark, NJ",New Jersey,760,2208,8,5,768,2213,8,13,776,2200,410,41,61,62,0,,0,0.0,0.0,0.0,0.0,0.0
2024,7,14,7,2024-07-14,YX,2403,MCO,SLC,"Orlando, FL",Florida,"Salt Lake City, UT",Utah,559,808,8,10,567,818,12,13,579,805,1787,214,234,239,0,,0,0.0,0.0,0.0,0.0,0.0
2024,3,30,6,2024-03-30,WN,6050,DFW,STL,"Dallas/Fort Worth, TX",Texas,"St. Louis, MO",Missouri,1436,2259,5,10,1441,2269,7,17,1448,2252,2905,356,376,380,0,,0,0.0,0.0,0.0,0.0,0.0
2024,4,20,6,2024-04-20,OH,7146,JFK,MSP,"New York, NY",New York,"Minneapolis, MN",Minnesota,1936,637,-25,-15,1911,622,12,8,1923,614,2003,243,263,263,0,,0,0.0,0.0,0.0,0.0,0.0
2024,12,24,2,2024-12-24,OH,6706,MSP,BWI,"Minneapolis, MN",Minnesota,"Baltimore, MD",Maryland,662,693,-7,-15,655,678,16,15,671,663,2994,365,385,396,0,,0,0.0,0.0,0.0,0.0,0.0
2024,5,24,5,2024-05-24,AS,3521,PHL,CLT,"Philadelphia, PA",Pennsylvania,"Charlotte, NC",North Carolina,1637,1856,19,15,1656,1871,27,18,1683,1853,822,92,112,137,0,,0,0.0,0.0,0.0,0.0,0.0
2024,10,1,2,2024-10-01,MQ,2178,ATL,TPA,"Atlanta, GA",Georgia,"Tampa, FL",Florida,853,1486,1,10,854,1496,22,14,876,1482,876,109,129,145,0,,0,0.0,0.0,0.0,0.0,0.0
2024,6,27,4,2024-06-27,AA,6203,PHL,PDX,"Philadelphia, PA",Pennsylvania,"Portland, OR",Oregon,695,1786,8,0,703,1786,17,9,720,1777,1489,176,196,202,0,,0,0.0,0.0,0.0,0.0,0.0
2024,8,28,3,2024-08-28,DL,4250,SAN,LAX,"San Diego, CA",California,"Los Angeles, CA",California,1568,1438,1,-5,1569,1433,12,16,1581,1417,2078,254,274,282,0,,0,0.0,0.0,0.0,0.0,0.0
2024,11,21,4,2024-11-21,F9,2300,BWI,SFO,"Baltimore, MD",Maryland,"San Francisco, CA",California,1124,1251,0,0,1124,1251,21,16,1145,1235,220,32,52,69,0,,0,0.0,0.0,0.0,0.0,0.0
2024,11,14,4,2024-11-14,WN,4651,MSP,PDX,"Minneapolis, MN",Minnesota,"Portland, OR",Oregon,1404,841,7,0,1411,841,13,18,1424,823,1206,154,174,185,0,,0,0.0,0.0,0.0,0.0,0.0
2024,11,26,2,2024-11-26,9E,6529,SEA,MSP,"Seattle, WA",Washington,"Minneapolis, MN",Minnesota,678,1281,-7,-10,671,1271,11,11,682,1260,2109,261,281,283,0,,0,0.0,0.0,0.0,0.0,0.0
2024,6,1,6,2024-06-01,NK,8327,PHX,STL,"Phoenix, AZ",Arizona,"St. Louis, MO",Missouri,2016,697,3,-5,2019,692,26,6,2045,686,2501,315,335,347,0,,0,0.0,0.0,0.0,0.0,0.0
2024,4,13,6,2024-04-13,WN,9109,PDX,DFW,"Portland, OR",Oregon,"Dallas/Fort Worth, TX",Texas,824,2006,-2,0,822,2006,28,9,850,1997,1801,215,235,252,0,,0,0.0,0.0,0.0,0.0,0.0
2024,3,15,5,2024-03-15,OH,2046,PHL,MCO,"Philadelphia, PA",Pennsylvania,"Orlando, FL",Florida,869,1178,-10,-10,859,1168,29,13,888,1155,2345,292,312,334,0,,0,0.0,0.0,0.0,0.0,0.0
2024,5,7,2,2024-05-07,G4,4056,MCO,HNL,"Orlando, FL",Florida,"Honolulu, HI",Hawaii,1067,1912,90,90,1157,2002,19,8,1176,1994,432,45,65,72,0,,0,35.0,25.0,12.0,2.0,16.0
2024,7,17,3,2024-07-17,G4,2325,PHL,ATL,"Philadelphia, PA",Pennsylvania,"Atlanta, GA",Georgia,1870,1215,-17,-10,1853,1205,28,14,1881,1191,657,90,110,132,0,,0,0.0,0.0,0.0,0.0,0.0
2024,6,2,7,2024-06-02,WN,7815,EWR,ATL,"Newark, NJ",New Jersey,"Atlanta, GA",Georgia,1278,740,7,0,1285,740,26,14,1311,726,300,46,66,86,0,,0,0.0,0.0,0.0,0.0,0.0
2024,2,25,7,2024-02-25,MQ,3425,IAD,LGA,"Washington, DC",District of Columbia,"New York, NY",New York,1425,802,1,0,1426,802,20,14,1446,788,2016,244,264,278,0,,0,0.0,0.0,0.0,0.0,0.0
2024,10,4,5,2024-10-04,HA,8799,SEA,PHX,"Seattle, WA",Washington,"Phoenix, AZ",Arizona,614,2111,-2,0,612,2111,24,16,636,2095,1375,163,183,203,0,,0,0.0,0.0,0.0,0.0,0.0
2024,12,10,2,2024-12-10,F9,3845,EWR,MIA,"Newark, NJ",New Jersey,"Miami, FL",Florida,856,2027,-16,-10,840,2017,29,12,869,2005,1180,155,175,196,0,,0,0.0,0.0,0.0,0.0,0.0
2024,1,19,5,2024-01-19,AS,8260,JFK,LGA,"New York, NY",New York,"New York, NY",New York,1690,1016,-10,0,1680,1016,12,4,1692,1012,2030,257,277,273,0,,0,0.0,0.0,0.0,0.0,0.0
2024,6,7,5,2024-06-07,AA,4914,LGA,SFO,"New York, NY",New York,"San Francisco, CA",California,1877,1401,-17,-15,1860,1386,28,14,1888,1372,937,124,144,166,0,,0,0.0,0.0,0.0,0.0,0.0
2024,1,26,5,2024-01-26,HA,8751,LGA,MSP,"New York, NY",New York,"Minneapolis, MN",Minnesota,614,1929,-9,-5,605,1924,20,19,625,1905,966,126,146,165,0,,0,0.0,0.0,0.0,0.0,0.0
2024,6,17,1,2024-06-17,NK,6203,LGA,ATL,"New York, NY",New York,"Atlanta, GA",Georgia,1931,1545,-20,-10,1911,1535,23,10,1934,1525,2033,254,274,287,0,,0,0.0,0.0,0.0,0.0,0.0
2024,1,23,2,2024-01-23,AA,1505,PHX,MDW,"Phoenix, AZ",Arizona,"Chicago, IL",Illinois,2115,736,-6,-15,2109,721,20,4,2129,717,2061,248,268,272,0,,0,0.0,0.0,0.0,0.0,0.0
2024,2,16,5,2024-02-16,UA,6190,MSP,PDX,"Minneapolis, MN",Minnesota,"Portland, OR",Oregon,1297,1374,21,15,1318,1389,29,14,1347,1375,1520,189,209,232,0,,0,0.0,0.0,0.0,0.0,0.0
2024,1,13,6,2024-01-13,F9,7387,LAS,MIA,"Las Vegas, NV",Nevada,"Miami, FL",Florida,822,1504,-3,5,819,1509,18,15,837,1494,2919,368,388,401,0,,0,0.0,0.0,0.0,0.0,0.0
2024,8,4,7,2024-08-04,HA,2136,LAS,SAN,"Las Vegas, NV",Nevada,"San Diego, CA",California,2064,1217,-20,-10,2044,1207,27,3,2071,1204,2767,351,371,381,0,,0,0.0,0.0,0.0,0.0,0.0
2024,11,17,7,2024-11-17,G4,6134,PDX,CLT,"Portland, OR",Oregon,"Charlotte, NC",North Carolina,541,1521,17,15,558,1536,20,16,578,1520,2265,287,307,323,0,,0,0.0,0.0,0.0,0.0,0.0
2024,7,12,5,2024-07-12,UA,2777,DCA,EWR,"Washington, DC",District of Columbia,"Newark, NJ",New Jersey,1983,1753,-1,-10,1982,1743,5,14,1987,1729,897,115,135,134,0,,0,0.0,0.0,0.0,0.0,0.0
2024,5,23,4,2024-05-23,AA,6244,PDX,STL,"Portland, OR",Oregon,"St. Louis, MO",Missouri,1642,1224,-1,-10,1641,1214,22,6,1663,1208,2888,353,373,381,0,,0,0.0,0.0,0.0,0.0,0.0
2024,3,13,3,2024-03-13,AA,1844,LGA,ATL,"New York, NY",New York,"Atlanta, GA",Georgia,1073,1433,-14,-15,1059,1418,22,16,1081,1402,1887,230,250,268,0,,0,0.0,0.0,0.0,0.0,0.0
2024,6,4,2,2024-06-04,NK,9523,MSP,DFW,"Minneapolis, MN",Minnesota,"Dallas/Fort Worth, TX",Texas,2190,1739,11,5,2201,1744,5,6,2206,1738,2422,310,330,321,0,,0,0.0,0.0,0.0,0.0,0.0
2024,3,17,7,2024-03-17,B6,1277,DTW,SFO,"Detroit, MI",Michigan,"San Francisco, CA",California,1973,737,-3,0,1970,737,21,10,1991,727,1048,140,160,171,0,,0,0.0,0.0,0.0,0.0,0.0
2024,6,17,1,2024-06-17,MQ,861,SLC,PHL,"Salt Lake City, UT",Utah,"Philadelphia, PA",Pennsylvania,940,1014,-11,-15,929,999,24,6,953,993,2822,350,370,380,0,,0,0.0,0.0,0.0,0.0,0.0
2024,10,13,7,2024-10-13,OH,4878,LGA,MSP,"New York, NY",New York,"Minneapolis, MN",Minnesota,1712,1784,-14,-20,1698,1764,11,3,1709,1761,1113,131,151,145,0,,0,0.0,0.0,0.0,0.0,0.0
2024,3,25,1,2024-03-25,AA,6558,MSP,IAD,"Minneapolis, MN",Minnesota,"Washington, DC",District of Columbia,784,1219,-9,0,775,1219,10,8,785,1211,225,32,52,50,0,,0,0.0,0.0,0.0,0.0,0.0
2024,6,30,7,2024-06-30,AS,5723,STL,SAN,"St. Louis, MO",Missouri,"San Diego, CA",California,603,847,4,5,607,852,17,15,624,837,313,34,54,66,0,,0,0.0,0.0,0.0,0.0,0.0
2024,11,10,7,2024-11-10,OH,4814,MSP,PHL,"Minneapolis, MN",Minnesota,"Philadelphia, PA",Pennsylvania,1068,1757,0,10,1068,1767,11,4,1079,1763,1445,179,199,194,0,,0,0.0,0.0,0.0,0.0,0.0
2024,10,23,3,2024-10-23,AS,3826,LGA,PHX,"New York, NY",New York,"Phoenix, AZ",Arizona,956,1125,2,0,958,1125,28,14,986,1111,1324,155,175,197,0,,0,0.0,0.0,0.0,0.0,0.0
2024,4,21,7,2024-04-21,OH,9835,BOS,ATL,"Boston, MA",Massachusetts,"Atlanta, GA",Georgia,810,2213,6,5,816,2218,12,16,828,2202,546,63,83,91,0,,0,0.0,0.0,0.0,0.0,0.0
2024,8,17,6,2024-08-17,WN,2033,DFW,PHL,"Dallas/Fort Worth, TX",Texas,"Philadelphia, PA",Pennsylvania,2207,1894,9,5,2216,1899,16,11,2232,1888,2270,285,305,312,0,,0,0.0,0.0,0.0,0.0,0.0
2024,4,5,5,2024-04-05,NK,3661,BOS,MDW,"Boston, MA",Massachusetts,"Chicago, IL",Illinois,1907,824,-1,0,1906,824,20,12,1926,812,545,73,93,105,0,,0,0.0,0.0,0.0,0.0,0.0
2024,6,16,7,2024-06-16,NK,7279,MDW,LAX,"Chicago, IL",Illinois,"Los Angeles, CA",California,2191,1744,-14,-5,2177,1739,7,9,2184,1730,1228,146,166,162,0,,0,0.0,0.0,0.0,0.0,0.0
2024,6,4,2,2024-06-04,YX,4544,PDX,IAH,"Portland, OR",Oregon,"Houston, TX",Texas,1688,1334,-11,-15,1677,1319,11,11,1688,1308,213,27,47,49,0,,0,0.0,0.0,0.0,0.0,0.0
2024,4,14,7,2024-04-14,G4,3064,MSP,SEA,"Minneapolis, MN",Minnesota,"Seattle, WA",Washington,906,1320,9,0,915,1320,10,17,925,1303,1322,158,178,185,0,,0,0.0,0.0,0.0,0.0,0.0
2024,7,11,4,2024-07-11,YX,9322,BWI,ATL,"Baltimore, MD",Maryland,"Atlanta, GA",Georgia,1344,1062,4,5,1348,1067,17,17,1365,1050,455,58,78,92,0,,0,0.0,0.0,0.0,0.0,0.0
2024,11,25,1,2024-11-25,AA,7324,LAX,SFO,"Los Angeles, CA",California,"San Francisco, CA",California,1080,1515,-19,-10,1061,1505,18,13,1079,1492,2876,364,384,395,0,,0,0.0,0.0,0.0,0.0,0.0
2024,5,11,6,2024-05-11,B6,8881,LGA,TPA,"New York, NY",New York,"Tampa, FL",Florida,1999,839,2,0,2001,839,17,4,2018,835,935,106,126,127,0,,0,0.0,0.0,0.0,0.0,0.0
2024,12,20,5,2024-12-20,HA,3201,CLT,MCO,"Charlotte, NC",North Carolina,"Orlando, FL",Florida,1581,620,-6,-5,1575,615,12,4,1587,611,628,86,106,102,0,,0,0.0,0.0,0.0,0.0,0.0
2024,5,17,5,2024-05-17,9E,3997,EWR,PHL,"Newark, NJ",New Jersey,"Philadelphia, PA",Pennsylvania,1218,1047,-4,-10,1214,1037,23,15,1237,1022,651,71,91,109,0,,0,0.0,0.0,0.0,0.0,0.0
2024,11,26,2,2024-11-26,UA,3778,BOS,SAN,"Boston, MA",Massachusetts,"San Diego, CA",California,1939,1952,-5,-10,1934,1942,18,6,1952,1936,733,93,113,117,0,,0,0.0,0.0,0.0,0.0,0.0
2024,9,26,4,2024-09-26,NK,1943,SEA,MDW,"Seattle, WA",Washington,"Chicago, IL",Illinois,1096,1047,-6,-10,1090,1037,29,5,1119,1032,1768,221,241,255,1,,0,0.0,0.0,0.0,0.0,0.0
2024,2,7,3,2024-02-07,WN,2038,DTW,IAH,"Detroit, MI",Michigan,"Houston, TX",Texas,2136,2228,-4,-5,2132,2223,9,17,2141,2206,527,71,91,97,0,,0,0.0,0.0,0.0,0.0,0.0
2024,2,14,3,2024-02-14,WN,8544,BOS,EWR,"Boston, MA",Massachusetts,"Newark, NJ",New Jersey,1774,854,-7,-5,1767,849,22,14,1789,835,1837,225,245,261,0,,0,0.0,0.0,0.0,0.0,0.0
2024,6,11,2,2024-06-11,MQ,7966,PDX,STL,"Portland, OR",Oregon,"St. Louis, MO",Missouri,1743,1785,1,0,1744,1785,8,3,1752,1782,629,68,88,79,0,,0,0.0,0.0,0.0,0.0,0.0
2024,11,26,2,2024-11-26,YX,7183,DEN,ORD,"Denver, CO",Colorado,"Chicago, IL",Illinois,1683,902,-14,-15,1669,887,27,13,1696,874,400,41,61,81,0,,0,0.0,0.0,0.0,0.0,0.0
2024,9,9,1,2024-09-09,AA,5472,BOS,MSP,"Boston, MA",Massachusetts,"Minneapolis, MN",Minnesota,686,1376,8,0,694,1376,5,19,699,1357,1153,142,162,166,0,,0,0.0,0.0,0.0,0.0,0.0
2024,6,17,1,2024-06-17,AA,1566,DTW,SFO,"Detroit, MI",Michigan,"San Francisco, CA",California,1395,1811,-14,-20,1381,1791,5,10,1386,1781,2355,297,317,312,0,,0,0.0,0.0,0.0,0.0,0.0
2024,10,11,5,2024-10-11,9E,835,TPA,LGA,"Tampa, FL",Florida,"New York, NY",New York,2122,1223,-5,-10,2117,1213,13,16,2130,1197,611,81,101,110,0,,0,0.0,0.0,0.0,0.0,0.0
2024,9,30,1,2024-09-30,DL,439,MIA,TPA,"Miami, FL",Florida,"Tampa, FL",Florida,963,1653,-1,0,962,1653,23,7,985,1646,328,48,68,78,0,,0,0.0,0.0,0.0,0.0,0.0
2024,1,20,6,2024-01-20,HA,1476,DCA,MCO,"Washington, DC",District of Columbia,"Orlando, FL",Florida,2021,2059,4,5,2025,2064,5,17,2030,2047,2390,307,327,329,0,,0,0.0,0.0,0.0,0.0,0.0
2024,8,26,1,2024-08-26,DL,4819,DCA,LGA,"Washington, DC",District of Columbia,"New York, NY",New York,829,1938,14,5,843,1943,19,4,862,1939,2182,268,288,291,0,,0,0.0,0.0,0.0,0.0,0.0
2024,9,26,4,2024-09-26,AA,804,BOS,SFO,"Boston, MA",Massachusetts,"San Francisco, CA",California,848,1486,-29,-20,819,1466,17,9,836,1457,2366,301,321,327,0,,0,0.0,0.0,0.0,0.0,0.0
2024,11,5,2,2024-11-05,F9,3824,BWI,IAH,"Baltimore, MD",Maryland,"Houston, TX",Texas,999,987,9,0,1008,987,27,15,1035,972,1444,182,202,224,0,,0,0.0,0.0,0.0,0.0,0.0
2024,1,31,3,2024-01-31,AS,8289,PHL,LAX,"Philadelphia, PA",Pennsylvania,"Los Angeles, CA",California,2190,1279,-15,-5,2175,1274,11,13,2186,1261,2047,246,266,270,0,,0,0.0,0.0,0.0,0.0,0.0
2024,11,9,6,2024-11-09,AS,4518,SAN,LAS,"San Diego, CA",California,"Las Vegas, NV",Nevada,989,1079,10,5,999,1084,18,16,1017,1068,1812,227,247,261,0,,0,0.0,0.0,0.0,0.0,0.0
2024,4,13,6,2024-04-13,9E,5359,LAS,DEN,"Las Vegas, NV",Nevada,"Denver, CO",Colorado,1504,1207,-11,-10,1493,1197,6,12,1499,1185,316,38,58,56,0,,0,0.0,0.0,0.0,0.0,0.0
2024,6,18,2,2024-06-18,9E,9760,EWR,IAH,"Newark, NJ",New Jersey,"Houston, TX",Texas,779,734,9,5,788,739,17,6,805,733,1969,237,257,260,0,,0,0.0,0.0,0.0,0.0,0.0
2024,7,4,4,2024-07-04,G4,652,SLC,DEN,"Salt Lake City, UT",Utah,"Denver, CO",Colorado,1354,1661,4,0,1358,1661,12,17,1370,1644,324,35,55,64,0,,0,0.0,0.0,0.0,0.0,0.0
2024,5,7,2,2024-05-07,B6,3591,EWR,SLC,"Newark, NJ",New Jersey,"Salt Lake City, UT",Utah,1687,887,0,5,1687,892,16,5,1703,887,2108,253,273,274,0,,0,0.0,0.0,0.0,0.0,0.0
2024,7,28,7,2024-07-28,HA,889,BWI,ATL,"Baltimore, MD",Maryland,"Atlanta, GA",Georgia,1504,1692,36,30,1540,1722,17,13,1557,1709,2272,279,299,309,0,,0,8.0,7.0,3.0,0.0,12.0
2024,10,7,1,2024-10-07,WN,1273,BWI,TPA,"Baltimore, MD",Maryland,"Tampa, FL",Florida,897,1345,17,15,914,1360,7,19,921,1341,607,73,93,99,0,,0,0.0,0.0,0.0,0.0,0.0
2024,9,9,1,2024-09-09,HA,652,ORD,MCO,"Chicago, IL",Illinois,"Orlando, FL",Florida,1591,1690,-10,0,1581,1690,23,16,1604,1674,1108,137,157,176,0,,0,0.0,0.0,0.0,0.0,0.0
2024,1,19,5,2024-01-19,OO,3522,CLT,LAS,"Charlotte, NC",North Carolina,"Las Vegas, NV",Nevada,927,2191,17,10,944,2201,16,17,960,2184,2340,291,311,324,0,,0,0.0,0.0,0.0,0.0,0.0
2024,7,18,4,2024-07-18,AS,4311,JFK,MIA,"New York, NY",New York,"Miami, FL",Florida,1955,791,-19,-10,1936,781,25,5,1961,776,2405,305,325,335,0,,0,0.0,0.0,0.0,0.0,0.0
2024,8,7,3,2024-08-07,F9,8923,PDX,PHL,"Portland, OR",Oregon,"Philadelphia, PA",Pennsylvania,874,1743,-28,-20,846,1723,6,15,852,1708,1442,185,205,206,0,,0,0.0,0.0,0.0,0.0,0.0
2024,5,15,3,2024-05-15,OH,369,BWI,MSP,"Baltimore, MD",Maryland,"Minneapolis, MN",Minnesota,1515,1000,0,0,1515,1000,24,5,1539,995,340,50,70,79,0,,0,0.0,0.0,0.0,0.0,0.0
2024,8,10,6,2024-08-10,AA,960,LAX,DCA,"Los Angeles, CA",California,"Washington, DC",District of Columbia,2247,2023,10,20,2257,2043,22,9,2279,2034,2894,362,382,393,0,,0,7.0,2.0,3.0,0.0,8.0
2024,1,3,3,2024-01-03,NK,390,BWI,DTW,"Baltimore, MD",Maryland,"Detroit, MI",Michigan,1131,2146,0,5,1131,2151,20,19,1151,2132,1834,238,258,277,0,,0,0.0,0.0,0.0,0.0,0.0
2024,8,23,5,2024-08-23,F9,9749,HNL,IAD,"Honolulu, HI",Hawaii,"Washington, DC",District of Columbia,1488,1508,0,-5,1488,1503,13,11,1501,1492,909,112,132,136,0,,0,0.0,0.0,0.0,0.0,0.0
2024,12,7,6,2024-12-07,G4,5970,LGA,SAN,"New York, NY",New York,"San Diego, CA",California,1196,1257,9,5,1205,1262,26,16,1231,1246,1757,209,229,251,0,,0,0.0,0.0,0.0,0.0,0.0
2024,8,15,4,2024-08-15,OO,729,TPA,PDX,"Tampa, FL",Florida,"Portland, OR",Oregon,1946,1637,-22,-20,1924,1617,21,10,1945,1607,1026,132,152,163,0,,0,0.0,0.0,0.0,0.0,0.0
2024,5,21,2,2024-05-21,F9,7107,ORD,PHX,"Chicago, IL",Illinois,"Phoenix, AZ",Arizona,1427,2169,1,0,1428,2169,29,16,1457,2153,2645,338,358,383,0,,0,0.0,0.0,0.0,0.0,0.0
2024,1,9,2,2024-01-09,NK,6043,DEN,TPA,"Denver, CO",Colorado,"Tampa, FL",Florida,2251,2339,-11,-10,2240,2329,28,7,2268,2322,1753,219,239,254,0,,0,0.0,0.0,0.0,0.0,0.0
2024,7,8,1,2024-07-08,UA,574,HNL,LAS,"Honolulu, HI",Hawaii,"Las Vegas, NV",Nevada,2165,2221,-24,-20,2141,2201,22,16,2163,2185,1271,157,177,195,0,,0,0.0,0.0,0.0,0.0,0.0
2024,12,15,7,2024-12-15,DL,4732,MSP,CLT,"Minneapolis, MN",Minnesota,"Charlotte, NC",North Carolina,577,1068,-11,-10,566,1058,23,14,589,1044,292,26,46,63,0,,0,0.0,0.0,0.0,0.0,0.0
2024,6,13,4,2024-06-13,HA,4180,TPA,EWR,"Tampa, FL",Florida,"Newark, NJ",New Jersey,987,1492,1,5,988,1497,11,10,999,1487,225,31,51,52,0,,0,0.0,0.0,0.0,0.0,0.0
2024,5,18,6,2024-05-18,UA,1860,PHL,BWI,"Philadelphia, PA",Pennsylvania,"Baltimore, MD",Maryland,1693,753,-5,0,1688,753,8,3,1696,750,364,47,67,58,0,,0,0.0,0.0,0.0,0.0,0.0
2024,10,2,3,2024-10-02,WN,4808,MSP,BOS,"Minneapolis, MN",Minnesota,"Boston, MA",Massachusetts,1561,1793,-18,-20,1543,1773,12,18,1555,1755,647,71,91,101,0,,0,0.0,0.0,0.0,0.0,0.0
2024,10,17,4,2024-10-17,WN,7020,DTW,PHX,"Detroit, MI",Michigan,"Phoenix, AZ",Arizona,1066,1556,-5,-5,1061,1551,5,10,1066,1541,692,83,103,98,0,,0,0.0,0.0,0.0,0.0,0.0
2024,2,22,4,2024-02-22,AS,3498,BOS,ORD,"Boston, MA",Massachusetts,"Chicago, IL",Illinois,1450,1278,2,5,1452,1283,14,7,1466,1276,645,80,100,101,0,,0,0.0,0.0,0.0,0.0,0.0
2024,6,23,7,2024-06-23,YX,3661,EWR,DEN,"Newark, NJ",New Jersey,"Denver, CO",Colorado,1813,2009,14,20,1827,2029,8,5,1835,2024,867,116,136,129,0,,0,7.0,1.0,2.0,0.0,10.0
2024,4,19,5,2024-04-19,NK,3944,ATL,SLC,"Atlanta, GA",Georgia,"Salt Lake City, UT",Utah,1057,1296,2,10,1059,1306,21,15,1080,1291,2130,274,294,310,0,,0,0.0,0.0,0.0,0.0,0.0
2024,7,21,7,2024-07-21,YX,3904,SLC,SFO,"Salt Lake City, UT",Utah,"San Francisco, CA",California,670,905,-27,-20,643,885,11,7,654,878,979,122,142,140,0,,0,0.0,0.0,0.0,0.0,0.0
2024,5,15,3,2024-05-15,WN,9916,LAX,SAN,"Los Angeles, CA",California,"San Diego, CA",California,1141,2248,-17,-10,1124,2238,29,5,1153,2233,2787,342,362,376,0,,0,0.0,0.0,0.0,0.0,0.0
2024,1,4,4,2024-01-04,9E,1608,TPA,HNL,"Tampa, FL",Florida,"Honolulu, HI",Hawaii,2199,2279,-12,-10,2187,2269,5,16,2192,2253,1439,185,205,206,0,,0,0.0,0.0,0.0,0.0,0.0
2024,6,3,1,2024-06-03,AS,4210,BWI,SAN,"Baltimore, MD",Maryland,"San Diego, CA",California,2105,1941,-15,-5,2090,1936,20,8,2110,1928,1254,148,168,176,0,,0,0.0,0.0,0.0,0.0,0.0
2024,6,20,4,2024-06-20,G4,4953,ATL,MDW,"Atlanta, GA",Georgia,"Chicago, IL",Illinois,791,953,4,0,795,953,28,9,823,944,2744,350,370,387,0,,0,0.0,0.0,0.0,0.0,0.0
2024,12,23,1,2024-12-23,OH,6931,SEA,HNL,"Seattle, WA",Washington,"Honolulu, HI",Hawaii,1080,1506,-8,-10,1072,1496,14,8,1086,1488,1479,191,211,213,0,,0,0.0,0.0,0.0,0.0,0.0
2024,2,16,5,2024-02-16,AS,8295,HNL,BOS,"Honolulu, HI",Hawaii,"Boston, MA",Massachusetts,921,1834,9,15,930,1849,15,16,945,1833,612,76,96,107,0,,0,0.0,0.0,0.0,0.0,0.0
2024,4,3,3,2024-04-03,OH,3547,DCA,STL,"Washington, DC",District of Columbia,"St. Louis, MO",Missouri,604,2326,12,5,616,2331,10,6,626,2325,1100,139,159,155,0,,0,0.0,0.0,0.0,0.0,0.0
2024,2,17,6,2024-02-17,UA,5684,BOS,SFO,"Boston, MA",Massachusetts,"San Francisco, CA",California,1065,1397,-11,-5,1054,1392,26,12,1080,1380,1854,233,253,271,0,,0,0.0,0.0,0.0,0.0,0.0
2024,8,27,2,2024-08-27,AA,3891,DEN,LAX,"Denver, CO",Colorado,"Los Angeles, CA",California,1929,1293,0,0,1929,1293,28,15,1957,1278,2116,256,276,299,0,,0,0.0,0.0,0.0,0.0,0.0
2024,12,12,4,2024-12-12,OO,5181,LGA,PHX,"New York, NY",New York,"Phoenix, AZ",Arizona,1379,2078,-8,0,1371,2078,5,14,1376,2064,340,47,67,66,0,,0,0.0,0.0,0.0,0.0,0.0
2024,7,31,3,2024-07-31,9E,9452,HNL,LAS,"Honolulu, HI",Hawaii,"Las Vegas, NV",Nevada,1982,2290,-7,0,1975,2290,13,16,1988,2274,2676,337,357,366,0,,0,0.0,0.0,0.0,0.0,0.0
2024,12,5,4,2024-12-05,9E,933,MSP,EWR,"Minneapolis, MN",Minnesota,"Newark, NJ",New Jersey,1374,1453,6,10,1380,1463,15,15,1395,1448,2662,325,345,355,0,,0,0.0,0.0,0.0,0.0,0.0
2024,11,19,2,2024-11-19,MQ,5435,DCA,DTW,"Washington, DC",District of Columbia,"Detroit, MI",Michigan,747,791,-17,-10,730,781,10,11,740,770,670,77,97,98,0,,0,0.0,0.0,0.0,0.0,0.0
2024,5,18,6,2024-05-18,B6,5587,JFK,HNL,"New York, NY",New York,"Honolulu, HI",Hawaii,1426,1192,-3,5,1423,1197,23,18,1446,1179,1090,131,151,172,0,,0,0.0,0.0,0.0,0.0,0.0
2024,7,23,2,2024-07-23,9E,6360,SAN,DTW,"San Diego, CA",California,"Detroit, MI",Michigan,808,1958,-16,-15,792,1943,17,11,809,1932,2903,366,386,394,0,,0,0.0,0.0,0.0,0.0,0.0
2024,3,13,3,2024-03-13,9E,9494,DTW,DEN,"Detroit, MI",Michigan,"Denver, CO",Colorado,1896,1504,9,0,1905,1504,21,8,1926,1496,1179,145,165,174,0,,0,0.0,0.0,0.0,0.0,0.0
2024,1,4,4,2024-01-04,UA,2275,MIA,BWI,"Miami, FL",Florida,"Baltimore, MD",Maryland,1629,1567,0,0,1629,1567,18,16,1647,1551,1468,185,205,219,0,,0,0.0,0.0,0.0,0.0,0.0
2024,3,16,6,2024-03-16,F9,9673,BWI,TPA,"Baltimore, MD",Maryland,"Tampa, FL",Florida,814,1619,-13,-20,801,1599,24,9,825,1590,1359,171,191,204,0,,0,0.0,0.0,0.0,0.0,0.0
2024,11,24,7,2024-11-24,9E,4273,EWR,PHL,"Newark, NJ",New Jersey,"Philadelphia, PA",Pennsylvania,1108,1497,-25,-15,1083,1482,25,5,1108,1477,2935,361,381,391,0,,0,0.0,0.0,0.0,0.0,0.0
2024,3,17,7,2024-03-17,HA,2888,IAD,EWR,"Washington, DC",District of Columbia,"Newark, NJ",New Jersey,1444,2184,-17,-15,1427,2169,8,17,1435,2152,2968,378,398,403,0,,0,0.0,0.0,0.0,0.0,0.0
2024,10,30,3,2024-10-30,AA,7560,STL,HNL,"St. Louis, MO",Missouri,"Honolulu, HI",Hawaii,1038,1415,1,-5,1039,1410,11,14,1050,1396,1415,181,201,206,0,,1,0.0,0.0,0.0,0.0,0.0
2024,9,12,4,2024-09-12,OO,8633,SLC,MCO,"Salt Lake City, UT",Utah,"Orlando, FL",Florida,571,1166,1,0,572,1166,19,3,591,1163,2553,324,344,346,0,,0,0.0,0.0,0.0,0.0,0.0
2024,4,11,4,2024-04-11,DL,9653,MCO,ORD,"Orlando, FL",Florida,"Chicago, IL",Illinois,877,1690,50,60,927,1750,26,13,953,1737,346,48,68,87,0,,0,3.0,16.0,9.0,1.0,31.0
2024,4,15,1,2024-04-15,UA,6821,DTW,PHL,"Detroit, MI",Michigan,"Philadelphia, PA",Pennsylvania,2019,1226,-14,-10,2005,1216,14,5,2019,1211,1266,158,178,177,0,,0,0.0,0.0,0.0,0.0,0.0
2024,11,28,4,2024-11-28,UA,4291,DTW,IAD,"Detroit, MI",Michigan,"Washington, DC",District of Columbia,1708,711,-12,-15,1696,696,9,19,1705,677,2220,275,295,303,0,,0,0.0,0.0,0.0,0.0,0.0
2024,2,8,4,2024-02-08,YX,7412,TPA,JFK,"Tampa, FL",Florida,"New York, NY",New York,633,1270,-7,-5,626,1265,17,15,643,1250,564,60,80,92,0,,0,0.0,0.0,0.0,0.0,0.0
2024,11,9,6,2024-11-09,F9,8287,LAX,MDW,"Los Angeles, CA",California,"Chicago, IL",Illinois,1697,1730,-14,-15,1683,1715,19,10,1702,1705,1826,230,250,259,0,,0,0.0,0.0,0.0,0.0,0.0
2024,10,1,2,2024-10-01,B6,4716,SLC,TPA,"Salt Lake City, UT",Utah,"Tampa, FL",Florida,2133,625,-23,-20,2110,605,7,15,2117,590,1558,184,204,206,0,,0,0.0,0.0,0.0,0.0,0.0
2024,3,28,4,2024-03-28,F9,1095,IAH,PHL,"Houston, TX",Texas,"Philadelphia, PA",Pennsylvania,892,1600,-4,0,888,1600,29,10,917,1590,1404,184,204,223,0,,0,0.0,0.0,0.0,0.0,0.0
2024,7,29,1,2024-07-29,OO,456,DFW,SAN,"Dallas/Fort Worth, TX",Texas,"San Diego, CA",California,1587,1221,13,10,1600,1231,23,10,1623,1221,256,37,57,70,0,,0,0.0,0.0,0.0,0.0,0.0
2024,3,17,7,2024-03-17,OH,8477,PHX,JFK,"Phoenix, AZ",Arizona,"New York, NY",New York,1495,1689,1,10,1496,1699,7,15,1503,1684,2512,310,330,332,0,,0,0.0,0.0,0.0,0.0,0.0
2024,3,17,7,2024-03-17,HA,1793,DFW,IAH,"Dallas/Fort Worth, TX",Texas,"Houston, TX",Texas,914,2037,-24,-15,890,2022,23,14,913,2008,854,109,129,146,0,,0,0.0,0.0,0.0,0.0,0.0
2024,1,28,7,2024-01-28,HA,2690,IAH,JFK,"Houston, TX",Texas,"New York, NY",New York,902,1316,-6,-15,896,1301,16,7,912,1294,2995,372,392,395,0,,0,0.0,0.0,0.0,0.0,0.0
2024,9,1,7,2024-09-01,OO,9634,SEA,PDX,"Seattle, WA",Washington,"Portland, OR",Oregon,1636,1212,6,0,1642,1212,18,15,1660,1197,1762,227,247,260,0,,0,0.0,0.0,0.0,0.0,0.0
2024,3,6,3,2024-03-06,AS,8021,TPA,CLT,"Tampa, FL",Florida,"Charlotte, NC",North Carolina,564,2123,-6,-5,558,2118,12,14,570,2104,1396,176,196,202,0,,0,0.0,0.0,0.0,0.0,0.0
2024,9,22,7,2024-09-22,HA,1791,TPA,PDX,"Tampa, FL",Florida,"Portland, OR",Oregon,2251,2341,-1,5,2250,2346,22,12,2272,2334,2236,281,301,315,1,,0,0.0,0.0,0.0,0.0,0.0
2024,7,23,2,2024-07-23,YX,9374,DEN,SAN,"Denver, CO",Colorado,"San Diego, CA",California,1365,1624,-10,0,1355,1624,8,17,1363,1607,205,18,38,43,0,,0,0.0,0.0,0.0,0.0,0.0
2024,2,27,2,2024-02-27,DL,2157,ORD,BOS,"Chicago, IL",Illinois,"Boston, MA",Massachusetts,900,1181,-26,-20,874,1161,28,4,902,1157,2263,288,308,320,0,,0,0.0,0.0,0.0,0.0,0.0
2024,7,19,5,2024-07-19,OO,3004,PDX,STL,"Portland, OR",Oregon,"St. Louis, MO",Missouri,789,2285,-17,-10,772,2275,15,8,787,2267,967,114,134,137,0,,0,0.0,0.0,0.0,0.0,0.0
2024,8,12,1,2024-08-12,WN,4551,MDW,TPA,"Chicago, IL",Illinois,"Tampa, FL",Florida,2006,1058,16,15,2022,1073,21,18,2043,1055,2472,315,335,354,0,,0,0.0,0.0,0.0,0.0,0.0
2024,5,21,2,2024-05-21,G4,7037,CLT,EWR,"Charlotte, NC",North Carolina,"Newark, NJ",New Jersey,1943,968,3,0,1946,968,23,3,1969,965,1305,169,189,195,0,,0,0.0,0.0,0.0,0.0,0.0
2024,3,24,7,2024-03-24,WN,2480,BOS,HNL,"Boston, MA",Massachusetts,"Honolulu, HI",Hawaii,1838,1326,5,5,1843,1331,8,4,1851,1327,456,56,76,68,0,,0,0.0,0.0,0.0,0.0,0.0
2024,5,22,3,2024-05-22,B6,8308,EWR,TPA,"Newark, NJ",New Jersey,"Tampa, FL",Florida,1612,741,-12,-5,1600,736,10,17,1610,719,340,47,67,74,0,,0,0.0,0.0,0.0,0.0,0.0
2024,12,17,2,2024-12-17,B6,8615,IAD,SEA,"Washington, DC",District of Columbia,"Seattle, WA",Washington,1258,613,3,5,1261,618,6,18,1267,600,1101,140,160,164,0,,0,0.0,0.0,0.0,0.0,0.0
2024,2,2,5,2024-02-02,9E,2170,BOS,JFK,"Boston, MA",Massachusetts,"New York, NY",New York,1343,2091,-18,-10,1325,2081,11,10,1336,2071,2329,282,302,303,0,,0,0.0,0.0,0.0,0.0,0.0
2024,5,31,5,2024-05-31,F9,1030,SLC,LGA,"Salt Lake City, UT",Utah,"New York, NY",New York,1160,1310,-3,5,1157,1315,23,16,1180,1299,837,108,128,147,0,,0,0.0,0.0,0.0,0.0,0.0
2024,6,6,4,2024-06-06,AS,1544,LGA,STL,"New York, NY",New York,"St. Louis, MO",Missouri,856,1130,-3,5,853,1135,18,12,871,1123,748,89,109,119,0,,0,0.0,0.0,0.0,0.0,0.0
2024,5,20,1,2024-05-20,9E,8694,JFK,IAD,"New York, NY",New York,"Washington, DC",District of Columbia,1377,2033,-19,-15,1358,2018,20,17,1378,2001,2749,335,355,372,0,,0,0.0,0.0,0.0,0.0,0.0
2024,9,7,6,2024-09-07,NK,3502,EWR,BOS,"Newark, NJ",New Jersey,"Boston, MA",Massachusetts,1497,1426,-20,-10,1477,1416,12,5,1489,1411,1687,217,237,234,0,,0,0.0,0.0,0.0,0.0,0.0
2024,10,29,2,2024-10-29,AS,4652,BWI,HNL,"Baltimore, MD",Maryland,"Honolulu, HI",Hawaii,1251,1773,2,0,1253,1773,22,8,1275,1765,661,86,106,116,0,,0,0.0,0.0,0.0,0.0,0.0
2024,4,21,7,2024-04-21,OH,9798,BWI,DTW,"Baltimore, MD",Maryland,"Detroit, MI",Michigan,2041,1430,-7,0,2034,1430,13,4,2047,1426,1611,201,221,218,0,,0,0.0,0.0,0.0,0.0,0.0
2024,5,23,4,2024-05-23,OH,1621,ATL,MSP,"Atlanta, GA",Georgia,"Minneapolis, MN",Minnesota,1248,1956,1,0,1249,1956,8,11,1257,1945,2901,358,378,377,0,,0,0.0,0.0,0.0,0.0,0.0
2024,7,27,6,2024-07-27,OH,3198,MDW,PHL,"Chicago, IL",Illinois,"Philadelphia, PA",Pennsylvania,864,1697,2,5,866,1702,18,9,884,1693,2312,287,307,314,0,,0,0.0,0.0,0.0,0.0,0.0
2024,8,11,7,2024-08-11,B6,8220,MSP,PHX,"Minneapolis, MN",Minnesota,"Phoenix, AZ",Arizona,766,1037,13,5,779,1042,28,8,807,1034,1535,189,209,225,0,,0,0.0,0.0,0.0,0.0,0.0
2024,2,12,1,2024-02-12,HA,7455,SAN,LGA,"San Diego, CA",California,"New York, NY",New York,905,982,-5,0,900,982,24,3,924,979,1570,186,206,213,0,,0,0.0,0.0,0.0,0.0,0.0
2024,9,20,5,2024-09-20,B6,2287,IAH,HNL,"Houston, TX",Texas,"Honolulu, HI",Hawaii,2273,1514,-1,0,2272,1514,26,16,2298,1498,2625,319,339,361,0,,0,0.0,0.0,0.0,0.0,0.0
2024,8,31,6,2024-08-31,UA,2668,DCA,SLC,"Washington, DC",District of Columbia,"Salt Lake City, UT",Utah,638,1974,-18,-20,620,1954,28,10,648,1944,2637,331,351,369,0,,0,0.0,0.0,0.0,0.0,0.0
2024,1,3,3,2024-01-03,NK,8383,PHX,PHL,"Phoenix, AZ",Arizona,"Philadelphia, PA",Pennsylvania,1688,1889,-18,-10,1670,1879,25,10,1695,1869,720,81,101,116,0,,0,0.0,0.0,0.0,0.0,0.0
2024,5,4,6,2024-05-04,MQ,5047,DFW,LAS,"Dallas/Fort Worth, TX",Texas,"Las Vegas, NV",Nevada,2220,1404,-2,0,2218,1404,26,8,2244,1396,254,32,52,66,0,,0,0.0,0.0,0.0,0.0,0.0
2024,9,24,2,2024-09-24,9E,5040,BWI,PHX,"Baltimore, MD",Maryland,"Phoenix, AZ",Arizona,1165,1572,4,5,1169,1577,22,17,1191,1560,231,26,46,65,0,,0,0.0,0.0,0.0,0.0,0.0
2024,3,24,7,2024-03-24,B6,4862,MSP,DEN,"Minneapolis, MN",Minnesota,"Denver, CO",Colorado,1629,2280,12,10,1641,2290,24,19,1665,2271,2777,356,376,399,0,,0,0.0,0.0,0.0,0.0,0.0
2024,1,16,2,2024-01-16,NK,1853,ORD,ATL,"Chicago, IL",Illinois,"Atlanta, GA",Georgia,1672,1550,10,5,1682,1555,9,8,1691,1547,552,67,87,84,0,,0,0.0,0.0,0.0,0.0,0.0
2024,11,29,5,2024-11-29,HA,5154,DCA,LGA,"Washington, DC",District of Columbia,"New York, NY",New York,684,2268,-3,0,681,2268,5,9,686,2259,2380,301,321,315,0,,0,0.0,0.0,0.0,0.0,0.0
2024,2,28,3,2024-02-28,DL,4992,ORD,SEA,"Chicago, IL",Illinois,"Seattle, WA",Washington,1933,1004,-10,-10,1923,994,27,12,1950,982,2387,298,318,337,0,,0,0.0,0.0,0.0,0.0,0.0
2024,6,25,2,2024-06-25,G4,5881,HNL,SAN,"Honolulu, HI",Hawaii,"San Diego, CA",California,1282,1620,-14,-5,1268,1615,10,11,1278,1604,2696,334,354,355,0,,0,0.0,0.0,0.0,0.0,0.0
2024,3,3,7,2024-03-03,F9,187,BOS,LAS,"Boston, MA",Massachusetts,"Las Vegas, NV",Nevada,1370,1485,-12,-20,1358,1465,24,7,1382,1458,2445,298,318,329,0,,0,0.0,0.0,0.0,0.0,0.0
2024,2,18,7,2024-02-18,HA,1741,CLT,ORD,"Charlotte, NC",North Carolina,"Chicago, IL",Illinois,1202,2046,-9,0,1193,2046,8,4,1201,2042,1432,183,203,195,0,,0,0.0,0.0,0.0,0.0,0.0
2024,11,2,6,2024-11-02,B6,3062,ATL,LAX,"Atlanta, GA",Georgia,"Los Angeles, CA",California,2198,2283,-20,-15,2178,2268,23,15,2201,2253,591,67,87,105,0,,0,0.0,0.0,0.0,0.0,0.0
2024,9,2,1,2024-09-02,DL,5513,SLC,PHX,"Salt Lake City, UT",Utah,"Phoenix, AZ",Arizona,1406,1566,-10,-15,1396,1551,21,13,1417,1538,2892,352,372,386,0,,0,0.0,0.0,0.0,0.0,0.0
2024,10,15,2,2024-10-15,AS,7520,BWI,LAX,"Baltimore, MD",Maryland,"Los Angeles, CA",California,700,678,5,0,705,678,10,13,715,665,2730,338,358,361,0,,0,0.0,0.0,0.0,0.0,0.0
2024,10,12,6,2024-10-12,F9,8842,BOS,DCA,"Boston, MA",Massachusetts,"Washington, DC",District of Columbia,1117,908,-24,-20,1093,888,9,17,1102,871,2019,249,269,275,0,,0,0.0,0.0,0.0,0.0,0.0
2024,11,27,3,2024-11-27,NK,7010,IAD,PHL,"Washington, DC",District of Columbia,"Philadelphia, PA",Pennsylvania,2250,1326,0,0,2250,1326,10,16,2260,1310,1686,209,229,235,0,,0,0.0,0.0,0.0,0.0,0.0
2024,1,15,1,2024-01-15,F9,5273,ATL,CLT,"Atlanta, GA",Georgia,"Charlotte, NC",North Carolina,719,1656,5,0,724,1656,5,13,729,1643,2051,251,271,269,0,,0,0.0,0.0,0.0,0.0,0.0
2024,12,3,2,2024-12-03,WN,5329,MDW,MIA,"Chicago, IL",Illinois,"Miami, FL",Florida,1356,1489,0,5,1356,1494,22,15,1378,1479,1315,164,184,201,0,,0,0.0,0.0,0.0,0.0,0.0
2024,9,11,3,2024-09-11,OH,8915,SLC,STL,"Salt Lake City, UT",Utah,"St. Louis, MO",Missouri,1993,2051,-21,-15,1972,2036,19,9,1991,2027,543,58,78,86,0,,0,0.0,0.0,0.0,0.0,0.0
2024,4,1,1,2024-04-01,UA,3857,MSP,HNL,"Minneapolis, MN",Minnesota,"Honolulu, HI",Hawaii,2252,2329,-22,-20,2230,2309,20,19,2250,2290,2337,301,321,340,0,,0,0.0,0.0,0.0,0.0,0.0
2024,10,5,6,2024-10-05,NK,4896,HNL,JFK,"Honolulu, HI",Hawaii,"New York, NY",New York,1511,2313,-3,5,1508,2318,27,13,1535,2305,1295,162,182,202,0,,0,0.0,0.0,0.0,0.0,0.0
2024,7,24,3,2024-07-24,DL,3392,JFK,PHL,"New York, NY",New York,"Philadelphia, PA",Pennsylvania,1957,1958,-13,-10,1944,1948,13,8,1957,1940,554,73,93,94,0,,0,0.0,0.0,0.0,0.0,0.0
2024,4,3,3,2024-04-03,OH,3932,IAD,DTW,"Washington, DC",District of Columbia,"Detroit, MI",Michigan,1552,2078,7,10,1559,2088,26,16,1585,2072,2830,360,380,402,0,,0,0.0,0.0,0.0,0.0,0.0
2024,8,12,1,2024-08-12,B6,2711,LAX,STL,"Los Angeles, CA",California,"St. Louis, MO",Missouri,2273,1312,-4,-10,2269,1302,26,8,2295,1294,728,82,102,116,0,,0,0.0,0.0,0.0,0.0,0.0
2024,10,27,7,2024-10-27,MQ,8453,PHL,EWR,"Philadelphia, PA",Pennsylvania,"Newark, NJ",New Jersey,563,1550,-5,0,558,1550,9,16,567,1534,2810,356,376,381,0,,0,0.0,0.0,0.0,0.0,0.0
2024,11,13,3,2024-11-13,NK,8328,LAX,IAD,"Los Angeles, CA",California,"Washington, DC",District of Columbia,1436,2035,-14,-15,1422,2020,15,5,1437,2015,1322,163,183,183,0,,0,0.0,0.0,0.0,0.0,0.0
2024,7,17,3,2024-07-17,AA,9137,DCA,DTW,"Washington, DC",District of Columbia,"Detroit, MI",Michigan,1619,1069,-10,-5,1609,1064,9,19,1618,1045,1543,197,217,225,0,,0,0.0,0.0,0.0,0.0,0.0
2024,9,27,5,2024-09-27,WN,6866,DCA,SLC,"Washington, DC",District of Columbia,"Salt Lake City, UT",Utah,2189,2138,14,10,2203,2148,10,9,2213,2139,2946,362,382,381,0,,0,0.0,0.0,0.0,0.0,0.0
2024,8,21,3,2024-08-21,HA,7637,CLT,TPA,"Charlotte, NC",North Carolina,"Tampa, FL",Florida,1039,1164,0,0,1039,1164,6,19,1045,1145,2830,361,381,386,0,,0,0.0,0.0,0.0,0.0,0.0
2024,2,15,4,2024-02-15,DL,5396,TPA,CLT,"Tampa, FL",Florida,"Charlotte, NC",North Carolina,1009,1537,4,5,1013,1542,14,12,1027,1530,2810,352,372,378,0,,0,0.0,0.0,0.0,0.0,0.0
2024,3,4,1,2024-03-04,AS,3446,DCA,HNL,"Washington, DC",District of Columbia,"Honolulu, HI",Hawaii,1863,720,-19,-10,1844,710,26,15,1870,695,1034,122,142,163,0,,0,0.0,0.0,0.0,0.0,0.0
2024,8,17,6,2024-08-17,YX,4154,SEA,SAN,"Seattle, WA",Washington,"San Diego, CA",California,2211,749,10,15,2221,764,8,10,2229,754,217,28,48,46,0,,0,0.0,0.0,0.0,0.0,0.0
2024,9,5,4,2024-09-05,AA,4300,CLT,LGA,"Charlotte, NC",North Carolina,"New York, NY",New York,750,752,8,0,758,752,18,7,776,745,2876,367,387,392,0,,0,0.0,0.0,0.0,0.0,0.0
2024,9,2,1,2024-09-02,NK,8627,ORD,JFK,"Chicago, IL",Illinois,"New York, NY",New York,2229,2352,-9,-15,2220,2337,7,3,2227,2334,1890,233,253,243,0,,0,0.0,0.0,0.0,0.0,0.0
2024,3,15,5,2024-03-15,UA,1660,IAD,SEA,"Washington, DC",District of Columbia,"Seattle, WA",Washington,1802,1603,-22,-20,1780,1583,17,19,1797,1564,359,39,59,75,0,,0,0.0,0.0,0.0,0.0,0.0
2024,6,5,3,2024-06-05,YX,7622,ATL,MSP,"Atlanta, GA",Georgia,"Minneapolis, MN",Minnesota,538,2270,-29,-20,509,2250,27,7,536,2243,274,38,58,72,0,,0,0.0,0.0,0.0,0.0,0.0
2024,8,10,6,2024-08-10,AA,4264,MSP,PDX,"Minneapolis, MN",Minnesota,"Portland, OR",Oregon,568,1879,-22,-15,546,1864,19,18,565,1846,1909,231,251,268,0,,0,0.0,0.0,0.0,0.0,0.0
2024,7,8,1,2024-07-08,HA,6820,STL,TPA,"St. Louis, MO",Missouri,"Tampa, FL",Florida,776,1173,13,15,789,1188,20,5,809,1183,875,107,127,132,0,,0,0.0,0.0,0.0,0.0,0.0
2024,2,21,3,2024-02-21,F9,8953,HNL,TPA,"Honolulu, HI",Hawaii,"Tampa, FL",Florida,1643,1686,-8,-5,1635,1681,9,11,1644,1670,275,40,60,60,0,,0,0.0,0.0,0.0,0.0,0.0
2024,3,28,4,2024-03-28,NK,5539,JFK,TPA,"New York, NY",New York,"Tampa, FL",Florida,1609,1916,-17,-10,1592,1906,14,16,1606,1890,2459,301,321,331,0,,0,0.0,0.0,0.0,0.0,0.0
2024,11,8,5,2024-11-08,DL,4952,TPA,HNL,"Tampa, FL",Florida,"Honolulu, HI",Hawaii,676,667,-15,-5,661,662,7,19,668,643,522,73,93,99,0,,0,0.0,0.0,0.0,0.0,0.0
2024,12,4,3,2024-12-04,NK,6695,LAS,BWI,"Las Vegas, NV",Nevada,"Baltimore, MD",Maryland,1470,824,-5,-5,1465,819,20,17,1485,802,2534,321,341,358,0,,0,0.0,0.0,0.0,0.0,0.0
2024,3,6,3,2024-03-06,UA,6813,DEN,DCA,"Denver, CO",Colorado,"Washington, DC",District of Columbia,1105,1446,-10,-10,1095,1436,12,10,1107,1426,2843,355,375,377,0,,0,0.0,0.0,0.0,0.0,0.0
2024,5,29,3,2024-05-29,HA,3283,TPA,BOS,"Tampa, FL",Florida,"Boston, MA",Massachusetts,1615,2272,-19,-15,1596,2257,20,6,1616,2251,943,108,128,134,0,,0,0.0,0.0,0.0,0.0,0.0
2024,1,20,6,2024-01-20,MQ,9777,CLT,SFO,"Charlotte, NC",North Carolina,"San Francisco, CA",California,1943,2077,-8,-15,1935,2062,9,17,1944,2045,2610,320,340,346,0,,0,0.0,0.0,0.0,0.0,0.0
2024,2,2,5,2024-02-02,G4,8132,CLT,LAS,"Charlotte, NC",North Carolina,"Las Vegas, NV",Nevada,580,1157,-3,0,577,1157,15,19,592,1138,2934,358,378,392,0,,0,0.0,0.0,0.0,0.0,0.0
2024,11,23,6,2024-11-23,F9,2509,MDW,MIA,"Chicago, IL",Illinois,"Miami, FL",Florida,840,2230,-1,-5,839,2225,23,13,862,2212,447,61,81,97,0,,0,0.0,0.0,0.0,0.0,0.0
2024,10,7,1,2024-10-07,B6,4398,MIA,IAH,"Miami, FL",Florida,"Houston, TX",Texas,920,1913,14,15,934,1928,20,14,954,1914,881,104,124,138,0,,0,0.0,0.0,0.0,0.0,0.0
2024,2,15,4,2024-02-15,NK,2634,MDW,BWI,"Chicago, IL",Illinois,"Baltimore, MD",Maryland,727,1475,3,0,730,1475,18,16,748,1459,338,46,66,80,0,,0,0.0,0.0,0.0,0.0,0.0
2024,3,13,3,2024-03-13,UA,5699,HNL,MSP,"Honolulu, HI",Hawaii,"Minneapolis, MN",Minnesota,972,846,-9,0,963,846,15,9,978,837,1972,246,266,270,0,,0,0.0,0.0,0.0,0.0,0.0
2024,12,19,4,2024-12-19,AA,103,DFW,MDW,"Dallas/Fort Worth, TX",Texas,"Chicago, IL",Illinois,587,1939,14,15,601,1954,18,5,619,1949,2416,309,329,332,0,,0,0.0,0.0,0.0,0.0,0.0
2024,11,8,5,2024-11-08,AA,126,STL,DCA,"St. Louis, MO",Missouri,"Washington, DC",District of Columbia,1873,1508,8,0,1881,1508,20,13,1901,1495,1003,119,139,152,0,,0,0.0,0.0,0.0,0.0,0.0
2024,12,8,7,2024-12-08,HA,5261,SFO,MIA,"San Francisco, CA",California,"Miami, FL",Florida,2163,891,4,0,2167,891,29,4,2196,887,834,96,116,129,0,,0,0.0,0.0,0.0,0.0,0.0
2024,5,12,7,2024-05-12,OO,1064,EWR,MDW,"Newark, NJ",New Jersey,"Chicago, IL",Illinois,689,2103,4,-5,693,2098,22,19,715,2079,1542,183,203,224,0,,0,0.0,0.0,0.0,0.0,0.0
2024,2,24,6,2024-02-24,DL,6307,LGA,LAX,"New York, NY",New York,"Los Angeles, CA",California,1366,813,-4,5,1362,818,7,12,1369,806,1731,207,227,226,0,,0,0.0,0.0,0.0,0.0,0.0
2024,3,1,5,2024-03-01,F9,3196,MDW,TPA,"Chicago, IL",Illinois,"Tampa, FL",Florida,1480,1367,1,-5,1481,1362,7,3,1488,1359,1622,211,231,221,0,,0,0.0,0.0,0.0,0.0,0.0
2024,12,10,2,2024-12-10,AA,171,STL,LAS,"St. Louis, MO",Missouri,"Las Vegas, NV",Nevada,2169,2183,-8,0,2161,2183,5,15,2166,2168,585,70,90,90,0,,0,0.0,0.0,0.0,0.0,0.0
2024,1,8,1,2024-01-08,OO,5701,CLT,DTW,"Charlotte, NC",North Carolina,"Detroit, MI",Michigan,1480,1204,-12,-5,1468,1199,16,16,1484,1183,484,62,82,94,0,,0,0.0,0.0,0.0,0.0,0.0
2024,9,28,6,2024-09-28,YX,3047,BOS,DTW,"Boston, MA",Massachusetts,"Detroit, MI",Michigan,635,1570,-6,0,629,1570,11,19,640,1551,496,62,82,92,0,,0,0.0,0.0,0.0,0.0,0.0
2024,9,2,1,2024-09-02,B6,6338,PDX,BWI,"Portland, OR",Oregon,"Baltimore, MD",Maryland,1848,2141,11,10,1859,2151,15,12,1874,2139,240,28,48,55,0,,0,0.0,0.0,0.0,0.0,0.0
2024,6,24,1,2024-06-24,G4,4590,IAH,HNL,"Houston, TX",Texas,"Honolulu, HI",Hawaii,539,1816,3,-5,542,1811,17,17,559,1794,2498,312,332,346,0,,0,0.0,0.0,0.0,0.0,0.0
2024,4,25,4,2024-04-25,YX,2511,DTW,JFK,"Detroit, MI",Michigan,"New York, NY",New York,2173,1610,-9,-10,2164,1600,18,19,2182,1581,338,51,71,88,0,,0,0.0,0.0,0.0,0.0,0.0
2024,11,12,2,2024-11-12,G4,8408,PHX,BWI,"Phoenix, AZ",Arizona,"Baltimore, MD",Maryland,1810,2238,-6,0,1804,2238,26,15,1830,2223,2495,315,335,356,0,,0,0.0,0.0,0.0,0.0,0.0
2024,9,27,5,2024-09-27,DL,3024,LAS,STL,"Las Vegas, NV",Nevada,"St. Louis, MO",Missouri,755,2057,19,15,774,2072,16,10,790,2062,1605,206,226,232,0,,0,0.0,0.0,0.0,0.0,0.0
2024,7,11,4,2024-07-11,NK,2937,SFO,TPA,"San Francisco, CA",California,"Tampa, FL",Florida,1446,673,12,5,1458,678,10,9,1468,669,2158,270,290,289,0,,0,0.0,0.0,0.0,0.0,0.0
2024,5,29,3,2024-05-29,OO,676,TPA,BOS,"Tampa, FL",Florida,"Boston, MA",Massachusetts,2120,1697,3,-5,2123,1692,10,19,2133,1673,1942,244,264,273,0,,0,0.0,0.0,0.0,0.0,0.0
2024,5,10,5,2024-05-10,AA,9063,HNL,MDW,"Honolulu, HI",Hawaii,"Chicago, IL",Illinois,1943,1224,12,20,1955,1244,11,7,1966,1237,955,128,148,146,0,,0,0.0,4.0,3.0,0.0,13.0
2024,4,11,4,2024-04-11,UA,8007,IAH,MSP,"Houston, TX",Texas,"Minneapolis, MN",Minnesota,1038,1263,-14,-5,1024,1258,10,6,1034,1252,2278,279,299,295,0,,0,0.0,0.0,0.0,0.0,0.0
2024,11,5,2,2024-11-05,AS,8491,SEA,PDX,"Seattle, WA",Washington,"Portland, OR",Oregon,2265,1886,30,30,2295,1916,13,19,2308,1897,932,112,132,144,0,,0,9.0,6.0,3.0,0.0,12.0
2024,9,26,4,2024-09-26,G4,1855,PDX,BWI,"Portland, OR",Oregon,"Baltimore, MD",Maryland,1814,1709,-7,-10,1807,1699,25,6,1832,1693,2021,245,265,276,0,,0,0.0,0.0,0.0,0.0,0.0
2024,10,18,5,2024-10-18,9E,8471,JFK,SLC,"New York, NY",New York,"Salt Lake City, UT",Utah,1839,657,114,120,1953,777,21,13,1974,764,2692,342,362,376,0,,0,12.0,10.0,6.0,1.0,91.0
2024,7,28,7,2024-07-28,DL,2505,SFO,MSP,"San Francisco, CA",California,"Minneapolis, MN",Minnesota,1357,2284,-13,-15,1344,2269,21,12,1365,2257,2700,329,349,362,0,,0,0.0,0.0,0.0,0.0,0.0
2024,12,26,4,2024-12-26,NK,6983,ATL,DEN,"Atlanta, GA",Georgia,"Denver, CO",Colorado,631,1325,2,5,633,1330,19,5,652,1325,1680,218,238,242,0,,0,0.0,0.0,0.0,0.0,0.0
2024,12,3,2,2024-12-03,HA,8263,DEN,EWR,"Denver, CO",Colorado,"Newark, NJ",New Jersey,2126,2040,0,5,2126,2045,5,18,2131,2027,1468,173,193,196,0,,0,0.0,0.0,0.0,0.0,0.0
2024,3,7,4,2024-03-07,WN,6239,DTW,PDX,"Detroit, MI",Michigan,"Portland, OR",Oregon,1367,1904,6,5,1373,1909,18,15,1391,1894,703,96,116,129,0,,0,0.0,0.0,0.0,0.0,0.0
2024,1,10,3,2024-01-10,DL,3088,JFK,PHX,"New York, NY",New York,"Phoenix, AZ",Arizona,1240,2230,1,5,1241,2235,6,9,1247,2226,1267,166,186,181,0,,0,0.0,0.0,0.0,0.0,0.0
2024,2,18,7,2024-02-18,UA,5884,LGA,PHL,"New York, NY",New York,"Philadelphia, PA",Pennsylvania,1038,807,0,0,1038,807,24,13,1062,794,2777,354,374,391,0,,0,0.0,0.0,0.0,0.0,0.0
2024,4,20,6,2024-04-20,AS,9894,DEN,PHX,"Denver, CO",Colorado,"Phoenix, AZ",Arizona,1826,1766,-18,-15,1808,1751,26,4,1834,1747,2168,278,298,308,0,,0,0.0,0.0,0.0,0.0,0.0
2024,11,16,6,2024-11-16,9E,1219,PDX,MIA,"Portland, OR",Oregon,"Miami, FL",Florida,781,1012,-7,-5,774,1007,11,12,785,995,641,76,96,99,0,,0,0.0,0.0,0.0,0.0,0.0
2024,8,6,2,2024-08-06,G4,2314,PDX,DCA,"Portland, OR",Oregon,"Washington, DC",District of Columbia,991,2218,-7,0,984,2218,17,13,1001,2205,1988,251,271,281,0,,0,0.0,0.0,0.0,0.0,0.0
2024,2,26,1,2024-02-26,F9,8100,PHX,EWR,"Phoenix, AZ",Arizona,"Newark, NJ",New Jersey,779,1675,-6,0,773,1675,25,15,798,1660,2061,251,271,291,0,,0,0.0,0.0,0.0,0.0,0.0
2024,10,9,3,2024-10-09,9E,8165,IAH,LAS,"Houston, TX",Texas,"Las Vegas, NV",Nevada,2023,1640,-17,-10,2006,1630,11,3,2017,1627,1500,194,214,208,0,,0,0.0,0.0,0.0,0.0,0.0
2024,4,22,1,2024-04-22,OH,3001,MDW,MCO,"Chicago, IL",Illinois,"Orlando, FL",Florida,1722,1329,-9,-10,1713,1319,22,9,1735,1310,1984,249,269,280,0,,0,0.0,0.0,0.0,0.0,0.0
2024,5,12,7,2024-05-12,OO,1185,BOS,LGA,"Boston, MA",Massachusetts,"New York, NY",New York,1898,1339,7,0,1905,1339,10,9,1915,1330,2941,360,380,379,0,,0,0.0,0.0,0.0,0.0,0.0
2024,3,11,1,2024-03-11,G4,273,BWI,SFO,"Baltimore, MD",Maryland,"San Francisco, CA",California,1823,1403,9,5,1832,1408,23,4,1855,1404,1489,195,215,222,0,,0,0.0,0.0,0.0,0.0,0.0
2024,3,23,6,2024-03-23,WN,3632,ATL,LAX,"Atlanta, GA",Georgia,"Los Angeles, CA",California,1408,1018,7,10,1415,1028,13,10,1428,1018,2611,327,347,350,0,,0,0.0,0.0,0.0,0.0,0.0
2024,2,26,1,2024-02-26,YX,1338,HNL,IAH,"Honolulu, HI",Hawaii,"Houston, TX",Texas,1165,2047,-15,-15,1150,2032,14,13,1164,2019,547,75,95,102,0,,0,0.0,0.0,0.0,0.0,0.0
2024,12,14,6,2024-12-14,WN,4934,LAX,DTW,"Los Angeles, CA",California,"Detroit, MI",Michigan,1822,1518,18,15,1840,1533,8,19,1848,1514,2860,365,385,392,0,,0,0.0,0.0,0.0,0.0,0.0
2024,9,27,5,2024-09-27,HA,3913,MSP,DEN,"Minneapolis, MN",Minnesota,"Denver, CO",Colorado,1054,800,11,15,1065,815,25,17,1090,798,1012,130,150,172,0,,0,0.0,0.0,0.0,0.0,0.0
2024,4,20,6,2024-04-20,G4,7184,PHL,STL,"Philadelphia, PA",Pennsylvania,"St. Louis, MO",Missouri,1845,2041,-15,-20,1830,2021,25,14,1855,2007,732,100,120,139,0,,0,0.0,0.0,0.0,0.0,0.0
2024,12,22,7,2024-12-22,F9,8112,MDW,LGA,"Chicago, IL",Illinois,"New York, NY",New York,1633,2065,-3,0,1630,2065,16,10,1646,2055,2544,313,333,339,0,,0,0.0,0.0,0.0,0.0,0.0
2024,3,16,6,2024-03-16,YX,2073,PHX,TPA,"Phoenix, AZ",Arizona,"Tampa, FL",Florida,2146,2125,0,0,2146,2125,17,7,2163,2118,1803,233,253,257,0,,0,0.0,0.0,0.0,0.0,0.0
2024,6,6,4,2024-06-06,HA,3882,PHL,PHX,"Philadelphia, PA",Pennsylvania,"Phoenix, AZ",Arizona,970,1705,-10,0,960,1705,22,10,982,1695,2996,370,390,402,0,,0,0.0,0.0,0.0,0.0,0.0
2024,1,20,6,2024-01-20,DL,2344,CLT,BWI,"Charlotte, NC",North Carolina,"Baltimore, MD",Maryland,911,2263,6,0,917,2263,17,15,934,2248,2758,337,357,369,0,,0,0.0,0.0,0.0,0.0,0.0
2024,5,10,5,2024-05-10,F9,9949,CLT,MSP,"Charlotte, NC",North Carolina,"Minneapolis, MN",Minnesota,1012,679,-4,0,1008,679,24,16,1032,663,2171,269,289,309,0,,0,0.0,0.0,0.0,0.0,0.0
2024,11,24,7,2024-11-24,AA,8704,LAX,EWR,"Los Angeles, CA",California,"Newark, NJ",New Jersey,2003,788,-3,-10,2000,778,27,16,2027,762,1869,225,245,268,0,,0,0.0,0.0,0.0,0.0,0.0
2024,5,1,3,2024-05-01,G4,7321,IAH,EWR,"Houston, TX",Texas,"Newark, NJ",New Jersey,1663,2103,-14,-15,1649,2088,22,3,1671,2085,2987,378,398,403,0,,0,0.0,0.0,0.0,0.0,0.0
2024,2,10,6,2024-02-10,G4,7914,TPA,ORD,"Tampa, FL",Florida,"Chicago, IL",Illinois,1377,1779,-1,-10,1376,1769,9,3,1385,1766,453,54,74,66,0,,0,0.0,0.0,0.0,0.0,0.0
2024,6,15,6,2024-06-15,MQ,1482,ATL,CLT,"Atlanta, GA",Georgia,"Charlotte, NC",North Carolina,1189,1427,-1,5,1188,1432,20,11,1208,1421,1457,189,209,220,0,,0,0.0,0.0,0.0,0.0,0.0
2024,5,9,4,2024-05-09,HA,1223,LAX,DFW,"Los Angeles, CA",California,"Dallas/Fort Worth, TX",Texas,1448,1783,-15,-10,1433,1773,25,9,1458,1764,2355,288,308,322,0,,0,0.0,0.0,0.0,0.0,0.0
2024,1,23,2,2024-01-23,F9,5281,ATL,ORD,"Atlanta, GA",Georgia,"Chicago, IL",Illinois,2027,1353,1,10,2028,1363,25,11,2053,1352,2031,254,274,290,0,,0,0.0,0.0,0.0,0.0,0.0
2024,10,5,6,2024-10-05,OO,4112,LAS,BOS,"Las Vegas, NV",Nevada,"Boston, MA",Massachusetts,559,1425,-4,-5,555,1420,27,4,582,1416,263,25,45,56,0,,0,0.0,0.0,0.0,0.0,0.0
2024,9,7,6,2024-09-07,B6,2343,HNL,PDX,"Honolulu, HI",Hawaii,"Portland, OR",Oregon,1706,2217,-5,-5,1701,2212,14,10,1715,2202,415,51,71,75,0,,0,0.0,0.0,0.0,0.0,0.0
2024,1,9,2,2024-01-09,B6,2689,BOS,STL,"Boston, MA",Massachusetts,"St. Louis, MO",Missouri,918,1667,3,10,921,1677,18,3,939,1674,2846,356,376,377,0,,0,0.0,0.0,0.0,0.0,0.0
2024,1,13,6,2024-01-13,MQ,1229,DCA,EWR,"Washington, DC",District of Columbia,"Newark, NJ",New Jersey,1456,1785,-14,-10,1442,1775,27,6,1469,1769,289,28,48,61,0,,0,0.0,0.0,0.0,0.0,0.0
2024,11,2,6,2024-11-02,UA,8936,STL,HNL,"St. Louis, MO",Missouri,"Honolulu, HI",Hawaii,1324,2356,-16,-10,1308,2346,19,14,1327,2332,2700,346,366,379,0,,0,0.0,0.0,0.0,0.0,0.0
2024,11,15,5,2024-11-15,B6,9849,SAN,MDW,"San Diego, CA",California,"Chicago, IL",Illinois,1407,2284,30,30,1437,2314,15,6,1452,2308,745,85,105,106,0,,0,3.0,0.0,4.0,0.0,23.0
2024,2,21,3,2024-02-21,WN,6399,IAD,LAX,"Washington, DC",District of Columbia,"Los Angeles, CA",California,1232,2259,5,0,1237,2259,12,9,1249,2250,1468,173,193,194,1,,0,0.0,0.0,0.0,0.0,0.0
2024,7,27,6,2024-07-27,AA,4601,SFO,LAS,"San Francisco, CA",California,"Las Vegas, NV",Nevada,1750,1109,-11,-10,1739,1099,21,3,1760,1096,2683,326,346,350,0,,0,0.0,0.0,0.0,0.0,0.0
2024,2,7,3,2024-02-07,G4,7139,DCA,SFO,"Washington, DC",District of Columbia,"San Francisco, CA",California,890,2136,-12,-10,878,2126,7,13,885,2113,2015,252,272,272,0,,0,0.0,0.0,0.0,0.0,0.0
2024,4,9,2,2024-04-09,HA,2873,TPA,MSP,"Tampa, FL",Florida,"Minneapolis, MN",Minnesota,1667,1294,5,10,1672,1304,5,6,1677,1298,2757,344,364,355,0,,0,0.0,0.0,0.0,0.0,0.0
2024,7,11,4,2024-07-11,9E,2885,MCO,LGA,"Orlando, FL",Florida,"New York, NY",New York,1235,1831,2,0,1237,1831,11,6,1248,1825,1901,231,251,248,0,,0,0.0,0.0,0.0,0.0,0.0
2024,7,9,2,2024-07-09,OH,7040,IAH,BOS,"Houston, TX",Texas,"Boston, MA",Massachusetts,2087,1720,-22,-15,2065,1705,25,14,2090,1691,2088,269,289,308,0,,0,0.0,0.0,0.0,0.0,0.0
2024,2,20,2,2024-02-20,WN,1806,IAH,ATL,"Houston, TX",Texas,"Atlanta, GA",Georgia,2116,620,10,10,2126,630,6,19,2132,611,1404,169,189,194,0,,0,0.0,0.0,0.0,0.0,0.0
2024,5,20,1,2024-05-20,UA,2701,DFW,LAS,"Dallas/Fort Worth, TX",Texas,"Las Vegas, NV",Nevada,1160,1978,-5,-5,1155,1973,14,13,1169,1960,639,78,98,105,0,,0,0.0,0.0,0.0,0.0,0.0
2024,6,16,7,2024-06-16,AS,8666,SAN,HNL,"San Diego, CA",California,"Honolulu, HI",Hawaii,526,2128,35,30,561,2158,22,7,583,2151,680,93,113,122,0,,0,8.0,6.0,4.0,0.0,12.0
2024,11,6,3,2024-11-06,AA,1712,BWI,SLC,"Baltimore, MD",Maryland,"Salt Lake City, UT",Utah,2267,2027,-1,-10,2266,2017,11,4,2277,2013,2483,314,334,329,0,,0,0.0,0.0,0.0,0.0,0.0
2024,4,18,4,2024-04-18,B6,554,DEN,MIA,"Denver, CO",Colorado,"Miami, FL",Florida,1122,1846,8,0,1130,1846,9,11,1139,1835,854,103,123,123,0,,0,0.0,0.0,0.0,0.0,0.0
2024,7,25,4,2024-07-25,HA,4397,DTW,PHX,"Detroit, MI",Michigan,"Phoenix, AZ",Arizona,2031,999,-15,-10,2016,989,8,18,2024,971,2602,332,352,358,1,,0,0.0,0.0,0.0,0.0,0.0
2024,10,26,6,2024-10-26,NK,1575,PHX,ORD,"Phoenix, AZ",Arizona,"Chicago, IL",Illinois,1383,2085,1,-5,1384,2080,18,14,1402,2066,1924,237,257,269,0,,0,0.0,0.0,0.0,0.0,0.0
2024,4,19,5,2024-04-19,DL,9145,ORD,IAH,"Chicago, IL",Illinois,"Houston, TX",Texas,2114,1159,-3,-10,2111,1149,28,14,2139,1135,1581,199,219,241,0,,0,0.0,0.0,0.0,0.0,0.0
2024,7,14,7,2024-07-14,9E,9015,MCO,JFK,"Orlando, FL",Florida,"New York, NY",New York,626,1655,-12,-5,614,1650,7,6,621,1644,948,108,128,121,0,,0,0.0,0.0,0.0,0.0,0.0
2024,5,31,5,2024-05-31,G4,1491,SFO,PDX,"San Francisco, CA",California,"Portland, OR",Oregon,1979,1088,-3,-10,1976,1078,17,18,1993,1060,876,107,127,142,0,,0,0.0,0.0,0.0,0.0,0.0
2024,8,30,5,2024-08-30,YX,8553,ATL,MDW,"Atlanta, GA",Georgia,"Chicago, IL",Illinois,780,887,-10,-10,770,877,7,7,777,870,1450,171,191,185,0,,0,0.0,0.0,0.0,0.0,0.0
2024,5,7,2,2024-05-07,HA,8108,DTW,SFO,"Detroit, MI",Michigan,"San Francisco, CA",California,1918,2060,21,20,1939,2080,12,4,1951,2076,1767,218,238,234,0,,0,5.0,3.0,3.0,0.0,9.0
2024,4,14,7,2024-04-14,AS,8834,MIA,IAD,"Miami, FL",Florida,"Washington, DC",District of Columbia,818,2003,-21,-20,797,1983,22,15,819,1968,2649,338,358,375,1,,0,0.0,0.0,0.0,0.0,0.0
2024,1,10,3,2024-01-10,DL,8842,STL,LAS,"St. Louis, MO",Missouri,"Las Vegas, NV",Nevada,940,1036,-8,0,932,1036,23,13,955,1023,1334,171,191,207,0,,0,0.0,0.0,0.0,0.0,0.0
2024,12,21,6,2024-12-21,F9,5525,SAN,SLC,"San Diego, CA",California,"Salt Lake City, UT",Utah,840,729,4,0,844,729,8,5,852,724,1473,182,202,195,0,,0,0.0,0.0,0.0,0.0,0.0
2024,5,27,1,2024-05-27,F9,737,TPA,SAN,"Tampa, FL",Florida,"San Diego, CA",California,1193,1040,12,5,1205,1045,14,8,1219,1037,1367,165,185,187,0,,0,0.0,0.0,0.0,0.0,0.0
2024,12,30,1,2024-12-30,AA,8456,PHX,SLC,"Phoenix, AZ",Arizona,"Salt Lake City, UT",Utah,618,2116,10,5,628,2121,7,16,635,2105,545,60,80,83,0,,0,0.0,0.0,0.0,0.0,0.0
2024,12,29,7,2024-12-29,YX,2905,STL,MCO,"St. Louis, MO",Missouri,"Orlando, FL",Florida,1277,1389,1,5,1278,1394,16,8,1294,1386,2508,320,340,344,0,,0,0.0,0.0,0.0,0.0,0.0
2024,5,19,7,2024-05-19,AA,8912,ATL,BWI,"Atlanta, GA",Georgia,"Baltimore, MD",Maryland,1189,1596,20,20,1209,1616,28,15,1237,1601,307,32,52,75,0,,0,5.0,0.0,0.0,0.0,15.0
2024,7,8,1,2024-07-08,AA,1323,PDX,MDW,"Portland, OR",Oregon,"Chicago, IL",Illinois,1212,1868,4,5,1216,1873,10,3,1226,1870,1559,190,210,203,0,,0,0.0,0.0,0.0,0.0,0.0
